repoLanguage,forkCount,stargazerCount,repoAge,state,deletions,additions,changedFiles,commentsTotalCount,commitsTotalCount,prExperience,isMember,authorComments,reviewersComments,reviewersTotalCount,bodyLength,prSize,reviewTime,purpose
Python,19248,70257,2417.6668055555556,CLOSED,12,15,2,4,1,226,False,3,1,1,582,27,19.397777777777776,Feature
PHP,883,2337,1790.022199074074,CLOSED,9,23,2,3,4,13,False,0,3,3,2590,32,48.00194444444445,Document
PHP,883,2337,1786.1434837962963,CLOSED,1,97,3,5,1,6,False,1,4,3,3953,98,2085.108888888889,Document
TypeScript,783,13212,1160.1102662037038,CLOSED,417,3530,67,1,101,812,False,1,0,0,1865,3947,1886.1077777777778,Document
TypeScript,2071,16638,1200.9199074074074,MERGED,4,5,3,0,3,66,True,0,0,0,2445,9,344.6672222222222,Bug
Vue,293,495,787.927337962963,MERGED,365,366,31,37,36,358,True,9,28,7,804,731,1086.51,Feature
TypeScript,3989,23860,2783.0381828703703,MERGED,3,14,5,2,3,159,False,0,2,2,1121,17,624.0119444444445,Document
TypeScript,7045,76149,2586.035138888889,MERGED,28,5,1,5,1,74,False,0,5,2,502,33,0.19805555555555557,Feature
TypeScript,7045,76149,2586.624571759259,MERGED,0,14,1,5,1,83,False,0,5,2,614,14,0.9344444444444444,Feature
JavaScript,8844,63474,4035.704675925926,MERGED,1,31,4,2,5,52,True,1,1,1,1658,32,347.5661111111111,Bug
TypeScript,7045,76149,2586.586539351852,MERGED,0,2,1,5,1,82,False,0,5,2,595,2,0.16416666666666666,Feature
TypeScript,7045,76149,2586.1292939814816,MERGED,88,164,6,6,1,80,False,0,6,2,739,252,10.614444444444445,Feature
JavaScript,0,9,33.00521990740741,CLOSED,1,7,1,1,1,1,False,0,1,1,1227,8,1281.6583333333333,Document
TypeScript,7045,76149,2586.094201388889,MERGED,2,3,1,5,1,78,False,0,5,2,761,5,0.3325,Feature
TypeScript,7045,76149,2586.0871412037036,MERGED,2,2,1,5,1,77,False,0,5,2,743,4,0.09638888888888889,Feature
TypeScript,7045,76149,2586.0525694444445,MERGED,0,38,1,5,1,75,False,0,5,2,689,38,0.6119444444444444,Feature
Python,4515,54977,879.063599537037,MERGED,1,6,1,3,2,134,False,1,2,2,3507,7,2709.4319444444445,Document
TypeScript,7045,76149,2586.5736342592595,MERGED,2,1,1,6,1,81,False,0,6,3,858,3,0.12944444444444445,Feature
TypeScript,7045,76149,2586.079525462963,MERGED,1,17,1,5,1,76,False,0,5,2,864,18,0.12305555555555556,Feature
TypeScript,7045,76149,2586.0255092592593,MERGED,45,62,3,5,1,73,False,0,5,2,949,107,0.07027777777777777,Feature
Python,19248,70257,2417.9065162037036,CLOSED,5,3,1,1,1,423,False,1,0,0,251,8,13.551111111111112,Feature
TypeScript,6,5,503.4709953703704,MERGED,43,3,1,0,1,15,False,0,0,0,205,46,0.12416666666666666,Feature
PHP,883,2337,1790.1780787037035,CLOSED,1,1,1,4,1,1,False,0,4,3,1558,2,38.30222222222222,Document
TypeScript,33316,371992,3011.8820601851853,MERGED,0,196,3,4,13,111,True,1,3,3,937,196,600.0327777777778,Feature
PowerShell,8,8,588.2360416666667,MERGED,43,3,1,0,1,6,False,0,0,0,278,46,0.02,Feature
Python,19248,70257,2417.271446759259,CLOSED,18,136,4,6,10,68,False,6,0,0,1131,154,997.0008333333334,Bug
TypeScript,2071,16638,1196.1100810185185,MERGED,13,12,1,0,6,3,False,0,0,0,1321,25,96.03277777777778,Bug
Python,19248,70257,2414.4474768518517,CLOSED,0,2,1,0,1,495,False,0,0,0,213,2,8.737777777777778,Feature
TypeScript,7045,76149,2587.060138888889,MERGED,2,723,3,5,1,85,False,0,5,2,1307,725,0.2313888888888889,Bug
TypeScript,7045,76149,2586.844328703704,MERGED,4121,2681,5,5,1,84,False,0,5,2,1669,6802,0.17027777777777778,Document
TypeScript,2071,16638,1199.3106134259258,MERGED,0,2,1,0,1,65,True,0,0,0,2501,2,18.905,Bug
TypeScript,7045,76149,2586.1113078703706,MERGED,72,48,5,5,1,79,False,0,5,2,1788,120,0.3913888888888889,Feature
Python,19248,70257,2414.808113425926,CLOSED,60,38,12,2,2,1513,False,2,0,0,375,98,41.50333333333333,Feature
TypeScript,33316,371992,3010.557650462963,MERGED,0,36,1,3,3,110,True,0,3,3,1265,36,8.117222222222223,Feature
TypeScript,0,0,39.17509259259259,MERGED,0,4,1,0,1,0,True,0,0,0,247,4,0.05611111111111111,Feature
Python,19248,70257,2414.782152777778,CLOSED,3,3,2,1,1,1512,False,1,0,0,300,6,5.470833333333333,Feature
Rust,433,2229,189.3604513888889,CLOSED,46,115,4,4,3,179,False,1,3,2,727,161,467.87944444444446,Feature
TypeScript,7045,76149,2585.867638888889,MERGED,151,769,10,5,1,71,False,0,5,2,2413,920,3.1527777777777777,Bug
TypeScript,41369,87411,2895.648993055556,MERGED,0,29,2,3,2,549,True,1,2,2,3780,29,2.4827777777777778,Document
Go,2083,11768,1476.2623148148148,MERGED,12,34,1,0,1,837,True,0,0,0,2183,46,0.10583333333333333,Document
F#,153,337,2874.0943402777775,MERGED,90,801,6,5,15,8,False,2,3,2,3276,891,164.33083333333335,Bug
JavaScript,8844,63474,4035.575011574074,MERGED,18,31,2,0,1,88,True,0,0,0,954,49,0.7694444444444445,Feature
TypeScript,2071,16638,1195.3840046296298,MERGED,7,122,2,8,3,1,False,4,4,1,2881,129,114.24388888888889,Bug
TypeScript,2071,16638,1196.1647916666668,CLOSED,4,4,2,0,1,59,True,0,0,0,2607,8,94.65222222222222,Bug
TypeScript,2071,16638,1194.8897569444446,MERGED,1,6,2,0,1,64,True,0,0,0,2626,7,4.586111111111111,Bug
Python,19248,70257,2412.8243287037035,CLOSED,32,96,3,1,4,450,False,1,0,0,3093,128,135.29361111111112,Bug
TypeScript,41369,87411,2893.8533680555556,CLOSED,16,241,6,2,8,61,True,1,1,1,4712,257,2679.8180555555555,Document
TypeScript,1297,21107,373.6660648148148,CLOSED,72,7303,45,2,7,25,False,0,2,2,4911,7375,336.75694444444446,Document
TypeScript,0,0,39.17797453703704,MERGED,0,8,1,1,2,1,True,1,0,0,882,8,0.022222222222222223,Feature
TypeScript,2071,16638,1197.538136574074,MERGED,21,28,3,0,2,0,False,0,0,0,3076,49,62.37916666666667,Bug
TypeScript,7045,76149,2586.0229050925927,CLOSED,3,3,1,5,1,72,False,0,5,2,1228,6,0.050277777777777775,Document
TypeScript,2071,16638,1200.2286342592593,MERGED,98,91,2,4,3,4,False,2,2,1,4871,189,361.3536111111111,Document
TypeScript,7,6,597.985,MERGED,100,595,25,9,27,242,False,1,8,3,6756,695,479.1455555555556,Document
Go,2083,11768,1476.2928819444444,MERGED,56,107,4,0,1,838,True,0,0,0,4475,163,0.1111111111111111,Document
C++,2234,23693,2313.8087268518516,MERGED,70,57,3,1,32,269,False,1,0,0,2801,127,240.55388888888888,Bug
C,5529,39699,15.214374999999999,MERGED,2,89,1,12,3,6,False,7,5,3,2333,91,65.98944444444444,Bug
F#,153,337,2872.3346759259257,MERGED,1109,1813,21,1,10,21,False,0,1,1,14207,2922,467.1147222222222,Bug
PHP,822,6030,3016.7677199074074,CLOSED,10,167,4,0,2,136,True,0,0,0,3080,177,10.661944444444444,Bug
TypeScript,41369,87411,2895.508368055556,MERGED,0,20,1,0,5,548,True,0,0,0,2436,20,8.709722222222222,Document
TypeScript,2071,16638,1194.9722453703705,MERGED,40,146,9,1,3,0,False,1,0,0,6703,186,5.405833333333334,Bug
C#,7484,40424,2629.9962037037035,MERGED,0,18,2,1,3,622,True,0,1,1,3995,18,161.00833333333333,Document
Go,298,7579,514.2089236111111,CLOSED,2,5935,87,3,13,103,False,0,3,1,5775,5937,1055.3297222222222,Document
JavaScript,0,9,33.00868055555556,MERGED,9,15,7,1,2,2,False,0,1,1,3174,24,29.87527777777778,Document
TypeScript,41369,87411,2893.7422453703707,CLOSED,424,8825,231,10,545,3,True,5,5,2,6883,9249,698.7580555555555,Document
Python,4515,54977,879.9366203703704,MERGED,4,10,1,1,7,1,False,0,1,1,4793,14,692.5569444444444,Document
Python,968,6759,9.96224537037037,CLOSED,305,172,10,1,1,41,False,0,1,1,6619,477,338.62333333333333,Feature
C,5529,39699,18.24096064814815,CLOSED,23,121,4,33,6,8,False,11,22,8,7942,144,23.775833333333335,Bug
Python,19248,70257,2424.6897569444445,CLOSED,0,172,8,7,12,130,False,6,1,1,553,172,1365.7419444444445,Document
Python,19248,70257,2428.378946759259,CLOSED,48742,171943,2295,14,1305,2,False,8,6,2,722,220685,3116.936388888889,Document
TypeScript,2147,14722,1439.8153703703704,CLOSED,20,20,1,0,1,652,False,0,0,0,728,40,0.6611111111111111,Bug
C#,80,125,783.6623148148147,CLOSED,8,24,3,1,7,174,False,1,0,0,816,32,3262.7677777777776,Document
C#,80,125,783.7553587962963,CLOSED,4,146,6,1,8,28,False,1,0,0,1061,150,356.4558333333333,Document
C++,363,552,502.16837962962967,MERGED,4,1,2,0,2,97,False,0,0,0,1312,5,21.96388888888889,Document
Python,19248,70257,2420.039675925926,CLOSED,3,91,3,4,12,210,False,3,1,1,392,94,115.07416666666667,Feature
Python,19248,70257,2426.220046296296,CLOSED,28,87,4,11,22,154,False,5,6,3,479,115,1346.4394444444445,Feature
TypeScript,5735,42500,3106.153981481482,MERGED,204,7708,418,4,17,912,True,4,0,0,8747,7912,1118.7586111111111,Document
Python,24585,55553,4614.0240277777775,MERGED,198,324,39,7,113,10,False,3,4,3,251,522,1324.6030555555556,Bug
Python,19248,70257,2428.734212962963,CLOSED,7,10,4,0,5,230,False,0,0,0,2070,17,2379.965277777778,Feature
PHP,1093,3326,2817.9709259259257,MERGED,10,76,7,7,27,391,False,3,4,1,2488,86,894.6322222222223,Bug
Perl,286,540,3439.1822916666665,MERGED,8,14,1,6,7,233,False,1,5,5,88,22,648.2961111111111,Feature
Go,421,1654,1477.1969444444446,CLOSED,4,17,1,0,1,61,False,0,0,0,1149,21,0.8969444444444444,Document
TypeScript,178,1359,287.8753819444444,MERGED,0,10,1,0,1,1,True,0,0,0,648,10,0.24583333333333332,Feature
TypeScript,2147,14722,1439.943402777778,MERGED,1,1,1,0,1,30,False,0,0,0,608,2,2.6286111111111112,Bug
TypeScript,2147,14722,1439.2071412037037,MERGED,2,19,1,0,2,151,False,0,0,0,1105,21,0.5583333333333333,Feature
TypeScript,2147,14722,1439.0757060185185,MERGED,1,1,1,0,1,145,False,0,0,0,645,2,23.50111111111111,Feature
Rust,417,2801,884.0786111111111,MERGED,0,81,2,1,5,2,False,1,0,0,1090,81,309.255,Document
PHP,1334,2960,4174.885810185185,MERGED,0,2,1,0,1,853,False,0,0,0,1067,2,0.3219444444444444,Document
C++,2234,23693,2323.8723842592594,MERGED,2,3,1,1,1,283,False,0,1,1,764,5,2.1525,Bug
C++,2234,23693,2323.859363425926,MERGED,10,23,2,1,1,282,False,0,1,1,994,33,1.5552777777777778,Bug
Vue,0,1,212.4613888888889,MERGED,0,2,1,1,1,102,True,0,1,1,645,2,0.058055555555555555,Feature
Rust,128,2771,362.3881712962963,MERGED,0,10,1,0,2,445,True,0,0,0,896,10,15.596111111111112,Feature
C++,2234,23693,2323.9426504629632,MERGED,2,4,1,1,1,172,False,0,1,1,612,6,0.019444444444444445,Feature
Python,2407,12180,198.77609953703703,MERGED,11,42,3,84,44,0,False,14,70,12,3849,53,2861.925,Bug
Go,421,1654,1474.8978356481482,MERGED,1,1,1,2,1,393,True,1,1,1,741,2,25.349444444444444,Bug
C++,2234,23693,2322.032974537037,MERGED,1,5,1,1,3,191,False,0,1,1,455,6,4.254166666666666,Feature
JavaScript,5139,7048,1169.5182523148148,MERGED,9,108,9,5,10,234,False,1,4,2,919,117,191.82055555555556,Bug
TypeScript,2147,14722,1437.1353124999998,MERGED,0,2,1,1,1,55,False,0,1,1,1024,2,0.07611111111111112,Feature
Go,2083,11768,1481.3550694444446,CLOSED,0,55,1,5,1,0,False,2,3,1,2073,55,1091.4716666666666,Document
C++,2234,23693,2324.6841435185183,MERGED,1,3,1,2,1,173,False,1,1,1,780,4,71.16194444444444,Feature
JavaScript,5139,7048,1171.2658912037036,MERGED,1,27,2,5,3,1,False,1,4,3,814,28,83.46972222222222,Feature
PHP,1334,2960,4174.376423611111,CLOSED,0,1,1,1,1,147,False,0,1,1,842,1,12.236666666666666,Feature
Python,2407,12180,204.10917824074076,CLOSED,2,117,4,9,17,111,True,2,7,3,3353,119,193.26527777777778,Document
TypeScript,2147,14722,1439.1713657407408,MERGED,1,9,1,0,1,150,False,0,0,0,1162,10,0.4072222222222222,Bug
TypeScript,41369,87411,2895.767314814815,CLOSED,0,9,1,0,2,550,True,0,0,0,2168,9,1.9808333333333332,Document
TypeScript,216,520,1664.8178356481483,MERGED,9,5,1,0,1,53,False,0,0,0,313,14,3.3066666666666666,Feature
TypeScript,15,34,456.68189814814815,MERGED,2,8,1,0,2,845,False,0,0,0,556,10,0.9794444444444445,Feature
JavaScript,5139,7048,1168.9415277777778,MERGED,0,15,1,1,1,117,False,0,1,1,770,15,0.15138888888888888,Feature
TypeScript,5735,42500,3105.120613425926,MERGED,2,0,2,1,1,910,True,1,0,0,2464,2,0.1125,Document
Go,421,1654,1477.089074074074,MERGED,13,4,3,0,1,396,True,0,0,0,1743,17,20.306944444444444,Bug
F#,271,818,2689.280740740741,MERGED,0,5,1,2,1,5,False,0,2,1,1276,5,269.4486111111111,Bug
C++,2234,23693,2324.9357870370372,MERGED,5,14,2,1,1,510,False,0,1,1,1144,19,1.3727777777777779,Bug
Rust,417,2801,888.0881018518518,MERGED,20,285,15,2,9,142,False,1,1,1,767,305,871.6505555555556,Feature
Go,11875,71337,2655.9377430555555,MERGED,0,7,1,0,1,275,True,0,0,0,1060,7,0.11138888888888888,Feature
Blade,0,0,80.9244212962963,MERGED,0,11,1,0,2,4,False,0,0,0,515,11,2.956111111111111,Feature
JavaScript,5139,7048,1170.589097222222,CLOSED,19,25,3,2,7,235,False,0,2,2,1473,44,94.9011111111111,Feature
F#,271,818,2696.972673611111,MERGED,22,25,3,1,1,53,False,0,1,1,3245,47,342.10027777777776,Document
Go,421,1654,1476.0738657407408,MERGED,7,8,1,0,1,598,False,0,0,0,1335,15,1.1655555555555555,Bug
C++,2234,23693,2324.0447106481483,CLOSED,3887,1837,227,6,26,0,False,3,3,2,1654,5724,263.4736111111111,Document
TypeScript,307,2556,504.42112268518514,CLOSED,2,2,1,0,1,539,True,0,0,0,1083,4,0.6386111111111111,Bug
Go,421,1654,1474.8768634259259,MERGED,9,9,2,0,1,392,True,0,0,0,1483,18,24.31861111111111,Document
TypeScript,2071,16638,1205.2275694444445,CLOSED,3,2,1,1,1,68,True,1,0,0,2305,5,87.89555555555556,Bug
Blade,0,0,82.20027777777777,MERGED,20,41,1,0,2,5,False,0,0,0,628,61,0.028055555555555556,Feature
TypeScript,15,34,457.47356481481484,MERGED,29,55,2,0,3,450,True,0,0,0,1149,84,75.93,Bug
TypeScript,307,2556,504.4445023148148,MERGED,0,12,1,1,2,540,True,1,0,0,956,12,99.81833333333333,Feature
TypeScript,41369,87411,2896.5626967592593,CLOSED,2,2,1,1,1,0,False,1,0,0,2777,4,1160.191111111111,Document
TypeScript,5735,42500,3105.093356481482,MERGED,209,291,22,2,5,909,True,2,0,0,4560,500,1316.5091666666667,Document
TypeScript,41369,87411,2904.458402777778,CLOSED,1,1,1,0,1,1880,True,0,0,0,2194,2,0.02666666666666667,Document
TypeScript,15,34,455.5007060185185,CLOSED,4,7,4,1,1,843,False,1,0,0,1366,11,0.21444444444444444,Feature
JavaScript,8844,63474,4044.6941435185186,MERGED,2,24,5,1,1,0,False,0,1,1,1881,26,131.7927777777778,Document
Go,11875,71337,2655.514351851852,MERGED,0,10,1,0,1,272,True,0,0,0,684,10,0.06444444444444444,Feature
JavaScript,8844,63474,4045.107453703704,MERGED,1832,2102,77,1,26,60,True,0,1,1,1463,3934,101.53888888888889,Document
Go,184,661,1988.3764930555556,CLOSED,4,4,3,1,2,16,True,0,1,1,220,8,1.628611111111111,Bug
TypeScript,2147,14722,1437.0924074074073,MERGED,32,67,4,1,2,10,False,0,1,1,2531,99,0.9944444444444445,Feature
TypeScript,2147,14722,1436.9880208333334,MERGED,31,62,3,1,1,9,False,0,1,1,2253,93,0.345,Feature
TypeScript,15,34,457.50111111111113,MERGED,1,1,1,0,1,451,True,0,0,0,946,2,0.6880555555555555,Bug
JavaScript,8844,63474,4045.245150462963,MERGED,3,1,1,0,2,55,True,0,0,0,1244,4,48.450833333333335,Document
TypeScript,7045,76149,2589.770439814815,MERGED,0,6,1,5,1,92,False,0,5,2,659,6,0.4111111111111111,Document
TypeScript,4705,54041,1188.6836574074075,MERGED,30,75,1,4,9,62,False,1,3,3,1697,105,70.0261111111111,Bug
Go,2083,11768,1485.9302083333332,MERGED,0,3,1,5,1,0,False,3,2,1,1453,3,9.234722222222222,Document
Go,2083,11768,1486.3152546296296,MERGED,1,15,1,0,1,851,True,0,0,0,1044,16,0.10472222222222222,Document
TypeScript,41369,87411,2903.8720949074072,MERGED,4,206,2,2,6,62,True,0,2,2,2479,210,265.88694444444445,Document
Go,395,660,1231.8881944444445,MERGED,0,1,1,0,1,113,False,0,0,0,244,1,0.11472222222222223,Feature
PHP,1334,2960,4174.0190625000005,MERGED,6,4,4,1,3,852,False,0,1,1,2016,10,4.81,Feature
C++,2234,23693,2324.919988425926,MERGED,25,6,4,1,1,509,False,0,1,1,1770,31,65.47527777777778,Feature
TypeScript,1297,21107,382.9777314814815,MERGED,8,19,4,1,1,758,True,0,1,1,224,27,0.024722222222222222,Feature
JavaScript,8844,63474,4036.2363425925923,MERGED,1,1,1,2,1,0,False,0,2,2,928,2,0.14055555555555554,Bug
Python,3,12,12.723171296296295,MERGED,0,8,1,0,1,5,False,0,0,0,620,8,0.0475,Feature
JavaScript,5139,7048,1170.8665162037037,MERGED,10,10,10,2,1,0,False,1,1,1,123,20,0.16416666666666666,Feature
JavaScript,8844,63474,4044.5543055555554,MERGED,37,46,8,0,7,59,True,0,0,0,1643,83,4.084444444444444,Bug
TypeScript,1416,21916,249.61787037037038,MERGED,14,50,2,3,2,70,True,0,3,3,342,64,1.8233333333333333,Feature
JavaScript,8844,63474,4044.0610185185183,MERGED,1667,1749,4,5,19,58,True,4,1,1,1715,3416,9.205,Document
TypeScript,7045,76149,2587.7072222222223,MERGED,1,16,1,5,1,87,False,0,5,2,835,17,0.5902777777777778,Feature
JavaScript,8844,63474,4044.060960648148,CLOSED,405,442,7,0,1,53,True,0,0,0,1891,847,0.20083333333333334,Feature
Blade,0,0,81.04890046296296,MERGED,2,6,1,0,1,11,False,0,0,0,1047,8,0.03805555555555556,Bug
C++,363,552,504.52592592592595,MERGED,2,2,1,1,1,79,False,1,0,0,2061,4,57.532222222222224,Document
C#,80,125,785.7712847222223,MERGED,0,15,2,0,2,3,False,0,0,0,417,15,165.11666666666667,Bug
Go,395,660,1232.8904861111112,MERGED,0,5,1,0,1,188,False,0,0,0,253,5,0.3375,Feature
TypeScript,2071,16638,1207.4076273148148,MERGED,1,1,1,0,1,0,False,0,0,0,1263,2,4.121666666666667,Document
F#,153,337,2880.966284722222,MERGED,0,307,4,1,2,10,False,0,1,1,3027,307,334.1013888888889,Document
Java,450,746,4039.1245138888885,MERGED,14,68,2,0,2,965,False,0,0,0,327,82,93.12166666666667,Bug
JavaScript,5139,7048,1169.1051157407408,MERGED,47,224,3,1,5,283,False,0,1,1,2032,271,13.941666666666666,Feature
C++,2234,23693,2321.9095486111114,MERGED,59,69,6,1,4,171,False,0,1,1,354,128,67.04027777777777,Feature
Go,395,660,1232.1428587962962,MERGED,0,6,1,0,1,115,False,0,0,0,196,6,0.06444444444444444,Feature
C++,2234,23693,2321.763611111111,MERGED,9,202,3,1,4,10,False,0,1,1,1670,211,47.89833333333333,Document
TypeScript,7045,76149,2589.762210648148,MERGED,0,19,2,5,1,91,False,0,5,2,917,19,0.08194444444444444,Feature
TypeScript,7045,76149,2589.7457407407405,MERGED,17216,17135,3,5,1,90,False,0,5,2,886,34351,0.16361111111111112,Document
TypeScript,1297,21107,383.0753240740741,MERGED,1,3,1,2,1,762,True,1,1,1,1375,4,0.16027777777777777,Document
TypeScript,1297,21107,383.0052430555556,MERGED,2,6,3,1,1,760,True,0,1,1,1318,8,0.013333333333333334,Document
JavaScript,5139,7048,1170.662800925926,MERGED,32,437,10,2,4,0,False,0,2,2,220,469,21.99972222222222,Feature
TypeScript,1297,21107,382.2974537037037,MERGED,1,1,1,2,3,2,False,1,1,1,1464,2,16.905277777777776,Document
TypeScript,1297,21107,382.80929398148146,MERGED,719,711,10,1,1,756,True,0,1,1,374,1430,3.2330555555555556,Bug
Python,24585,55553,4612.347152777777,MERGED,3,14,2,1,2,2,False,0,1,1,255,17,18.57138888888889,Feature
Rust,433,2229,195.75184027777777,MERGED,31,45,4,0,1,102,False,0,0,0,659,76,1.4272222222222222,Bug
Python,19248,70257,2419.4344328703705,CLOSED,5,2,1,5,2,1522,False,5,0,0,113,7,11.403055555555556,Feature
HTML,118,8,34.88990740740741,MERGED,6,6,1,0,1,4,True,0,0,0,188,12,0.013333333333333334,Feature
Python,19248,70257,2420.615601851852,CLOSED,6,1,1,4,1,1524,False,4,0,0,176,7,5.551666666666667,Feature
PHP,883,2337,1797.022951388889,CLOSED,4,4,2,3,1,196,False,1,2,2,2273,8,233.28916666666666,Document
C++,2234,23693,2323.9502314814813,MERGED,25,14,3,2,1,194,False,1,1,1,2427,39,30.834722222222222,Feature
Go,395,660,1232.941875,MERGED,1,10,1,0,1,51,False,0,0,0,273,11,0.14666666666666667,Feature
Go,30,295,314.3537847222222,MERGED,15,1,2,3,1,95,True,0,3,1,1957,16,0.12361111111111112,Bug
Java,450,746,4038.0513541666664,MERGED,7,7,5,2,2,61,True,0,2,1,2671,14,3.164722222222222,Bug
Go,30,295,308.1178125,MERGED,2,2,1,2,1,91,True,0,2,1,1433,4,0.0175,Bug
TypeScript,1297,21107,382.9620717592593,MERGED,6,14,4,1,1,757,True,0,1,1,397,20,0.14305555555555555,Feature
Go,395,660,1232.1514351851852,MERGED,3,3,3,0,1,50,False,0,0,0,310,6,0.09222222222222222,Feature
Go,395,660,1231.8938773148147,MERGED,0,32,1,0,1,114,False,0,0,0,276,32,1.0047222222222223,Feature
C#,80,125,784.8851851851852,MERGED,5,5,2,0,1,2,False,0,0,0,347,10,0.24333333333333335,Document
Go,30,295,307.4099189814815,MERGED,1,1,1,3,1,89,True,1,2,1,1368,2,0.01361111111111111,Bug
Go,30,295,313.00894675925923,MERGED,4,3,3,2,2,93,True,0,2,1,1783,7,0.0175,Bug
Python,19248,70257,2419.3844791666666,CLOSED,1,1,1,5,1,0,False,0,5,3,213,2,12.269722222222223,Bug
TypeScript,216,520,1664.8530208333334,MERGED,3,1,1,0,1,144,False,0,0,0,308,4,0.18416666666666667,Feature
TypeScript,216,520,1664.811724537037,MERGED,51,51,3,2,1,52,False,1,1,1,322,102,1.2761111111111112,Bug
Erlang,2054,12122,3756.155347222222,MERGED,25,91,9,0,9,963,True,0,0,0,372,116,37.754444444444445,Feature
TypeScript,1297,21107,383.99841435185186,MERGED,2,7,2,1,1,766,True,0,1,1,1767,9,0.015833333333333335,Document
TypeScript,1297,21107,383.92754629629627,MERGED,50,233,9,1,4,58,False,0,1,1,2295,283,1.6575,Document
C++,2234,23693,2323.061597222222,MERGED,1,27,5,1,1,192,False,0,1,1,1899,28,18.378055555555555,Bug
TypeScript,41369,87411,2904.8373032407403,MERGED,10,976,6,5,17,36,False,2,3,1,1865,986,98.72083333333333,Document
JavaScript,3618,9017,2252.84125,MERGED,4,5,2,3,1,523,False,1,2,1,1465,9,332.145,Bug
C#,80,125,784.6580092592593,MERGED,35,28,10,0,5,151,True,0,0,0,588,63,240.04194444444445,Document
JavaScript,8844,63474,4041.5657870370374,MERGED,4,23,3,0,1,55,True,0,0,0,2284,27,42.214166666666664,Bug
Go,2083,11768,1484.016388888889,MERGED,2,2,1,2,1,0,False,0,2,2,1376,4,0.03861111111111111,Document
TypeScript,1297,21107,383.02068287037036,MERGED,2,6,2,1,1,761,True,0,1,1,1832,8,0.14555555555555555,Document
TypeScript,1297,21107,382.9843402777778,MERGED,122,3,4,1,1,759,True,0,1,1,2190,125,0.16416666666666666,Document
Erlang,2054,12122,3755.3197222222225,MERGED,1,4,1,0,1,961,True,0,0,0,339,5,12.831388888888888,Bug
Java,450,746,4037.4121990740737,MERGED,1,1,1,1,4,10,False,0,1,1,480,2,12.8025,Bug
C#,80,125,786.7704050925926,MERGED,1,1,1,0,1,60,False,0,0,0,624,2,116.90333333333334,Document
Python,19248,70257,2427.5101157407407,CLOSED,0,19,3,3,7,252,False,2,1,1,569,19,3.8958333333333335,Bug
C#,80,125,784.7429513888889,MERGED,92,168,9,0,1,177,False,0,0,0,537,260,0.4638888888888889,Document
Go,395,660,1232.1372800925926,MERGED,50,91,10,0,6,49,False,0,0,0,619,141,120.49416666666667,Feature
TypeScript,2071,16638,1210.3027662037036,CLOSED,0,137,4,3,5,1,False,1,2,1,3057,137,143.67361111111111,Document
TypeScript,15,34,457.4956134259259,MERGED,14,18,4,0,2,846,False,0,0,0,2584,32,1.9705555555555556,Feature
F#,153,337,2881.0234953703707,MERGED,36,1907,9,0,1,23,False,0,0,0,3118,1943,1.585,Bug
Go,298,7579,522.3276736111111,CLOSED,84,372,6,1,57,31,False,0,1,1,925,456,449.18333333333334,Document
JavaScript,5139,7048,1169.5213425925926,MERGED,21,1782,13,14,28,85,False,6,8,3,3662,1803,286.99583333333334,Feature
TypeScript,2071,16638,1205.195775462963,MERGED,2,5,1,0,4,67,True,0,0,0,2406,7,241.82972222222222,Bug
C#,80,125,787.6919097222222,MERGED,0,2,1,0,1,37,False,0,0,0,646,2,0.44055555555555553,Document
Erlang,2054,12122,3755.3124884259255,MERGED,63,140,15,0,16,960,True,0,0,0,406,203,19.969166666666666,Document
TypeScript,7045,76149,2587.8350694444443,MERGED,6,81,7,5,1,89,False,0,5,2,1580,87,0.2836111111111111,Document
JavaScript,8844,63474,4043.5468402777774,MERGED,8,139,15,0,6,57,True,0,0,0,3660,147,159.505,Feature
TypeScript,41369,87411,2903.54462962963,MERGED,4,16,4,1,3,22,False,0,1,1,2098,20,3.99,Document
Go,30,295,307.41692129629627,MERGED,1,3,1,2,1,90,True,0,2,1,1715,4,0.016666666666666666,Bug
TypeScript,7045,76149,2587.7975694444444,CLOSED,1,1,1,6,1,88,False,1,5,2,331,2,0.32722222222222225,Bug
TypeScript,216,520,1658.7880208333333,MERGED,130,210,13,2,5,140,False,2,0,0,488,340,140.5363888888889,Bug
TypeScript,2071,16638,1210.1029861111112,MERGED,0,3,1,0,2,69,True,0,0,0,2563,3,56.94722222222222,Bug
Vue,0,1,214.35350694444446,MERGED,24,95,4,1,3,27,False,0,1,1,4002,119,0.295,Feature
C++,2234,23693,2325.000520833333,MERGED,55,72,2,1,1,511,False,0,1,1,3377,127,63.56055555555555,Document
Rust,413,5117,432.72364583333336,CLOSED,7,11,6,4,1,0,False,2,2,1,4486,18,1.5261111111111112,Document
TypeScript,47,234,1012.812974537037,MERGED,77,1911,86,1,46,27,True,0,1,1,1219,1988,647.3569444444445,Document
F#,153,337,2883.8210300925925,MERGED,12,108,6,0,3,183,False,0,0,0,3869,120,156.46583333333334,Document
Erlang,2054,12122,3763.3728703703705,MERGED,39,111,13,0,4,42,False,0,0,0,745,150,73.77333333333333,Bug
C#,80,125,783.6991898148149,MERGED,105,96,27,0,2,57,False,0,0,0,644,201,67.3175,Document
C#,80,125,783.3917476851852,MERGED,1311,1898,12,2,15,147,True,2,0,0,750,3209,334.6744444444444,Document
Vue,0,1,213.09233796296294,MERGED,125,81,8,1,2,107,True,0,1,1,4383,206,0.105,Feature
C#,80,125,784.6020023148149,MERGED,43,52,3,0,2,150,True,0,0,0,568,95,0.505,Document
C#,80,125,786.5076851851851,MERGED,139,466,3,0,2,58,False,0,0,0,884,605,145.94861111111112,Document
TypeScript,3392,2334,935.2858101851853,MERGED,1,5,1,2,1,329,False,0,2,1,1023,6,66.94666666666667,Feature
C#,80,125,787.8030092592593,MERGED,61,74,6,0,7,185,True,0,0,0,1375,135,66.58222222222223,Document
Starlark,440,286,456.4059606481481,MERGED,1,1,1,2,1,0,False,2,0,0,1330,2,447.79,Bug
TypeScript,1297,21107,383.78959490740743,MERGED,220,190,5,1,1,765,True,0,1,1,2689,410,0.28194444444444444,Document
TypeScript,1297,21107,383.78116898148147,MERGED,377,51,9,1,1,764,True,0,1,1,2603,428,0.14055555555555554,Document
TypeScript,1297,21107,383.74357638888887,CLOSED,324,199,5,1,1,763,True,0,1,1,2873,523,1.0483333333333333,Document
C++,2234,23693,2321.8072453703703,MERGED,1,18,2,2,2,507,False,1,1,1,2875,19,42.58777777777778,Feature
Go,30,295,308.41980324074075,MERGED,27,359,9,9,4,92,True,2,7,1,3191,386,108.81083333333333,Document
C#,80,125,783.8390740740741,MERGED,2,93,9,0,1,0,False,0,0,0,1092,95,186.50277777777777,Feature
Go,2083,11768,1481.2480671296296,MERGED,0,7,2,0,1,845,True,0,0,0,2049,7,0.37972222222222224,Document
TypeScript,2071,16638,1207.0982060185186,MERGED,2,6,1,0,1,0,False,0,0,0,2283,8,3.745277777777778,Bug
TypeScript,4,33,730.2971643518518,MERGED,2,2,2,1,3,349,False,0,1,1,1022,4,0.12694444444444444,Bug
TypeScript,1297,21107,380.9065162037037,MERGED,38,19,1,2,30,0,False,1,1,1,2861,57,70.20777777777778,Document
TypeScript,1297,21107,382.6502893518518,CLOSED,77,130,8,10,9,3,False,3,7,5,4180,207,455.43333333333334,Document
TypeScript,3392,2334,934.9705787037037,MERGED,5,10,2,1,1,70,False,0,1,1,1079,15,0.2752777777777778,Feature
TypeScript,3392,2334,934.937974537037,MERGED,11,15,1,1,1,68,False,0,1,1,892,26,1.0244444444444445,Bug
TypeScript,41369,87411,2903.8619212962963,MERGED,3,18,1,0,5,378,True,0,0,0,2525,21,85.40833333333333,Document
TypeScript,4,33,729.3056597222222,MERGED,1,1,1,2,2,547,True,1,1,1,956,2,0.4127777777777778,Feature
JavaScript,5139,7048,1169.7594791666668,MERGED,13,13,13,1,1,83,False,0,1,1,4854,26,1.8072222222222223,Feature
C#,80,125,786.812638888889,MERGED,4295665,456727,11,1,3,180,False,0,1,1,724,4752392,22.156388888888888,Document
TypeScript,4,33,729.1760069444445,MERGED,10,19,3,2,1,178,True,1,1,1,1033,29,0.7622222222222222,Feature
TypeScript,41369,87411,2905.104409722222,CLOSED,1,1,1,0,1,380,True,0,0,0,2275,2,0.31166666666666665,Document
TypeScript,41369,87411,2903.802071759259,CLOSED,0,1,1,1,1,23,False,0,1,1,2190,1,66.20722222222223,Document
Erlang,2054,12122,3759.155011574074,MERGED,7,8,3,0,3,67,True,0,0,0,914,15,45.89055555555556,Document
TypeScript,17,33,685.7093634259259,MERGED,171,525,55,1,16,156,False,0,1,1,1071,696,129.8022222222222,Bug
TypeScript,41369,87411,2904.6742592592595,MERGED,3,82,2,1,2,379,True,0,1,1,2283,85,29.631944444444443,Document
TypeScript,41369,87411,2905.1013425925926,MERGED,1,30,2,1,5,4,False,0,1,1,2907,31,7.8502777777777775,Document
TypeScript,41369,87411,2904.5246527777776,MERGED,0,15,1,3,1,1,False,1,2,1,2555,15,28.191666666666666,Document
TypeScript,41369,87411,2904.8278124999997,MERGED,7,7,3,0,3,8,False,0,0,0,2650,14,3.9730555555555553,Document
Erlang,2054,12122,3761.3553472222225,MERGED,2,2,1,0,1,10,False,0,0,0,1052,4,1.0205555555555557,Document
TypeScript,183,1377,258.3475231481481,MERGED,33,1195,26,5,19,0,False,2,3,2,2028,1228,783.5416666666666,Document
TypeScript,41369,87411,2903.9534143518517,MERGED,1,17,2,8,2,40,False,4,4,2,2909,18,25.15138888888889,Document
TypeScript,41369,87411,2904.500636574074,CLOSED,8746,3389,30,2,7,0,False,0,2,1,2847,12135,0.45805555555555555,Document
TypeScript,41369,87411,2904.4847337962965,MERGED,7,7,1,0,1,552,True,0,0,0,2674,14,0.7527777777777778,Document
Erlang,2054,12122,3760.1017013888886,MERGED,3,7,2,4,1,8,False,3,1,1,1057,10,1.29,Document
Erlang,2054,12122,3760.4744097222224,CLOSED,41,28,5,0,1,967,True,0,0,0,1642,69,717.4997222222222,Document
Erlang,2054,12122,3759.160590277778,MERGED,1,14,1,0,1,286,False,0,0,0,998,15,4.227222222222222,Document
TypeScript,41369,87411,2903.975740740741,CLOSED,1,9,1,1,2,4,False,0,1,1,2479,10,14.7725,Document
TypeScript,41369,87411,2902.5994097222224,MERGED,10,12,5,2,6,1877,True,1,1,1,2429,22,57.780833333333334,Document
Java,171,504,1562.0554861111111,MERGED,1,1,1,0,1,91,True,0,0,0,894,2,162.48,Bug
TypeScript,41369,87411,2903.802893518519,CLOSED,25,22,1,2,3,377,True,1,1,1,2875,47,2.392777777777778,Document
TypeScript,41369,87411,2903.7722569444445,MERGED,2,19,2,0,1,39,False,0,0,0,2970,21,1.5683333333333334,Document
TypeScript,41369,87411,2903.6533680555553,MERGED,1,2,2,0,2,2,False,0,0,0,2935,3,2.1683333333333334,Document
Go,2083,11768,1477.9661342592592,MERGED,6,7,2,0,2,841,True,0,0,0,1879,13,0.14583333333333334,Document
TypeScript,41369,87411,2903.6281365740742,MERGED,2,2,2,0,1,1544,True,0,0,0,2274,4,0.9694444444444444,Document
JavaScript,8844,63474,4041.3510300925923,MERGED,3,94,11,6,6,5,False,3,3,2,3899,97,367.765,Bug
TypeScript,41369,87411,2902.6726041666666,MERGED,7,7,1,3,2,376,True,2,1,1,2538,14,25.788333333333334,Document
C#,80,125,783.8914930555555,MERGED,1,3,1,0,5,175,False,0,0,0,797,4,42.39388888888889,Document
Rust,433,2229,199.4846990740741,MERGED,5,12,1,1,1,73,False,0,1,1,851,17,28.89527777777778,Feature
Go,2083,11768,1477.3345833333333,MERGED,0,173,3,0,1,839,True,0,0,0,2312,173,0.11555555555555555,Document
TypeScript,41369,87411,2901.652476851852,MERGED,44,906,10,7,7,374,True,4,3,1,2244,950,49.99166666666667,Document
HTML,11809,87633,122.6485763888889,CLOSED,0,5,2,0,1,0,False,0,0,0,1072,5,0.6161111111111112,Feature
Java,450,746,4032.9605208333337,MERGED,22,474,16,2,43,9,False,0,2,1,1203,496,579.735,Feature
TypeScript,41369,87411,2902.5865972222223,MERGED,4,4,2,0,1,375,True,0,0,0,2706,8,0.32555555555555554,Document
Python,142,422,2374.123935185185,MERGED,17,18,3,0,1,156,True,0,0,0,1297,35,0.09555555555555556,Feature
Python,19248,70257,2420.784710648148,CLOSED,46,85,5,1,4,244,False,1,0,0,745,131,79.94555555555556,Feature
C#,80,125,787.6350462962963,MERGED,12,32,5,0,20,61,False,0,0,0,972,44,169.23222222222222,Document
TypeScript,41369,87411,2901.7113194444446,MERGED,1,1,1,4,1,0,False,1,3,1,2264,2,18.596666666666668,Document
Go,11875,71337,2655.9315046296297,MERGED,97,151,3,0,1,274,True,0,0,0,2876,248,0.0475,Feature
Go,1835,11245,1694.6453935185184,MERGED,2,2,1,0,1,131,False,0,0,0,999,4,0.15611111111111112,Feature
C#,80,125,787.4994560185186,MERGED,79,26,8,0,14,30,False,0,0,0,1135,105,288.0075,Document
TypeScript,7,6,611.2309259259259,MERGED,16,101,6,1,7,252,False,0,1,1,907,117,143.58555555555554,Document
TypeScript,41369,87411,2900.9289930555556,MERGED,16,70,3,0,2,1540,True,0,0,0,2911,86,0.6491666666666667,Document
Erlang,2054,12122,3756.020486111111,MERGED,8,25,2,0,2,962,True,0,0,0,976,33,3.207222222222222,Document
TypeScript,3989,23860,2793.946261574074,MERGED,1,16,2,2,2,342,True,0,2,1,1127,17,219.86388888888888,Document
TypeScript,41369,87411,2900.424872685185,MERGED,0,2,2,0,3,61,True,0,0,0,2351,2,1.1513888888888888,Document
JavaScript,8844,63474,4045.0253472222225,MERGED,1,161,24,0,2,54,True,0,0,0,4178,162,123.83611111111111,Bug
Python,4515,54977,889.790162037037,CLOSED,0,0,0,0,0,0,False,0,0,0,3512,0,1711.786388888889,Document
TypeScript,41369,87411,2899.7592013888893,MERGED,3,2,2,1,2,1873,True,0,1,1,2542,5,15.291944444444445,Document
Erlang,2054,12122,3762.4159027777782,MERGED,59,264,25,5,1,292,False,2,3,3,1393,323,164.33305555555555,Document
TypeScript,41369,87411,2897.7037847222223,MERGED,1,3,1,0,3,103,False,0,0,0,2275,4,2.5366666666666666,Document
TypeScript,41369,87411,2899.509664351852,MERGED,3,50,2,3,2,38,False,1,2,1,2668,53,6.036388888888889,Document
Python,72,25,1602.821261574074,MERGED,6,6,1,0,1,108,False,0,0,0,1525,12,0.16277777777777777,Document
Python,72,25,1602.7491319444443,MERGED,388,2136,27,0,2,107,False,0,0,0,1453,2524,0.1613888888888889,Document
Erlang,2054,12122,3760.002268518518,MERGED,2,11,3,0,1,31,False,0,0,0,1283,13,220.34333333333333,Document
Erlang,2054,12122,3761.107361111111,MERGED,104,215,7,0,9,68,True,0,0,0,1114,319,165.03972222222222,Document
Erlang,2054,12122,3762.266655092593,MERGED,0,5,1,1,1,71,False,0,1,1,1073,5,116.73055555555555,Document
Python,2407,12180,203.97260416666666,CLOSED,39,71,18,31,31,0,False,13,18,2,10505,110,2831.954166666667,Document
TypeScript,41369,87411,2897.7840046296296,MERGED,23,0,3,0,3,3,False,0,0,0,2380,23,6.906944444444444,Document
TypeScript,3989,23860,2796.5111226851855,CLOSED,1,1,1,4,1,0,False,1,3,2,1182,2,5.420555555555556,Document
C++,2234,23693,2324.0127546296294,MERGED,24,45,13,1,6,195,False,0,1,1,4526,69,76.04416666666667,Feature
TypeScript,3989,23860,2796.097141203704,MERGED,1,1,1,2,1,162,False,0,2,1,1237,2,15.430833333333334,Bug
TypeScript,2071,16638,1201.9257291666665,MERGED,10,35,5,0,8,0,False,0,0,0,3710,45,320.7102777777778,Document
TypeScript,41369,87411,2897.044861111111,MERGED,3,57,4,6,6,1539,True,4,2,1,2750,60,13.814166666666667,Document
Starlark,440,286,457.4647106481482,CLOSED,0,30,2,3,2,0,False,3,0,0,1242,30,0.21583333333333332,Document
C#,80,125,787.8057986111112,MERGED,134,4128,37,0,18,169,False,0,0,0,1071,4262,115.03777777777778,Document
HTML,11809,87633,121.38300925925927,CLOSED,1,1,1,0,2,5,False,0,0,0,992,2,23.545555555555556,Feature
TypeScript,3989,23860,2795.3071064814812,MERGED,0,4,2,2,1,230,True,0,2,1,1572,4,34.40027777777778,Feature
C#,80,125,780.7762268518518,MERGED,0,4,1,0,1,47,True,0,0,0,1978,4,0.1986111111111111,Document
HTML,11809,87633,122.14193287037038,MERGED,1,1,1,0,1,1,False,0,0,0,983,2,0.7111111111111111,Feature
TypeScript,41369,87411,2896.6716087962964,MERGED,2,2,2,0,1,1,False,0,0,0,2398,4,0.8894444444444445,Document
Python,968,6759,22.048819444444444,MERGED,1,1,1,0,1,59,False,0,0,0,1398,2,0.021388888888888888,Feature
Go,421,1654,1475.929386574074,MERGED,344,105,7,0,1,36,False,0,0,0,7103,449,26.642222222222223,Bug
TypeScript,41369,87411,2895.7734027777774,MERGED,4,17,3,5,3,21,False,2,3,2,2532,21,20.569444444444443,Document
TypeScript,41369,87411,2895.9536574074077,CLOSED,2,5,1,3,1,370,True,1,2,1,2282,7,11.906944444444445,Document
C++,2234,23693,2323.061712962963,MERGED,584,190,35,2,6,193,False,1,1,1,4928,774,48.22555555555556,Feature
HTML,11809,87633,121.36899305555556,CLOSED,1,1,1,0,1,4,False,0,0,0,1016,2,0.26055555555555554,Feature
Erlang,2054,12122,3762.410023148148,MERGED,1,1,1,0,1,291,False,0,0,0,1110,2,1.3583333333333334,Document
HTML,11809,87633,121.33760416666667,CLOSED,1,1,1,0,1,3,False,0,0,0,975,2,0.03944444444444444,Feature
Erlang,2054,12122,3762.371331018519,MERGED,3,8,2,0,1,290,False,0,0,0,1312,11,0.835,Document
Erlang,2054,12122,3761.9524074074075,MERGED,14,20,2,1,1,222,True,1,0,0,1118,34,0.8077777777777778,Document
Erlang,2054,12122,3762.350636574074,CLOSED,1,6,2,1,1,289,False,1,0,0,1226,7,0.5241666666666667,Document
Python,547,7159,2205.632766203704,MERGED,4,11,5,0,6,210,False,0,0,0,1789,15,0.3461111111111111,Document
Starlark,440,286,455.8911342592592,MERGED,0,6,1,0,1,27,False,0,0,0,1151,6,2.831111111111111,Document
C++,363,552,504.5635648148148,MERGED,32,3,3,0,1,176,False,0,0,0,1466,35,0.8772222222222222,Document
TypeScript,2071,16638,1208.3251273148148,CLOSED,4,25,4,4,1,0,False,2,2,1,3705,29,0.1436111111111111,Document
HTML,11809,87633,120.25738425925925,MERGED,0,5,2,1,1,2,False,1,0,0,1096,5,17.211666666666666,Feature
Erlang,2054,12122,3759.313773148148,MERGED,313,4492,60,2,32,123,False,1,1,1,1340,4805,86.35861111111112,Document
HTML,11809,87633,119.06280092592591,CLOSED,0,1,1,0,1,2,False,0,0,0,1063,1,53.85166666666667,Feature
HTML,11809,87633,119.0569212962963,CLOSED,0,5,1,0,1,0,False,0,0,0,1134,5,53.98861111111111,Feature
HTML,11809,87633,119.09391203703704,MERGED,1,7,2,0,2,0,False,0,0,0,1134,8,45.18972222222222,Feature
C++,363,552,504.2347685185185,MERGED,94,92,6,0,1,174,False,0,0,0,1479,186,0.9888888888888889,Document
Vue,0,1,213.40170138888888,MERGED,189,242,8,2,1,110,True,1,1,1,6572,431,18.10638888888889,Bug
C++,363,552,504.0406712962963,MERGED,66,67,11,0,1,173,False,0,0,0,1657,133,1.0272222222222223,Document
TypeScript,3392,2334,935.1071759259258,MERGED,14,23,2,1,2,609,False,0,1,1,1509,37,1.9066666666666667,Bug
TypeScript,4,33,729.6642361111111,MERGED,10,11,1,2,1,550,True,1,1,1,1523,21,0.043333333333333335,Bug
TypeScript,3392,2334,935.0059490740741,MERGED,1,3,1,2,1,328,False,0,2,1,1374,4,2.026388888888889,Bug
TypeScript,4,33,729.6123611111111,MERGED,1,13,3,2,1,549,True,1,1,1,1273,14,0.5641666666666667,Feature
C++,363,552,503.43574074074075,MERGED,34,10,4,0,1,171,False,0,0,0,1688,44,12.830833333333333,Document
Erlang,2054,12122,3759.9147222222223,MERGED,14,18,13,0,3,323,True,0,0,0,1201,32,3.2066666666666666,Document
Python,72,25,1601.9433680555555,MERGED,470,975,9,0,15,72,False,0,0,0,7636,1445,714.8463888888889,Bug
TypeScript,4,33,729.4411805555555,MERGED,1,1,1,2,1,548,True,1,1,1,1059,2,0.22416666666666665,Feature
Erlang,2054,12122,3760.1890625,CLOSED,2,2,1,0,1,9,False,0,0,0,1082,4,27.845833333333335,Document
TypeScript,4,33,729.3822916666667,MERGED,65,88,3,1,5,348,False,0,1,1,1571,153,0.08416666666666667,Feature
TypeScript,4,33,729.3101736111112,MERGED,2,2,1,0,1,133,False,0,0,0,1100,4,0.23444444444444446,Document
C++,2234,23693,2321.8778356481484,MERGED,0,6,1,1,1,508,False,0,1,1,1414,6,0.2536111111111111,Document
TypeScript,4,33,729.2609837962963,MERGED,2,13,2,2,2,545,True,1,1,1,1344,15,0.6263888888888889,Bug
TypeScript,4,33,729.1180787037038,MERGED,1,1,1,2,1,544,True,1,1,1,1238,2,0.058333333333333334,Feature
Starlark,440,286,455.9946412037037,MERGED,2,4,1,0,10,2,False,0,0,0,1904,6,283.5127777777778,Bug
C++,363,552,503.30275462962965,MERGED,5,1,1,0,1,169,False,0,0,0,1279,6,0.7480555555555556,Document
Erlang,2054,12122,3759.124386574074,MERGED,3,119,8,1,4,133,False,0,1,1,1341,122,48.26222222222222,Document
TypeScript,41369,87411,2904.5904976851853,MERGED,3,41,2,1,10,63,True,0,1,1,3268,44,70.25805555555556,Document
HTML,11809,87633,119.06025462962963,CLOSED,0,1,1,0,1,1,False,0,0,0,1154,1,0.01361111111111111,Feature
Erlang,2054,12122,3760.0238425925927,MERGED,30,82,6,0,5,966,True,0,0,0,1278,112,3.9255555555555555,Document
Erlang,2054,12122,3759.839027777778,MERGED,9,30,1,0,1,474,False,0,0,0,1157,39,1.7802777777777778,Document
Starlark,440,286,457.9861226851852,MERGED,0,157,3,3,6,0,False,3,0,0,2656,157,643.3327777777778,Feature
C++,363,552,503.05277777777775,MERGED,19,66,8,1,4,168,False,0,1,1,5122,85,6.741944444444444,Document
Erlang,2054,12122,3759.1961458333335,MERGED,3,11,6,0,3,964,True,0,0,0,1117,14,22.240277777777777,Document
TypeScript,4,33,728.0811342592592,MERGED,2,2,1,2,1,177,True,1,1,1,1252,4,0.05527777777777778,Bug
JavaScript,5139,7048,1170.6103587962964,MERGED,167,295,7,2,6,99,False,1,1,1,5777,462,101.04527777777778,Document
Erlang,2054,12122,3759.0792592592593,MERGED,6,10,4,1,1,221,True,1,0,0,1201,16,6.116388888888889,Document
C#,80,125,784.7929050925926,MERGED,1,1,1,0,3,29,False,0,0,0,1043,2,68.9775,Document
F#,33,60,2218.26712962963,MERGED,18,66,1,0,1,15,True,0,0,0,6868,84,41.53777777777778,Bug
Erlang,2054,12122,3758.9925462962965,CLOSED,3,17,4,0,2,132,False,0,0,0,1026,20,3.1430555555555557,Document
TypeScript,216,520,1658.2340162037037,MERGED,134,881,44,2,8,154,False,1,1,1,1172,1015,285.6125,Feature
Python,19248,70257,2420.8009027777775,CLOSED,206,62,6,3,4,245,False,1,2,2,1035,268,112.46916666666667,Bug
Erlang,2054,12122,3756.1635532407404,MERGED,13,21,5,0,3,285,False,0,0,0,1024,34,76.7161111111111,Document
Go,3,15,838.9970023148148,MERGED,7,28,3,7,2,12,False,2,5,1,1573,35,1.73,Document
TypeScript,41369,87411,2903.5376041666664,MERGED,15,5,1,0,1,1878,True,0,0,0,3425,20,2.0005555555555556,Document
Starlark,440,286,457.4784143518518,MERGED,0,30,2,1,1,2,False,1,0,0,1893,30,108.48972222222223,Document
C#,80,125,780.7317013888888,MERGED,84,167,22,1,9,168,False,1,0,0,1027,251,143.93055555555554,Document
C#,80,125,779.7114236111111,MERGED,37,47,1,0,1,157,False,0,0,0,5066,84,160.89083333333335,Document
JavaScript,5139,7048,1170.8217824074075,MERGED,38,35,7,1,1,72,False,0,1,1,6430,73,0.12111111111111111,Document
C#,80,125,779.9587499999999,MERGED,29,47,2,1,8,172,False,0,1,1,1514,76,158.33,Document
TypeScript,41369,87411,2901.510555555555,MERGED,1,1943,11,0,4,1541,True,0,0,0,3098,1944,1.8547222222222222,Document
JavaScript,5139,7048,1168.9118402777779,MERGED,66,390,10,2,7,0,False,0,2,2,1255,456,62.672222222222224,Bug
Erlang,2054,12122,3761.2781712962965,MERGED,30,1956,29,1,2,288,False,1,0,0,1605,1986,146.96944444444443,Document
TypeScript,4,33,729.4286226851851,MERGED,352,457,13,1,12,135,False,0,1,1,1992,809,147.58555555555554,Document
TypeScript,41369,87411,2901.6112152777782,MERGED,2,16,2,0,2,62,True,0,0,0,3335,18,1.1030555555555555,Document
Go,11875,71337,2655.8691435185187,MERGED,16,520,13,0,1,273,True,0,0,0,5179,536,0.19527777777777777,Feature
TypeScript,4,33,730.1853587962963,MERGED,4,11,1,2,2,179,True,1,1,1,1792,15,75.125,Document
JavaScript,5139,7048,1168.909675925926,CLOSED,0,2,1,1,1,82,False,0,1,1,1435,2,0.08694444444444445,Document
TypeScript,41369,87411,2900.932210648148,MERGED,12,6,2,0,1,373,True,0,0,0,4307,18,0.6194444444444445,Document
Starlark,440,286,457.47462962962965,CLOSED,0,30,2,0,3,1,False,0,0,0,1740,30,0.014722222222222222,Document
TypeScript,41369,87411,2900.7907638888887,MERGED,1,11,2,1,2,1876,True,0,1,1,3265,12,4.0025,Document
TypeScript,41369,87411,2900.4865509259257,MERGED,77,75,4,0,2,551,True,0,0,0,3459,152,0.6897222222222222,Document
Rust,433,2229,195.3736458333333,MERGED,3,12,3,1,3,559,False,0,1,1,1504,15,30.474722222222223,Bug
Python,19248,70257,2419.850451388889,CLOSED,3,62,5,1,1,128,False,1,0,0,5105,65,6.391111111111111,Document
Python,4515,54977,890.608587962963,MERGED,1,613,3,1,20,78,True,1,0,0,3351,614,1241.9647222222222,Document
C++,363,552,503.55749999999995,MERGED,4,15,4,0,4,172,False,0,0,0,2150,19,80.58222222222223,Document
Starlark,440,286,456.69722222222225,MERGED,3,6,1,0,1,35,False,0,0,0,1717,9,0.2875,Bug
Starlark,440,286,456.5954398148148,MERGED,25,20,1,0,1,33,False,0,0,0,2284,45,2.7555555555555555,Document
TypeScript,41369,87411,2897.8520717592596,MERGED,13,117,2,7,3,0,False,3,4,2,3955,130,62.12222222222222,Document
C,5529,39699,25.888206018518517,MERGED,4,37,1,0,1,12,True,0,0,0,2222,41,2.9008333333333334,Feature
C#,80,125,787.8416087962963,MERGED,60,90,5,0,3,48,True,0,0,0,1905,150,66.09944444444444,Document
TypeScript,0,0,113.79174768518517,CLOSED,186,176,10,0,6,10,False,0,0,0,8856,362,314.30694444444447,Feature
C++,363,552,504.3063541666667,MERGED,0,278,2,0,1,175,False,0,0,0,1852,278,2.9458333333333333,Document
TypeScript,3392,2334,934.9670833333333,MERGED,3,7,2,1,1,69,False,0,1,1,1895,10,3.2733333333333334,Feature
JavaScript,9664,43889,3623.2876273148145,MERGED,2,2,1,1,1,0,False,0,1,1,1797,4,41.33083333333333,Bug
TypeScript,4,33,729.4294560185185,MERGED,32,38,3,1,1,136,False,0,1,1,1691,70,0.08861111111111111,Feature
TypeScript,4,33,729.3561689814815,MERGED,20,45,5,1,3,347,False,0,1,1,2237,65,0.505,Feature
TypeScript,4,33,729.323587962963,MERGED,3,3,1,1,2,134,False,0,1,1,1760,6,0.034166666666666665,Feature
TypeScript,4,33,729.2758680555556,MERGED,30,21,5,2,3,546,True,1,1,1,2074,51,1.2591666666666668,Bug
TypeScript,3706,54073,1324.3302662037038,MERGED,59,45,2,0,1,26,True,0,0,0,2045,104,0.5022222222222222,Feature
TypeScript,3706,54073,1324.2443171296297,MERGED,3183,3473,3,0,1,25,True,0,0,0,2225,6656,2.4883333333333333,Bug
TypeScript,7045,76149,2587.526712962963,MERGED,10,1107,10,5,1,86,False,0,5,2,4256,1117,0.5336111111111111,Document
C++,2234,23693,2317.0328472222222,MERGED,14,6,4,2,11,275,False,0,2,2,1932,20,163.17472222222221,Feature
Erlang,2054,12122,3760.079918981481,MERGED,3,54,5,0,1,287,False,0,0,0,1794,57,0.7680555555555556,Document
TypeScript,41369,87411,2896.5955902777782,MERGED,10,77,6,2,4,37,False,1,1,1,3368,87,21.791944444444443,Document
JavaScript,9664,43889,3623.081990740741,MERGED,3,0,1,0,1,239,True,0,0,0,1909,3,0.044444444444444446,Feature
TypeScript,4,33,728.1536111111112,MERGED,2,5,1,2,2,542,True,1,1,1,1575,7,1.5375,Bug
F#,153,337,2886.716979166667,MERGED,331,627,8,3,10,22,False,2,1,1,9569,958,97.15138888888889,Document
Erlang,2054,12122,3756.111145833333,MERGED,292,639,21,3,1,284,False,2,1,1,1569,931,103.38305555555556,Document
Rust,433,2229,200.6237152777778,MERGED,4,10,1,0,1,75,False,0,0,0,1887,14,0.6147222222222222,Feature
Starlark,440,286,457.8209606481482,MERGED,49,67,20,1,15,41,False,0,1,1,3197,116,238.96722222222223,Document
Go,3,15,839.086550925926,MERGED,1,2,1,1,1,10,False,1,0,0,1731,3,0.029444444444444443,Document
TypeScript,4,33,722.3027777777778,MERGED,204,396,22,2,21,171,True,1,1,1,2121,600,138.4311111111111,Bug
Starlark,440,286,457.2152430555555,MERGED,0,196,2,0,4,20,False,0,0,0,2816,196,253.45166666666665,Feature
JavaScript,8844,63474,4045.3922222222222,MERGED,10,272,14,0,7,155,True,0,0,0,5503,282,114.96388888888889,Feature
C#,80,125,786.7629282407407,MERGED,40,200,15,0,28,179,False,0,0,0,2340,240,285.3961111111111,Document
C#,80,125,784.9312731481482,MERGED,27,34,5,0,12,178,False,0,0,0,2415,61,350.87388888888887,Document
TypeScript,3989,23860,2792.9105092592595,MERGED,3,3,1,2,2,161,False,0,2,1,2176,6,274.37166666666667,Document
TypeScript,4803,40784,3718.807928240741,CLOSED,9,7,1,0,4,134,True,0,0,0,2464,16,0.03638888888888889,Feature
Python,4515,54977,885.7477083333333,MERGED,28,58,6,12,7,0,False,5,7,2,5533,86,1972.8013888888888,Document
JavaScript,5139,7048,1170.0550694444444,MERGED,16,715,16,3,28,41,False,1,2,2,9570,731,39.86416666666667,Feature
TypeScript,1416,21916,249.8640162037037,MERGED,8,18,3,3,2,33,False,0,3,3,3174,26,1.3183333333333334,Bug
Starlark,440,286,457.20609953703706,CLOSED,0,168,2,0,5,19,False,0,0,0,2731,168,0.11388888888888889,Feature
Starlark,440,286,456.60276620370365,MERGED,14,33,1,0,2,34,False,0,0,0,3046,47,2.566388888888889,Feature
Python,4515,54977,885.3953124999999,CLOSED,2,2,1,8,2,2,False,2,6,4,3212,4,84.515,Document
C++,2234,23693,2321.715358796296,MERGED,15,16,7,2,3,281,False,2,0,0,2723,31,50.79472222222222,Feature
Python,547,7159,2205.586909722222,MERGED,12,15,3,0,4,209,False,0,0,0,2976,27,0.1925,Document
JavaScript,9664,43889,3624.89556712963,MERGED,7,11,3,0,1,255,True,0,0,0,2853,18,0.6797222222222222,Document
TypeScript,41369,87411,2904.7282291666666,MERGED,69,73,24,1,3,41,False,1,0,0,5448,142,27.93027777777778,Document
C++,2234,23693,2316.9707060185187,MERGED,5,32,4,0,11,274,False,0,0,0,2702,37,164.66611111111112,Feature
TypeScript,41369,87411,2903.7374768518516,MERGED,3563,162,11,0,5,1545,True,0,0,0,4979,3725,16.960555555555555,Document
Rust,433,2229,200.63564814814814,MERGED,30,37,11,0,2,76,False,0,0,0,2901,67,0.4811111111111111,Bug
Rust,413,5117,430.7431365740741,MERGED,37,86,8,0,6,185,False,0,0,0,2638,123,48.27194444444444,Document
Java,450,746,4037.152928240741,MERGED,2,30,4,2,3,130,False,0,2,1,2411,32,20.9425,Feature
TypeScript,149,2900,342.0089699074074,CLOSED,364,3550,63,6,30,66,False,3,3,2,6912,3914,1606.951388888889,Bug
TypeScript,41369,87411,2901.6809953703705,MERGED,8682,6556,17,0,6,1543,True,0,0,0,7538,15238,1.3263888888888888,Document
TypeScript,41369,87411,2900.589131944444,MERGED,107,210,9,1,9,1874,True,0,1,1,7425,317,0.5072222222222222,Document
TypeScript,41369,87411,2898.8546643518516,MERGED,36,162,12,1,13,60,True,0,1,1,4898,198,17.630555555555556,Document
Rust,433,2229,196.54516203703704,MERGED,28,24,4,1,2,70,False,0,1,1,2333,52,0.9669444444444445,Bug
TypeScript,41369,87411,2896.6467013888887,MERGED,49,60,4,4,1,372,True,1,3,2,5219,109,46.49861111111111,Document
TypeScript,41369,87411,2896.465405092593,MERGED,113,107,7,0,6,371,True,0,0,0,7547,220,4.133333333333334,Document
Go,2083,11768,1479.3289699074076,MERGED,564,478,84,0,3,844,True,0,0,0,7157,1042,0.16277777777777777,Document
Python,4515,54977,885.5843287037037,MERGED,169,345,4,0,3,77,True,0,0,0,6894,514,1431.7205555555556,Document
TypeScript,149,2900,344.99381944444445,MERGED,2,452,11,5,6,67,False,2,3,2,4209,454,137.75861111111112,Feature
Python,2407,12180,198.92107638888888,MERGED,11,44,3,11,17,0,False,3,8,1,2941,55,335.9975,Document
JavaScript,22,26,877.5697106481481,MERGED,30,427,12,3,9,9,True,1,2,2,3903,457,216.0872222222222,Feature
TypeScript,3392,2334,935.2747106481482,MERGED,61,280,6,1,17,610,False,0,1,1,4058,341,3.4580555555555557,Feature
TypeScript,216,520,1662.9079282407408,MERGED,226,721,22,0,1,50,False,0,0,0,10299,947,73.55222222222223,Bug
TypeScript,3706,54073,1323.4439583333333,MERGED,29,106,1,0,2,24,True,0,0,0,4130,135,9.926111111111112,Feature
Java,1,10,197.8333912037037,MERGED,5,13,1,0,2,18,True,0,0,0,3239,18,0.04055555555555555,Document
Rust,433,2229,201.47515046296294,MERGED,10,33,2,2,2,190,False,1,1,1,3738,43,0.55,Bug
TypeScript,41369,87411,2898.9089351851853,MERGED,25,83,3,7,10,1871,True,1,6,3,10298,108,40.02916666666667,Bug
TypeScript,41369,87411,2898.963611111111,MERGED,4052,12258,140,1,42,1872,True,0,1,1,7963,16310,0.33055555555555555,Document
TypeScript,41369,87411,2898.5835763888886,CLOSED,4052,12258,140,1,42,1868,True,0,1,1,8195,16310,9.1075,Document
Erlang,2054,12122,3761.918101851852,MERGED,5,8,2,1,2,319,True,0,1,1,4582,13,768.93,Document
Java,1,10,197.99402777777777,MERGED,4950,169,17,0,23,19,True,0,0,0,15335,5119,0.4777777777777778,Document
TypeScript,41369,87411,2904.4457291666663,MERGED,83,979,28,1,11,1879,True,0,1,1,12911,1062,0.4436111111111111,Document
TypeScript,3392,2334,935.4027083333334,MERGED,115,284,9,4,25,0,False,1,3,2,5529,399,310.21194444444444,Feature
TypeScript,41369,87411,2898.9052083333336,MERGED,276,395,38,1,15,1870,True,0,1,1,13612,671,0.4691666666666667,Document
Go,54,353,692.1041550925926,MERGED,1658,2422,46,4,37,196,True,2,2,2,17885,4080,883.2113888888889,Bug
C++,2234,23693,2324.9275578703705,CLOSED,44,140,9,1,10,284,False,1,0,0,7200,184,95.57583333333334,Bug
TypeScript,4,33,728.3143171296297,MERGED,222,296,13,2,4,543,True,1,1,1,6890,518,217.55,Bug
Python,14532,41181,1052.7699305555554,CLOSED,39,84,1,6,2,2,False,3,3,1,4695,123,185.2722222222222,Bug
TypeScript,1416,21916,249.37292824074075,MERGED,41,83,6,3,5,299,True,0,3,3,7927,124,19.158333333333335,Bug
TypeScript,1416,21916,248.7358101851852,MERGED,26,100,9,3,3,69,True,0,3,3,4632,126,1.1675,Bug
TypeScript,184,1377,257.86059027777776,CLOSED,235,325,91,6,1,17,True,2,4,2,7208,560,144.76527777777778,Feature
C,5529,39700,25.800949074074072,MERGED,158,214,3,5,1,10,True,1,4,3,4543,372,4.9366666666666665,Bug
TypeScript,3392,2334,931.9115625,MERGED,95,220,9,1,10,64,False,0,1,1,7237,315,152.88916666666665,Bug
TypeScript,4,33,728.3638773148149,MERGED,887,1536,177,1,29,365,True,0,1,1,5630,2423,70.49305555555556,Document
TypeScript,149,2900,338.6099537037037,CLOSED,1873,1522,185,4,18,155,True,1,3,2,8794,3395,914.6583333333333,Bug
JavaScript,9664,43889,3624.827175925926,MERGED,0,18,7,0,1,19,False,0,0,0,7711,18,0.6113888888888889,Feature
JavaScript,9664,43889,3623.8842245370374,MERGED,43,475,14,0,1,254,True,0,0,0,5655,518,25.429166666666667,Bug
C++,2234,23693,2316.2138078703706,MERGED,5,150,12,0,14,273,False,0,0,0,4878,155,182.83138888888888,Bug
Rust,413,5117,430.83759259259256,MERGED,6,322,8,3,7,0,False,2,1,1,7310,328,49.448055555555555,Document
C#,80,125,780.8839236111112,MERGED,337509,606524,288,0,45,56,False,0,0,0,7110,944033,86.46444444444444,Document
Go,789,5551,1007.227025462963,CLOSED,53,344,18,3,7,12,False,2,1,1,9241,397,331.43944444444446,Document
TypeScript,1416,21916,247.31512731481482,MERGED,42,252,17,8,11,7,False,1,7,5,8318,294,160.39138888888888,Document
JavaScript,9664,43889,3625.1193634259257,MERGED,13,175,8,0,3,256,True,0,0,0,9163,188,96.61027777777778,Bug
TypeScript,41369,87411,2898.8797569444446,CLOSED,276,396,38,1,13,1869,True,0,1,1,13828,672,0.5772222222222222,Document
TypeScript,3392,2334,934.0882060185186,MERGED,40,98,12,1,9,250,False,0,1,1,8840,138,26.47222222222222,Bug
Rust,413,5117,427.07666666666665,MERGED,253,133,31,0,5,256,False,0,0,0,8880,386,232.095,Document
C,5529,39700,19.183958333333333,CLOSED,108,185,6,4,7,0,False,1,3,2,9176,293,23.820555555555554,Document
TypeScript,4,33,728.5825694444444,MERGED,158,324,26,1,9,346,False,0,1,1,10210,482,13.869722222222222,Bug
Rust,413,5117,429.8476388888889,MERGED,53,54,17,0,1,257,False,0,0,0,11399,107,4.730277777777777,Document
Rust,591,3260,515.096099537037,MERGED,19065,21499,247,2,59,172,True,2,0,0,15277,40564,649.8527777777778,Feature
Go,1835,11245,1692.1813194444446,MERGED,1301,714,21,1,1,32,False,0,1,1,12154,2015,68.3561111111111,Document
Rust,433,2229,195.69244212962963,MERGED,366,475,31,8,21,69,False,4,4,3,28671,841,139.45416666666668,Feature
TypeScript,42,46,738.0144328703703,MERGED,12,20,2,2,1,69,True,0,2,2,11343,32,237.22333333333333,Feature
Rust,433,2229,203.49729166666668,MERGED,613,797,40,2,7,77,False,1,1,1,16280,1410,72.15333333333334,Feature
TypeScript,15,34,464.4697453703704,CLOSED,1,0,1,0,5,147,False,0,0,0,403,1,2128.4194444444443,Bug
JavaScript,3618,9017,2261.5280902777777,CLOSED,1,2,1,0,1,230,False,0,0,0,1366,3,3.5775,Bug
C#,80,125,791.5608912037037,CLOSED,37,0,1,0,1,152,True,0,0,0,363,37,3073.2122222222224,Document
TypeScript,2147,14722,1444.7791435185184,MERGED,0,5,1,0,2,654,False,0,0,0,670,5,4.050277777777778,Feature
TypeScript,202,107,1118.801412037037,MERGED,5,24,1,3,8,198,True,0,3,3,1372,29,3.6719444444444442,Document
TypeScript,202,107,1116.7567592592593,CLOSED,1180,337,3,3,1,196,True,0,3,3,1849,1517,1.3347222222222221,Document
TypeScript,2147,14722,1447.0986342592594,MERGED,24,14,3,0,2,659,False,0,0,0,2859,38,68.86027777777778,Feature
Erlang,2054,12122,3767.249606481482,CLOSED,8,15,1,0,1,137,False,0,0,0,978,23,2367.4466666666667,Document
C#,80,125,793.848761574074,CLOSED,36,13,3,1,2,19,False,0,1,1,1695,49,3018.3233333333333,Bug
Python,24585,55553,4617.4163078703705,MERGED,1,9,2,2,11,1,False,2,0,0,342,10,1917.4219444444445,Feature
Go,433,6740,809.94625,MERGED,0,5,1,1,2,574,True,1,0,0,1460,5,0.4533333333333333,Bug
Rust,264,5382,380.10555555555555,MERGED,0,21,2,0,1,189,True,0,0,0,1071,21,3.0825,Feature
Go,11875,71337,2672.7186921296297,MERGED,177,233,21,0,2,277,True,0,0,0,372,410,0.06388888888888888,Feature
JavaScript,3618,9017,2256.662476851852,MERGED,1,2,1,1,1,1773,False,0,1,1,901,3,0.445,Bug
JavaScript,3618,9017,2260.5728703703703,MERGED,181,18,8,10,7,1778,False,7,3,3,684,199,268.31,Bug
Vue,293,495,803.9862384259259,MERGED,95,63,7,16,13,364,True,5,11,5,258,158,1023.5416666666666,Feature
JavaScript,3618,9017,2257.726550925926,MERGED,143,115,6,7,3,1776,False,3,4,2,1632,258,498.4169444444444,Feature
TypeScript,178,1359,298.85542824074076,MERGED,1,2,1,1,2,10,False,0,1,1,579,3,3.5844444444444443,Feature
TypeScript,7,6,618.2526157407407,CLOSED,132,1288,39,1,10,239,False,0,1,1,4536,1420,1791.7930555555556,Feature
PHP,1334,2960,4181.971736111112,MERGED,15,4,1,0,1,56,False,0,0,0,1693,19,743.9944444444444,Document
TypeScript,42,46,744.7121759259259,MERGED,645,751,35,1,13,58,False,0,1,1,685,1396,451.25305555555553,Feature
Go,11875,71337,2666.9278703703703,MERGED,7,11,1,0,1,276,True,0,0,0,1570,18,0.06472222222222222,Feature
TypeScript,178,1359,298.79901620370373,MERGED,1,24,6,2,1,13,True,1,1,1,1113,25,4.919444444444444,Feature
TypeScript,184,1377,264.3999884259259,CLOSED,475,543,94,2,3,21,False,0,2,2,526,1018,509.2561111111111,Feature
Go,421,1654,1480.876423611111,MERGED,1,1,1,0,1,6,False,0,0,0,981,2,0.6277777777777778,Bug
TypeScript,178,1359,298.4434375,MERGED,1,1,1,1,1,11,True,0,1,1,806,2,13.329444444444444,Bug
TypeScript,2147,14722,1446.8486574074075,MERGED,1,2,1,0,1,98,False,0,0,0,582,3,1.5016666666666667,Bug
TypeScript,2147,14722,1446.2378819444446,MERGED,1,1,1,0,1,68,False,0,0,0,660,2,12.835833333333333,Bug
TypeScript,202,107,1117.0569560185186,MERGED,45,146,3,5,6,233,True,0,5,4,2550,191,636.8561111111111,Bug
Rust,264,5382,375.91687499999995,MERGED,13,9,1,0,2,178,True,0,0,0,1893,22,0.09527777777777778,Document
Go,789,5551,1012.8379166666667,MERGED,0,2,1,0,1,414,False,0,0,0,1693,2,0.5152777777777777,Document
TypeScript,2147,14722,1445.029675925926,MERGED,1,1,1,0,1,58,False,0,0,0,531,2,2.868611111111111,Feature
Rust,417,2801,896.3623958333333,MERGED,2,119,1,0,2,202,False,0,0,0,959,121,38.585,Document
TypeScript,178,1359,295.9260185185185,CLOSED,2,6,1,2,1,2,True,0,2,2,1241,8,10.882222222222222,Feature
TypeScript,2147,14722,1442.8956944444444,MERGED,6,10,1,0,3,146,False,0,0,0,573,16,1.496388888888889,Feature
C++,2234,23693,2334.7879398148148,MERGED,0,6,1,1,1,187,False,0,1,1,536,6,0.015277777777777777,Feature
JavaScript,8844,63474,4049.320833333333,MERGED,21,618,81,3,8,62,True,0,3,2,628,639,264.6775,Bug
TypeScript,178,1359,295.7358449074074,MERGED,1,1,1,2,1,1,True,0,2,2,947,2,5.493333333333333,Document
TypeScript,2147,14722,1443.7904513888889,MERGED,1,1,1,0,1,0,False,0,0,0,627,2,32.54194444444445,Document
TypeScript,2071,16638,1218.117013888889,MERGED,1,1,1,0,1,0,False,0,0,0,2416,2,2.0225,Document
TypeScript,178,1359,292.4308564814815,MERGED,2,3,1,0,1,8,False,0,0,0,658,5,6.065833333333333,Feature
TypeScript,178,1359,292.2990046296296,MERGED,1,1,1,0,1,3,True,0,0,0,668,2,0.057777777777777775,Feature
Python,142,422,2381.2625347222224,MERGED,298,319,13,0,3,18,True,0,0,0,499,617,0.3775,Feature
TypeScript,178,1359,291.41976851851854,MERGED,1,12,1,0,1,7,False,0,0,0,704,13,17.463055555555556,Feature
C++,2234,23693,2333.6775578703705,MERGED,1,1,1,2,1,0,False,1,1,1,678,2,50.04694444444444,Document
C++,2234,23693,2331.9928587962963,CLOSED,818,2,2,1,2,184,False,0,1,1,601,820,160.94916666666666,Feature
TypeScript,7,6,617.2049768518518,MERGED,6,3,1,1,2,274,False,0,1,1,1618,9,0.2652777777777778,Document
JavaScript,5139,7048,1176.770162037037,CLOSED,0,128,4,8,5,0,False,1,7,5,1345,128,475.4075,Feature
Go,421,1654,1482.0816435185186,CLOSED,3,38,25,0,1,226,False,0,0,0,1091,41,146.07527777777779,Bug
TypeScript,2147,14722,1446.224386574074,CLOSED,2,2,2,0,1,654,False,0,0,0,945,4,0.245,Document
TypeScript,2147,14722,1443.0032638888888,MERGED,1,0,1,0,1,147,False,0,0,0,686,1,4.398055555555556,Bug
Go,395,660,1238.1277314814815,CLOSED,3,0,2,0,1,60,False,0,0,0,206,3,690.7380555555555,Feature
JavaScript,8844,63474,4048.0878125,MERGED,3,35,18,5,3,5,False,2,3,2,1752,38,676.1425,Bug
TypeScript,178,1359,298.4986111111111,MERGED,1,135,2,3,3,12,True,1,2,2,1048,136,12.036111111111111,Feature
TypeScript,2147,14722,1444.9823379629631,MERGED,71,64315,43,0,10,652,False,0,0,0,374,64386,3.8594444444444442,Feature
JavaScript,5139,7048,1180.3816666666667,MERGED,5,5,5,13,2,0,False,2,11,6,837,10,65.37666666666667,Bug
TypeScript,261,3765,652.4324421296296,MERGED,6,14,2,0,2,813,True,0,0,0,1399,20,25.19527777777778,Document
TypeScript,15,34,461.49921296296293,CLOSED,155,0,3,0,1,295,False,0,0,0,1936,155,799.8480555555556,Bug
PHP,1334,2960,4181.239502314815,MERGED,4,0,1,0,1,148,False,0,0,0,890,4,92.52444444444444,Bug
TypeScript,2147,14722,1446.7928124999999,MERGED,4,8,2,1,1,658,False,1,0,0,1585,12,128.51777777777778,Bug
JavaScript,8844,63474,4052.523564814815,CLOSED,149,571,43,10,14,0,False,2,8,3,3961,720,1456.358888888889,Bug
TypeScript,202,107,1118.831076388889,MERGED,11,2,1,4,1,235,True,0,4,4,1229,13,0.36138888888888887,Bug
TypeScript,178,1359,297.6378935185185,MERGED,1,1,1,1,1,0,False,0,1,1,1049,2,9.5575,Bug
V,2097,34361,1522.7227314814816,MERGED,60,236,16,9,13,151,True,3,6,3,1774,296,901.2163888888889,Bug
TypeScript,178,1359,296.8753125,MERGED,1,40,2,2,2,10,True,1,1,1,1594,41,0.36527777777777776,Feature
TypeScript,178,1359,296.6485763888889,MERGED,3,19,1,2,2,4,True,0,2,2,1179,22,3.5772222222222223,Bug
TypeScript,42,46,742.9365740740741,MERGED,0,12,1,1,1,77,False,0,1,1,328,12,0.9616666666666667,Feature
TypeScript,2147,14722,1442.7745023148148,MERGED,4,5,2,0,2,653,False,0,0,0,885,9,0.9955555555555555,Document
TypeScript,261,3765,649.4415046296297,MERGED,0,15,2,0,1,804,True,0,0,0,1170,15,1.23,Document
JavaScript,5139,7048,1177.1707638888888,MERGED,1,53,2,3,5,43,False,1,2,2,907,54,105.09527777777778,Feature
TypeScript,178,1359,296.2922800925926,MERGED,3,9,2,1,2,9,False,0,1,1,1409,12,0.051111111111111114,Feature
TypeScript,178,1359,295.80707175925926,MERGED,4,43,4,3,4,8,True,1,2,2,1275,47,6.735833333333333,Bug
TypeScript,58,78,793.2440972222222,CLOSED,16,479,13,1,3,166,True,0,1,1,1234,495,48.526944444444446,Feature
Go,421,1654,1483.0518287037037,MERGED,0,47,3,3,1,0,False,1,2,2,993,47,2.1661111111111113,Bug
TypeScript,261,3765,649.8977199074073,MERGED,1,12,2,1,3,86,True,0,1,1,1338,13,14.613055555555556,Document
TypeScript,261,3765,649.857048611111,MERGED,0,7,1,0,1,85,False,0,0,0,1111,7,13.149166666666666,Document
JavaScript,965,5240,3971.753912037037,MERGED,40,18,7,4,9,209,True,2,2,1,232,58,29.17222222222222,Bug
TypeScript,261,3765,648.6640046296296,MERGED,12,4,1,0,3,802,True,0,0,0,1949,16,19.36888888888889,Document
TypeScript,261,3765,648.6519444444444,MERGED,2,10,1,0,1,801,True,0,0,0,1145,12,0.11416666666666667,Document
TypeScript,261,3765,650.7385185185185,MERGED,1,2,1,2,2,0,False,0,2,1,842,3,92.8075,Feature
TypeScript,261,3765,649.4880208333333,MERGED,0,16,2,0,2,805,True,0,0,0,1594,16,7.090277777777778,Document
C++,2234,23693,2330.872048611111,MERGED,92,0,1,1,1,288,False,0,1,1,734,92,1.4805555555555556,Feature
Rust,264,5382,380.08495370370366,MERGED,2,5,1,0,2,188,True,0,0,0,852,7,3.5875,Feature
Rust,264,5382,380.06927083333335,MERGED,0,22,1,0,1,187,True,0,0,0,819,22,0.04666666666666667,Feature
JavaScript,3618,9017,2257.5878819444447,CLOSED,87,147,6,10,4,1774,False,6,4,1,1427,234,144.71555555555557,Bug
Vue,0,1,214.93484953703705,MERGED,1,1,1,1,1,28,False,0,1,1,612,2,0.010833333333333334,Feature
TypeScript,178,1359,298.75430555555556,MERGED,9,21,2,1,1,3,True,0,1,1,1910,30,5.926111111111111,Feature
TypeScript,15,34,466.5630439814815,MERGED,1,2,1,1,1,455,True,1,0,0,778,3,17.322777777777777,Bug
TypeScript,261,3765,653.5262847222222,MERGED,10,33,5,0,6,26,True,0,0,0,2195,43,4.311944444444444,Document
TypeScript,261,3765,653.5429513888889,MERGED,2,9,2,0,3,88,True,0,0,0,1808,11,2.438888888888889,Document
Go,11875,71337,2668.388877314815,MERGED,1,1,1,0,1,0,False,0,0,0,598,2,2.299722222222222,Bug
Go,4154,13945,1891.3119328703704,MERGED,2,2,2,3,1,303,False,3,0,0,336,4,215.29361111111112,Bug
TypeScript,178,1359,293.8694097222222,MERGED,2,20,2,0,1,0,True,0,0,0,1373,22,0.11805555555555555,Feature
TypeScript,15,34,463.6582407407407,MERGED,0,4,1,0,1,857,False,0,0,0,526,4,2.276388888888889,Bug
TypeScript,178,1359,297.98319444444445,MERGED,19,6,1,2,2,5,True,0,2,2,1868,25,1.2555555555555555,Bug
F#,271,818,2705.1584259259257,MERGED,1,1,1,2,1,5,False,1,1,1,1365,2,0.3277777777777778,Feature
TypeScript,2147,14722,1442.8403819444445,CLOSED,1,8,1,1,1,276,False,0,1,1,1388,9,101.25972222222222,Bug
JavaScript,5139,7048,1172.607175925926,CLOSED,0,3,1,4,1,0,False,0,4,3,736,3,0.24555555555555555,Feature
Blade,0,0,92.98254629629629,MERGED,4,2,1,0,1,5,True,0,0,0,807,6,0.009444444444444445,Document
TypeScript,216,520,1672.8114699074074,CLOSED,0,50,1,1,1,112,False,1,0,0,602,50,102.74666666666667,Feature
TypeScript,2147,14722,1445.2080555555556,MERGED,1,5,2,0,1,150,False,0,0,0,1308,6,2.171111111111111,Feature
TypeScript,2147,14722,1445.0342245370368,MERGED,5,8,2,0,2,67,False,0,0,0,1666,13,3.346111111111111,Feature
TypeScript,2147,14722,1445.0897337962963,MERGED,6,5,3,0,1,656,False,0,0,0,1466,11,0.8325,Bug
TypeScript,202,107,1116.8385416666667,CLOSED,52,409,14,7,11,142,True,1,6,5,1181,461,217.37666666666667,Document
TypeScript,2071,16638,1217.2161921296297,MERGED,1,1,1,0,1,1,False,0,0,0,775,2,0.1661111111111111,Document
TypeScript,7,6,619.0303935185185,MERGED,0,1,1,1,1,208,False,0,1,1,857,1,1.1055555555555556,Bug
TypeScript,2147,14722,1444.198900462963,MERGED,2,3,1,0,1,40,False,0,0,0,1228,5,13.589444444444444,Bug
Go,395,660,1238.963125,MERGED,3,18,2,1,5,33,False,0,1,1,280,21,530.0205555555556,Feature
JavaScript,3618,9017,2257.6991087962965,MERGED,16,129,1,0,2,1775,False,0,0,0,623,145,21.67972222222222,Document
Rust,264,5382,378.0280324074074,MERGED,3,3,2,0,1,185,True,0,0,0,992,6,0.06638888888888889,Document
JavaScript,5139,7048,1172.9032407407408,MERGED,0,5,1,1,1,284,False,0,1,1,702,5,0.016666666666666666,Feature
TypeScript,178,1359,296.6963310185185,MERGED,7,7,1,1,1,2,True,0,1,1,1945,14,2.095833333333333,Bug
TypeScript,2147,14722,1447.0751620370372,MERGED,7,43,3,0,1,41,False,0,0,0,3787,50,670.2036111111111,Feature
C++,2234,23693,2328.9660879629632,MERGED,10784,13089,399,1,4,178,False,0,1,1,823,23873,125.15583333333333,Feature
C++,2234,23693,2327.7147916666668,MERGED,1,2,1,1,1,176,False,0,1,1,721,3,6.009166666666666,Bug
TypeScript,178,1359,296.1315740740741,MERGED,0,13,2,3,2,0,True,0,3,2,1823,13,4.318888888888889,Feature
C++,2234,23693,2327.7203935185184,MERGED,2,4,2,1,1,177,False,0,1,1,690,6,0.02638888888888889,Feature
F#,153,337,2894.6937037037037,MERGED,0,1,1,0,1,134,False,0,0,0,1188,1,0.18861111111111112,Bug
TypeScript,261,3765,650.8332060185186,MERGED,1,12,2,0,1,206,True,0,0,0,1903,13,3.377222222222222,Document
F#,271,818,2703.111261574074,MERGED,3,3,2,0,1,63,True,0,0,0,1382,6,2.3530555555555557,Document
JavaScript,5139,7048,1174.6210185185184,MERGED,7,93,3,2,4,73,False,0,2,2,1063,100,20.182777777777776,Feature
TypeScript,178,1359,295.32965277777777,MERGED,27,30,1,2,1,0,False,0,2,2,1585,57,14.693055555555556,Feature
Rust,264,5382,376.9830555555556,MERGED,2,0,1,0,1,56,True,0,0,0,935,2,0.03944444444444444,Feature
TypeScript,261,3765,650.7612268518518,MERGED,6,31,3,0,1,160,False,0,0,0,1632,37,0.051111111111111114,Document
Python,72,25,1609.7066782407408,MERGED,0,302,1,0,3,15,False,0,0,0,840,302,21.148888888888887,Bug
JavaScript,9664,43889,3631.048645833333,CLOSED,25,319,25,7,9,0,False,4,3,1,977,344,1271.8325,Feature
Python,547,7159,2211.507824074074,MERGED,57,89,3,0,23,66,False,0,0,0,430,146,484.46666666666664,Bug
Rust,417,2801,897.3293634259259,CLOSED,11,12,9,2,1,143,False,0,2,2,3556,23,616.3369444444445,Bug
TypeScript,261,3765,649.9672569444444,MERGED,15,77,4,0,3,811,True,0,0,0,2174,92,12.239444444444445,Document
TypeScript,178,1359,293.8023148148148,MERGED,8,9,4,1,1,1,True,1,0,0,1064,17,1.6775,Bug
TypeScript,15,34,460.60520833333334,MERGED,9,12,1,0,1,849,False,0,0,0,535,21,1.365,Bug
TypeScript,178,1359,298.39516203703704,MERGED,7,188,8,7,3,0,False,4,3,3,4112,195,18.825555555555557,Bug
TypeScript,178,1359,292.8148263888889,MERGED,3,492,11,5,6,5,True,3,2,2,2254,495,78.43111111111111,Feature
F#,153,337,2893.422488425926,MERGED,2,2,1,1,1,36,False,0,1,1,1353,4,2.5452777777777778,Bug
TypeScript,2147,14722,1446.766759259259,MERGED,16,32,1,1,1,657,False,1,0,0,2318,48,0.9744444444444444,Feature
Rust,264,5382,375.9249652777778,MERGED,3,1,1,0,1,179,True,0,0,0,865,4,0.08472222222222223,Feature
TypeScript,261,3765,649.7261574074074,MERGED,10,21,2,0,1,807,True,0,0,0,1819,31,0.39305555555555555,Document
TypeScript,261,3765,649.7131712962963,MERGED,14,17,5,0,6,159,False,0,0,0,2202,31,0.6930555555555555,Document
TypeScript,261,3765,649.7097453703703,MERGED,1,8,2,0,2,142,False,0,0,0,1781,9,0.021388888888888888,Document
TypeScript,261,3765,649.6443055555555,MERGED,3,9,2,0,2,242,True,0,0,0,1679,12,0.32,Document
TypeScript,178,1359,293.52019675925925,MERGED,549,2708,21,10,8,7,True,6,4,3,2126,3257,36.58972222222222,Feature
TypeScript,2147,14722,1446.178263888889,MERGED,1,6,1,0,1,278,False,0,0,0,2145,7,14.418055555555556,Feature
JavaScript,5139,7048,1173.705636574074,CLOSED,1,44,2,1,10,285,False,0,1,1,936,45,11.39611111111111,Feature
TypeScript,261,3765,649.5030324074074,MERGED,11,28,3,0,2,547,True,0,0,0,1843,39,0.4613888888888889,Document
Python,72,25,1608.541585648148,MERGED,26,20,1,0,2,14,False,0,0,0,1182,46,21.263055555555557,Feature
TypeScript,216,520,1672.0208796296295,CLOSED,2,46,1,0,1,156,False,0,0,0,252,48,313.61611111111114,Feature
TypeScript,15,34,464.6393865740741,MERGED,11,11,1,0,1,859,False,0,0,0,815,22,70.8788888888889,Feature
Go,421,1654,1483.9834375,MERGED,2,22,2,0,1,64,False,0,0,0,1873,24,100.5988888888889,Document
Go,421,1654,1482.084212962963,MERGED,4,38,2,0,1,63,False,0,0,0,1497,42,1.2377777777777779,Document
TypeScript,2147,14722,1445.193402777778,MERGED,10,32,3,0,1,277,False,0,0,0,2169,42,20.34611111111111,Document
Go,421,1654,1481.3916203703702,MERGED,4,38,2,0,4,62,False,0,0,0,1426,42,15.631944444444445,Document
C++,2234,23693,2329.953761574074,CLOSED,22,69,3,1,10,11,False,0,1,1,1301,91,259.88138888888886,Bug
PHP,1334,2960,4180.034988425926,MERGED,0,84,2,4,4,54,False,2,2,1,1511,84,1.2138888888888888,Document
PHP,1334,2960,4179.998877314815,MERGED,5557,8,74,1,5,60,False,1,0,0,1533,5565,2.0613888888888887,Document
TypeScript,2147,14722,1445.1971296296297,MERGED,15,23,2,0,1,149,False,0,0,0,2521,38,2.419722222222222,Feature
C++,2234,23693,2328.9147800925925,CLOSED,1,10,2,1,1,513,False,0,1,1,1022,11,2.830277777777778,Bug
TypeScript,307,2556,514.9949189814814,MERGED,8,50,6,1,1,2,False,0,1,1,2592,58,10.745833333333334,Document
TypeScript,7,6,618.1375115740741,MERGED,13055,18832,20,0,63,275,False,0,0,0,1474,31887,163.95222222222222,Feature
TypeScript,261,3765,651.862175925926,MERGED,5,13,3,0,1,44,False,0,0,0,1880,18,0.7788888888888889,Document
Python,547,7159,2210.446412037037,MERGED,13,15,2,0,2,213,False,0,0,0,789,28,1.6041666666666667,Bug
C++,2234,23693,2327.93375,MERGED,7,3,2,1,1,197,False,0,1,1,947,10,3.475,Feature
TypeScript,1416,21916,259.3235648148148,MERGED,2,8,2,2,4,73,True,0,2,2,319,10,0.28694444444444445,Feature
JavaScript,5139,7048,1178.9283449074073,MERGED,6459,6317,14,3,7,0,False,1,2,2,128,12776,65.26027777777777,Feature
TypeScript,2147,14722,1443.772685185185,MERGED,6,9,1,0,2,128,False,0,0,0,2032,15,3.93,Feature
Python,547,7159,2209.85994212963,MERGED,114,141,1,0,10,212,False,0,0,0,1344,255,292.9838888888889,Document
JavaScript,5139,7048,1178.816886574074,MERGED,12,53,6,4,4,44,False,2,2,2,1828,65,97.61111111111111,Feature
JavaScript,8844,63474,4054.284490740741,MERGED,213,202,2,1,1,67,True,0,1,1,1395,415,9.634166666666667,Bug
Rust,264,5382,380.18893518518513,MERGED,6,4,1,0,1,190,True,0,0,0,1112,10,1.1,Feature
Go,421,1654,1479.2230902777776,MERGED,2,2,1,0,1,400,True,0,0,0,1646,4,16.75888888888889,Document
TypeScript,3989,23860,2806.319409722222,MERGED,0,1,1,1,1,234,True,0,1,1,359,1,0.45416666666666666,Feature
TypeScript,2071,16638,1217.9726157407406,MERGED,1,11,2,0,1,72,True,0,0,0,2458,12,2.448611111111111,Bug
TypeScript,7,6,622.0083796296296,CLOSED,26,16,8,2,2,240,False,1,1,1,2019,42,168.01416666666665,Bug
Go,395,660,1236.7280208333334,MERGED,10,14,1,0,1,116,False,0,0,0,196,24,1.4241666666666666,Feature
F#,271,818,2698.1911342592593,MERGED,9,7,1,0,1,10,True,0,0,0,1458,16,0.7311111111111112,Feature
TypeScript,184,1377,264.74104166666666,MERGED,84,2153,69,2,5,22,True,0,2,2,775,2237,9.403333333333334,Document
F#,271,818,2702.350266203704,MERGED,0,178,2,1,1,11,True,0,1,1,2183,178,0.12638888888888888,Document
Vue,0,1,218.36837962962963,CLOSED,0,0,0,0,1,135,True,0,0,0,75,0,0.01138888888888889,Feature
JavaScript,8844,63474,4052.200196759259,MERGED,9,9,4,1,1,2,False,0,1,1,1646,18,1.7352777777777777,Document
C++,2234,23693,2331.969837962963,MERGED,4,12,3,2,1,514,False,1,1,1,1370,16,68.57055555555556,Feature
Rust,264,5382,375.9338078703704,MERGED,3,3,1,0,1,180,True,0,0,0,1159,6,0.02722222222222222,Bug
TypeScript,184,1377,263.4906481481482,MERGED,17,160,10,2,4,0,False,0,2,2,827,177,33.42027777777778,Document
PHP,0,0,81.3308912037037,MERGED,0,52,4,0,3,21,False,0,0,0,1506,52,0.013888888888888888,Document
JavaScript,5139,7048,1174.5361805555556,MERGED,7,16,2,3,2,236,False,0,3,3,1712,23,25.249444444444446,Bug
F#,153,337,2891.250081018519,MERGED,0,7,1,1,1,0,False,0,1,1,1808,7,60.6825,Document
Rust,264,5382,376.0472916666667,MERGED,18,10,2,0,2,243,True,0,0,0,1300,28,1.8377777777777777,Bug
TypeScript,178,1359,295.9072800925926,MERGED,6,15,7,3,4,1,True,1,2,2,3387,21,4.972777777777778,Bug
TypeScript,15,34,462.14481481481477,MERGED,1,1,1,0,1,141,False,0,0,0,908,2,0.041944444444444444,Bug
Python,24585,55553,4623.122673611111,MERGED,1,1,1,4,1,521,False,2,2,1,251,2,1.4975,Bug
JavaScript,5139,7048,1178.0754166666668,MERGED,6477,6460,13,5,11,0,False,2,3,2,220,12937,134.32083333333333,Feature
TypeScript,2071,16638,1217.0383796296296,MERGED,9,15,2,0,2,5,False,0,0,0,1686,24,0.6586111111111111,Bug
TypeScript,15,34,461.48905092592594,MERGED,7,3,1,0,1,852,False,0,0,0,1019,10,0.6675,Feature
TypeScript,15,34,461.4258333333333,MERGED,0,17,1,0,1,138,False,0,0,0,1075,17,2.995,Feature
TypeScript,3392,2334,939.8342129629629,MERGED,0,0,1,1,1,261,False,0,1,1,226,0,0.2152777777777778,Feature
TypeScript,178,1359,294.9925578703704,MERGED,14,20,5,2,3,0,True,0,2,2,2671,34,3.9427777777777777,Bug
TypeScript,261,3765,648.7837499999999,MERGED,0,176,3,0,1,253,True,0,0,0,2363,176,1.4372222222222222,Document
PHP,1334,2960,4179.242951388888,MERGED,569,11,9,0,4,854,False,0,0,0,2076,580,16.625,Document
TypeScript,261,3765,648.6462152777777,MERGED,2,130,4,0,1,800,True,0,0,0,2259,132,0.2569444444444444,Document
TypeScript,1297,21107,391.9586574074074,MERGED,3,7,1,1,1,816,True,0,1,1,1476,10,0.008611111111111111,Document
TypeScript,15,34,460.731099537037,MERGED,11,49,3,0,4,851,False,0,0,0,1072,60,5.780555555555556,Feature
TypeScript,202,107,1116.7019675925926,MERGED,0,6,1,3,2,77,True,0,3,3,2604,6,0.12583333333333332,Document
TypeScript,7045,76149,2605.4965625,MERGED,20176,16605,3,5,1,95,False,0,5,2,1585,36781,0.10361111111111111,Document
TypeScript,7045,76149,2605.4817245370373,MERGED,1852,491,3,5,1,94,False,0,5,2,1429,2343,0.14722222222222223,Bug
Java,1,10,202.09625000000003,MERGED,3,3,1,0,1,21,True,0,0,0,1722,6,0.03666666666666667,Document
TypeScript,261,3765,649.8386111111112,MERGED,10,92,4,0,1,810,True,0,0,0,769,102,20.795833333333334,Document
TypeScript,218,1201,2900.286712962963,MERGED,51,78,9,1,5,296,True,1,0,0,2911,129,278.8666666666667,Bug
Go,395,660,1238.0767824074073,MERGED,1,4,1,0,1,57,False,0,0,0,186,5,0.3402777777777778,Feature
Go,395,660,1240.0938657407407,MERGED,0,3,1,0,1,333,False,0,0,0,241,3,0.013055555555555556,Feature
Go,395,660,1238.0503356481481,MERGED,1,4,1,0,1,54,False,0,0,0,172,5,0.39916666666666667,Feature
Python,547,7159,2211.8060532407408,MERGED,0,1,1,1,8,215,False,0,1,1,554,1,357.94555555555553,Bug
TypeScript,261,3765,649.6994097222222,MERGED,4,4,2,0,3,158,False,0,0,0,1018,8,0.07416666666666667,Document
Erlang,2054,12122,3767.1248842592595,MERGED,62,103,17,2,3,72,False,0,2,2,1122,165,165.48916666666668,Document
TypeScript,178,1359,292.78006944444445,MERGED,453,394,6,0,3,4,True,0,0,0,3012,847,26.20277777777778,Bug
TypeScript,1297,21107,390.3193518518519,CLOSED,25,29,1,2,1,0,False,0,2,2,1581,54,6.639444444444444,Bug
Go,395,660,1237.9638194444444,CLOSED,100,235,5,1,11,55,False,0,1,1,382,335,189.43805555555556,Feature
JavaScript,9664,43889,3631.9757986111113,MERGED,99,42,2,0,1,260,True,0,0,0,550,141,309.8727777777778,Bug
TypeScript,1297,21107,389.7263310185185,CLOSED,3,3,1,4,1,0,False,1,3,2,1268,6,20.890833333333333,Document
Go,395,660,1236.789988425926,MERGED,0,3,1,0,1,51,False,0,0,0,162,3,4.473333333333334,Feature
TypeScript,2147,14722,1444.9882291666665,MERGED,20,16,13,0,1,655,False,0,0,0,3235,36,1.91,Feature
Go,421,1654,1478.1630439814815,MERGED,15,23,1,1,1,397,True,0,1,1,2606,38,42.28277777777778,Bug
TypeScript,307,2556,510.49011574074075,MERGED,0,1,1,1,1,544,True,1,0,0,829,1,53.495,Feature
JavaScript,8844,63474,4050.309074074074,MERGED,11,85,5,2,3,64,True,2,0,0,1977,96,175.5663888888889,Bug
JavaScript,9664,43889,3631.720092592592,MERGED,1,10,3,0,1,65,False,0,0,0,351,11,4.875555555555556,Feature
TypeScript,1416,21916,256.49162037037036,MERGED,23,39,3,3,1,72,True,0,3,3,487,62,0.49083333333333334,Feature
Go,395,660,1238.1163194444446,MERGED,2,6,2,0,2,59,False,0,0,0,251,8,0.6527777777777778,Feature
Go,395,660,1238.0836574074074,MERGED,1,1,1,0,1,58,False,0,0,0,191,2,0.17194444444444446,Feature
Go,395,660,1238.0621759259259,MERGED,1,1,1,0,1,55,False,0,0,0,226,2,0.1111111111111111,Feature
Python,2407,12180,212.65797453703703,MERGED,114,663,28,44,91,1,False,8,36,13,4958,777,3176.0658333333336,Document
Java,450,746,4047.089050925926,MERGED,2,6,2,1,2,65,True,0,1,1,1827,8,8.515833333333333,Bug
C#,80,125,792.7562152777778,MERGED,406,259,23,0,10,4,False,0,0,0,451,665,213.16583333333332,Feature
JavaScript,8844,63474,4053.2730324074073,MERGED,27,73,3,2,3,157,True,0,2,2,2453,100,3.1555555555555554,Feature
Go,395,660,1241.3844791666668,MERGED,40,34,4,0,1,118,False,0,0,0,312,74,0.08833333333333333,Feature
Go,421,1654,1481.9461805555557,CLOSED,1,272,8,0,1,225,False,0,0,0,7619,273,1462.7547222222222,Bug
TypeScript,2147,14722,1440.9662152777776,CLOSED,7,46,6,0,1,152,False,0,0,0,2790,53,95.76138888888889,Feature
JavaScript,9664,43889,3632.042337962963,MERGED,7,297,8,0,1,66,False,0,0,0,411,304,66.7325,Feature
Rust,264,5382,379.3342476851852,MERGED,6,6,1,0,1,1,False,0,0,0,2027,12,9.757777777777777,Feature
Go,395,660,1237.183287037037,MERGED,0,3,1,0,1,53,False,0,0,0,222,3,0.04777777777777778,Feature
Go,2083,11768,1495.1671064814816,MERGED,4,24,1,2,1,857,True,1,1,1,1913,28,0.023055555555555555,Document
JavaScript,5139,7048,1176.5023148148148,MERGED,5784,9097,24,2,13,172,False,1,1,1,3416,14881,169.8636111111111,Feature
TypeScript,15,34,464.6429513888889,MERGED,1,4,1,0,2,860,False,0,0,0,1302,5,0.3169444444444444,Feature
Go,395,660,1236.717025462963,MERGED,0,9,1,0,1,50,False,0,0,0,244,9,0.08916666666666667,Feature
JavaScript,3618,9017,2258.671493055556,MERGED,173,218,13,19,6,1777,False,11,8,7,3794,391,289.0788888888889,Bug
Rust,264,5382,377.0442708333333,MERGED,1,56,8,3,2,181,True,0,3,1,1844,57,0.8280555555555555,Bug
TypeScript,58,78,796.2218287037036,CLOSED,5,12,1,7,4,0,False,1,6,3,1663,17,720.1172222222223,Feature
TypeScript,178,1359,298.8335300925926,MERGED,21,84,6,3,1,14,True,1,2,2,4655,105,8.299444444444445,Feature
JavaScript,9664,43889,3629.2388310185183,CLOSED,0,0,0,1,0,0,False,0,1,1,408,0,22.428055555555556,Bug
TypeScript,15,34,463.3514930555555,MERGED,2,5,1,0,2,146,False,0,0,0,1500,7,19.223333333333333,Bug
TypeScript,15,34,463.6683912037037,MERGED,5,55,2,0,1,296,False,0,0,0,1220,60,0.5830555555555555,Feature
Python,547,7159,2210.578923611111,MERGED,98,139,4,0,24,217,False,0,0,0,738,237,505.89444444444445,Bug
TypeScript,1297,21107,392.87922453703703,MERGED,8,24,4,1,2,822,True,0,1,1,2221,32,0.15083333333333335,Document
TypeScript,1297,21107,386.9100231481482,MERGED,1,5,1,1,1,790,True,0,1,1,1681,6,0.01,Document
Go,30,295,316.2306712962963,MERGED,0,2,1,2,1,81,True,0,2,1,1728,2,93.63055555555556,Bug
TypeScript,1297,21107,392.66652777777773,MERGED,756,395,4,2,1,819,True,0,2,2,2064,1151,0.16666666666666666,Document
TypeScript,178,1359,298.99069444444444,MERGED,214,236,4,1,4,6,True,0,1,1,3705,450,2.423611111111111,Bug
TypeScript,1297,21107,386.5528587962963,MERGED,3,2,1,1,1,0,True,0,1,1,1516,5,0.01972222222222222,Document
Python,547,7159,2212.6208912037036,MERGED,7,5,2,2,2,90,False,1,1,1,796,12,77.20361111111112,Bug
Vue,293,495,803.8050925925926,MERGED,35,42,17,4,3,363,True,2,2,2,581,77,168.10222222222222,Bug
JavaScript,8844,63474,4050.511759259259,MERGED,144,1374,33,1,26,66,True,1,0,0,1929,1518,45.9275,Bug
TypeScript,3989,23860,2805.3446412037033,MERGED,1,1,1,1,1,232,True,0,1,1,561,2,0.17694444444444443,Bug
Python,547,7159,2211.6380208333335,MERGED,5,7,1,0,3,214,False,0,0,0,655,12,2.6127777777777776,Bug
TypeScript,1297,21107,385.99125000000004,MERGED,0,19,1,1,2,784,True,0,1,1,1376,19,0.045,Document
TypeScript,1297,21107,391.935474537037,MERGED,4,12,1,1,1,814,True,0,1,1,1888,16,0.1425,Document
JavaScript,9664,43889,3630.4597800925926,MERGED,19,19,2,1,4,1,False,0,1,1,366,38,32.55027777777778,Bug
Go,395,660,1238.0738078703705,MERGED,2,6,2,0,1,56,False,0,0,0,317,8,0.2461111111111111,Feature
Rust,417,2801,896.2819791666667,MERGED,0,118,2,1,6,120,False,1,0,0,640,118,65.89527777777778,Document
Go,395,660,1237.862037037037,MERGED,79,50,9,0,2,54,False,0,0,0,357,129,1.4777777777777779,Feature
TypeScript,216,520,1671.1249189814814,MERGED,70,92,9,0,1,155,False,0,0,0,372,162,16.253888888888888,Feature
JavaScript,8844,63474,4050.0961574074076,MERGED,241,386,5,0,4,63,True,0,0,0,1944,627,1.7072222222222222,Document
TypeScript,178,1359,296.8075347222222,MERGED,51,113,12,8,6,9,True,5,3,3,4978,164,1.8883333333333334,Bug
TypeScript,1297,21107,385.0892592592593,MERGED,44,44,2,1,1,777,True,0,1,1,1356,88,0.021111111111111112,Document
TypeScript,1297,21107,384.9835532407408,MERGED,0,3,1,1,1,773,True,0,1,1,1470,3,0.02277777777777778,Document
TypeScript,1297,21107,384.94622685185186,MERGED,0,8,2,1,1,772,True,0,1,1,1558,8,0.1388888888888889,Document
TypeScript,307,2556,512.7055208333334,MERGED,2,2,1,0,1,6,False,0,0,0,1306,4,0.8477777777777777,Bug
TypeScript,1297,21107,384.9227777777778,MERGED,0,1,1,1,1,770,True,0,1,1,1588,1,0.0077777777777777776,Document
TypeScript,307,2556,512.6531249999999,MERGED,3,3,1,0,1,5,False,0,0,0,1475,6,1.0719444444444444,Bug
TypeScript,307,2556,512.4792013888889,MERGED,1,1,1,0,1,4,False,0,0,0,1500,2,0.94,Document
TypeScript,4,33,737.5548726851852,MERGED,2,73,3,2,2,568,True,1,1,1,732,75,89.65222222222222,Document
TypeScript,41369,87411,2909.671712962963,MERGED,19,55,3,0,3,1548,True,0,0,0,5812,74,0.5069444444444444,Document
Go,395,660,1236.9793865740742,MERGED,0,6,3,0,1,117,False,0,0,0,269,6,0.4816666666666667,Feature
TypeScript,261,3765,653.5589814814815,MERGED,2,76,5,0,4,134,True,0,0,0,4687,78,3.3202777777777777,Document
JavaScript,9664,43889,3630.1805208333335,MERGED,7,7,3,2,1,1,False,1,1,1,490,14,0.4175,Bug
TypeScript,41369,87411,2907.7609722222223,MERGED,1,45,3,2,4,74,True,1,1,1,1087,46,17.11138888888889,Bug
JavaScript,5139,7048,1175.8343750000001,MERGED,14,16,11,1,2,0,False,0,1,1,269,30,16.94611111111111,Bug
TypeScript,261,3765,652.4659027777778,MERGED,9,59,4,0,1,814,True,0,0,0,3653,68,24.399166666666666,Document
C#,80,125,794.9667013888889,MERGED,6242,9053,279,0,14,170,False,0,0,0,592,15295,87.20444444444445,Document
Go,421,1654,1479.0578356481483,MERGED,23,24,2,0,1,399,True,0,0,0,2467,47,20.721944444444443,Bug
JavaScript,8844,63474,4047.3483796296296,MERGED,795,624,8,4,23,61,True,1,3,2,1435,1419,57.19888888888889,Bug
Go,395,660,1239.156412037037,MERGED,192,323,13,0,34,56,False,0,0,0,514,515,166.08972222222224,Feature
TypeScript,261,3765,650.8812037037037,MERGED,14,459,34,0,6,243,True,0,0,0,4371,473,70.51666666666667,Document
TypeScript,48,54,3100.1820949074076,MERGED,21,26,1,3,2,53,True,1,2,2,4071,47,0.33,Feature
TypeScript,261,3765,650.7590972222223,MERGED,31,92,7,0,5,812,True,0,0,0,3858,123,65.3711111111111,Document
TypeScript,261,3765,650.5435532407407,MERGED,6,21,5,0,7,87,True,0,0,0,4216,27,70.36972222222222,Document
TypeScript,1297,21107,388.94427083333335,MERGED,4,14,1,1,2,807,True,0,1,1,2193,18,2.249722222222222,Document
TypeScript,184,1377,264.3664351851852,MERGED,7,6,4,1,1,19,False,0,1,1,445,13,1.1902777777777778,Bug
TypeScript,261,3765,649.6593750000001,MERGED,75,174,6,0,6,205,True,0,0,0,3684,249,92.8463888888889,Document
TypeScript,3989,23860,2804.256018518519,CLOSED,0,2,1,3,1,33,False,1,2,2,4682,2,0.32944444444444443,Document
TypeScript,202,107,1118.791238425926,MERGED,100,186,4,4,4,12,True,0,4,3,4742,286,763.4613888888889,Document
TypeScript,41369,87411,2911.643078703704,MERGED,256,20,7,5,15,384,True,3,2,2,2546,276,335.48277777777776,Document
TypeScript,261,3765,648.9602083333333,MERGED,66,91,41,0,3,803,True,0,0,0,4351,157,13.179166666666667,Document
TypeScript,15,34,464.6687962962963,MERGED,65,80,16,0,2,861,False,0,0,0,613,145,70.16444444444444,Feature
Python,14532,41181,1061.6321412037037,MERGED,2,6,2,0,3,1401,True,0,0,0,802,8,3.9305555555555554,Bug
TypeScript,2147,14722,1446.2106134259259,MERGED,25,68,6,0,5,59,False,0,0,0,3985,93,18.705833333333334,Bug
C#,80,125,794.805787037037,MERGED,8,10,3,0,1,153,True,0,0,0,542,18,26.95638888888889,Document
JavaScript,5139,7048,1174.1956597222222,MERGED,3,3,1,1,22,286,False,0,1,1,2857,6,15.989444444444445,Bug
TypeScript,1297,21107,387.8893287037037,MERGED,163,7,5,2,1,797,True,0,2,2,2094,170,0.13194444444444445,Document
TypeScript,1297,21107,387.83096064814816,MERGED,28,259,6,2,8,796,True,0,2,2,2222,287,0.49,Document
Go,1835,11245,1697.757986111111,MERGED,0,938,2,1,1,481,False,1,0,0,328,938,22.30361111111111,Document
Go,2083,11768,1488.245324074074,MERGED,6,7,2,0,1,854,True,0,0,0,1839,13,0.125,Document
TypeScript,1756,13210,2307.150636574074,CLOSED,0,96,4,1,24,21,False,0,1,1,3269,96,0.2325,Document
TypeScript,261,3765,650.5255439814815,MERGED,1,294,4,0,1,43,False,0,0,0,3322,295,4.228888888888889,Document
TypeScript,15,34,463.22675925925927,MERGED,0,3,1,0,3,144,False,0,0,0,1865,3,22.7425,Bug
JavaScript,9664,43889,3630.756365740741,MERGED,72,179,3,0,3,611,False,0,0,0,553,251,7.7619444444444445,Feature
TypeScript,1297,21107,387.04292824074076,MERGED,38,39,3,2,1,791,True,0,2,2,1779,77,0.20416666666666666,Document
C#,80,125,794.6111921296297,MERGED,14,33,1,0,4,190,False,0,0,0,599,47,1.326111111111111,Document
TypeScript,1297,21107,386.8823611111111,MERGED,13,2,2,1,1,788,True,0,1,1,2055,15,0.009444444444444445,Document
TypeScript,1297,21107,386.86151620370373,MERGED,3,10,4,1,1,786,True,0,1,1,2342,13,0.07527777777777778,Document
TypeScript,2147,14722,1443.1610995370372,MERGED,532,3943,25,0,26,148,False,0,0,0,6750,4475,0.6461111111111111,Feature
Python,547,7159,2210.6217592592593,MERGED,25,3,1,0,2,242,True,0,0,0,550,28,0.18472222222222223,Bug
TypeScript,1297,21107,386.56998842592594,MERGED,2,10,3,1,1,785,True,0,1,1,1807,12,0.13722222222222222,Document
C#,80,125,793.617326388889,MERGED,0,1,1,0,1,189,False,0,0,0,574,1,22.464444444444446,Document
TypeScript,17,33,691.0332060185186,MERGED,206,320,15,1,3,74,False,0,1,1,593,526,4.0552777777777775,Bug
TypeScript,58,78,793.2707291666667,MERGED,585,441,21,5,1,174,False,4,1,1,602,1026,122.72222222222223,Bug
TypeScript,2147,14722,1444.9575578703705,CLOSED,15,194,12,0,3,153,False,0,0,0,5095,209,7.173611111111111,Bug
TypeScript,1297,21107,385.13124999999997,MERGED,6,10,6,1,1,778,True,0,1,1,2288,16,0.03777777777777778,Document
TypeScript,184,1377,265.4601736111111,CLOSED,12,51,2,10,1,23,False,6,4,2,520,63,16.205,Feature
TypeScript,2071,16638,1218.3403935185186,MERGED,1,1,1,0,1,0,False,0,0,0,2487,2,3.5283333333333333,Document
TypeScript,1297,21107,385.89391203703707,MERGED,35,27,3,1,2,781,True,0,1,1,2228,62,0.0925,Document
Rust,264,5382,378.7624652777777,MERGED,23,90,11,3,7,0,False,2,1,1,3067,113,30.684166666666666,Bug
JavaScript,9664,43889,3629.0017361111113,MERGED,9,46,2,0,2,257,True,0,0,0,561,55,22.00861111111111,Bug
Java,450,746,4045.3451041666667,MERGED,7,14,3,2,5,13,False,0,2,1,716,21,16.4925,Document
C#,80,125,792.8951851851853,CLOSED,1,1,1,0,1,3,False,0,0,0,640,2,20.872777777777777,Document
TypeScript,3392,2334,936.944976851852,MERGED,6,94,3,5,4,229,False,2,3,2,3645,100,73.54972222222223,Bug
TypeScript,1297,21107,385.5760069444445,MERGED,1,16,2,1,3,779,True,0,1,1,1779,17,0.026944444444444444,Document
JavaScript,8844,63474,4053.2620138888888,MERGED,6,54,7,0,4,156,True,0,0,0,2924,60,5.783888888888889,Bug
TypeScript,15,34,461.5497453703704,MERGED,32,11,2,0,2,140,False,0,0,0,2357,43,14.99611111111111,Bug
TypeScript,41369,87411,2908.9427546296297,MERGED,0,4,1,0,1,1547,True,0,0,0,2096,4,11.742777777777778,Document
TypeScript,178,1359,291.78194444444443,MERGED,255,716,12,3,7,0,True,2,1,1,4674,971,9.731111111111112,Feature
Go,30,295,321.186087962963,MERGED,3,3,3,4,3,84,True,0,4,1,2256,6,21.278055555555557,Bug
TypeScript,41369,87411,2906.592511574074,CLOSED,1,1,1,5,1,0,False,3,2,1,2140,2,5.810277777777777,Document
JavaScript,5139,7048,1178.5927662037036,MERGED,35,150,20,2,3,174,False,1,1,1,4078,185,125.765,Document
C#,80,125,792.6121643518518,MERGED,67,84,7,0,7,205,False,0,0,0,532,151,6.239722222222222,Document
TypeScript,42,46,742.1198495370371,MERGED,0,176,3,1,9,76,False,0,1,1,648,176,19.704722222222223,Bug
JavaScript,5139,7048,1178.5864467592594,MERGED,28,1882,21,1,18,173,False,0,1,1,4902,1910,119.45277777777778,Document
TypeScript,1297,21107,384.98630787037035,MERGED,0,1,1,1,1,774,True,0,1,1,1653,1,0.008611111111111111,Document
Go,395,660,1237.1216898148148,CLOSED,50,85,10,1,7,52,False,1,0,0,661,135,66.05305555555556,Feature
TypeScript,184,1377,264.6421990740741,MERGED,8,14,2,1,2,22,False,0,1,1,539,22,2.0794444444444444,Document
C#,80,125,790.5634375,MERGED,30240,51481,807,0,67,204,False,0,0,0,639,81721,75.61777777777777,Document
TypeScript,184,1377,264.6196875,MERGED,3,104,3,3,1,21,True,1,2,2,532,107,0.47,Document
Rust,264,5382,375.95542824074073,MERGED,27,268,10,0,11,5,False,0,0,0,3168,295,19.58,Bug
TypeScript,2147,14722,1443.1536226851852,MERGED,9,50,4,0,4,0,False,0,0,0,6173,59,615.9544444444444,Document
Java,450,746,4044.4405439814814,MERGED,1,3,2,2,1,12,False,0,2,1,839,4,11.182222222222222,Feature
TypeScript,2071,16638,1217.2832060185185,MERGED,3,3,2,0,3,4,False,0,0,0,2703,6,0.5963888888888889,Document
Rust,264,5382,375.1554398148148,MERGED,2,9,2,0,3,175,True,0,0,0,2432,11,42.66361111111111,Bug
TypeScript,307,2556,510.6365856481482,MERGED,254,287,73,0,6,545,True,0,0,0,680,541,1.4630555555555556,Bug
TypeScript,2071,16638,1217.1441319444446,MERGED,1,1,1,0,1,0,False,0,0,0,2293,2,0.06111111111111111,Bug
TypeScript,2071,16638,1217.0585532407406,CLOSED,2,3,1,1,1,7,False,0,1,1,2297,5,0.06972222222222223,Bug
Rust,264,5382,378.05214120370374,MERGED,4,25,4,0,1,186,True,0,0,0,2573,29,0.27166666666666667,Document
Rust,264,5382,377.9719097222223,MERGED,1,179,14,2,8,184,True,1,1,1,3289,180,1.2558333333333334,Document
TypeScript,41369,87411,2907.874895833333,MERGED,7,0,1,2,1,554,True,0,2,1,2238,7,0.4438888888888889,Document
TypeScript,15,34,460.39951388888886,MERGED,12,18,4,0,4,452,True,0,0,0,2334,30,4.460833333333333,Feature
PHP,1334,2960,4181.151527777778,MERGED,126,59,9,0,2,35,False,0,0,0,3965,185,19.954722222222223,Document
TypeScript,2071,16638,1216.337673611111,MERGED,2,2,1,0,1,6,False,0,0,0,2939,4,1.8855555555555557,Bug
Java,450,746,4043.1507754629633,MERGED,13,10,3,2,4,11,False,0,2,1,676,23,23.785,Bug
Python,2407,12180,214.2708912037037,MERGED,2,2,2,2,3,0,False,1,1,1,1823,4,0.06972222222222223,Document
TypeScript,17,33,692.7074421296296,MERGED,77,118,4,3,2,53,True,0,3,3,585,195,5.775277777777778,Feature
TypeScript,15,34,458.9973958333333,MERGED,44,56,5,0,3,847,False,0,0,0,2590,100,35.019444444444446,Feature
Go,1295,18028,492.40108796296295,MERGED,5588,3416,4,0,1,427,True,0,0,0,992,9004,0.08166666666666667,Bug
TypeScript,1297,21107,391.9230671296296,MERGED,309,426,5,1,1,813,True,0,1,1,2732,735,0.16972222222222222,Document
TypeScript,7,6,617.1653819444444,MERGED,2,55,4,1,3,207,False,0,1,1,989,57,27.925555555555555,Document
TypeScript,47,234,1020.7637384259259,MERGED,1569,2931,39,1,29,35,False,0,1,1,1111,4500,548.3705555555556,Document
TypeScript,41369,87411,2906.5192824074074,CLOSED,1,1,1,2,1,64,True,0,2,2,2062,2,21.85388888888889,Document
TypeScript,4,33,738.3057986111112,MERGED,5,5,2,1,2,354,False,0,1,1,1023,10,0.04138888888888889,Feature
TypeScript,3989,23860,2803.2187847222226,MERGED,1,1,1,2,1,165,False,0,2,1,1054,2,1.1608333333333334,Bug
PHP,1334,2960,4180.155289351852,MERGED,664873,36,7616,0,6,855,False,0,0,0,4089,664909,5.720555555555555,Document
TypeScript,307,2556,512.6067129629629,MERGED,0,65,2,2,5,12,False,1,1,1,2209,65,98.89694444444444,Feature
C++,2234,23693,2327.8055324074076,MERGED,9,53,5,2,2,512,False,1,1,1,2398,62,98.53444444444445,Bug
TypeScript,41369,87411,2914.513252314815,MERGED,8,15,1,0,1,1551,True,0,0,0,2321,23,2.6119444444444446,Document
PHP,1334,2960,4179.856134259259,MERGED,15,13,7,0,4,53,False,0,0,0,3837,28,2.725,Document
Rust,413,5117,435.4808912037037,MERGED,388,1459,12,1,60,111,False,0,1,1,3219,1847,2045.6661111111111,Document
JavaScript,2,1,291.8075347222222,MERGED,340,0,1,0,1,0,False,0,0,0,998,340,0.11361111111111111,Feature
Rust,264,5382,375.9011805555556,MERGED,0,5,1,0,1,177,True,0,0,0,721,5,0.23555555555555555,Document
TypeScript,41369,87411,2905.497013888889,MERGED,1,1,1,0,1,0,False,0,0,0,2113,2,9.463611111111112,Document
C#,80,125,793.8150231481482,MERGED,47,22,4,2,3,188,True,1,1,1,812,69,100.79305555555555,Document
TypeScript,41369,87411,2905.5242708333335,MERGED,1,1,1,0,1,1,False,0,0,0,2129,2,3.9133333333333336,Document
Vue,0,1,221.40837962962962,MERGED,4,8,2,0,2,145,True,0,0,0,861,12,13.268888888888888,Feature
TypeScript,15,34,464.75532407407405,MERGED,13,24,3,0,1,862,False,0,0,0,2663,37,67.56305555555555,Bug
Java,450,746,4045.1241666666665,MERGED,30,51,4,2,6,63,True,0,2,1,3063,81,119.58638888888889,Bug
JavaScript,8844,63474,4046.0311111111114,MERGED,9,1514,6,2,8,58,True,0,2,2,3793,1523,605.4788888888888,Bug
TypeScript,307,2556,509.8428240740741,MERGED,46,2558,49,3,16,163,True,2,1,1,6171,2604,1338.2480555555555,Bug
TypeScript,47,234,1022.8362268518518,MERGED,145,1271,88,2,67,0,False,1,1,1,1253,1416,403.9738888888889,Feature
TypeScript,202,107,1118.5564930555556,MERGED,34,47,2,4,2,234,True,0,4,4,3401,81,6.963333333333333,Bug
JavaScript,9664,43889,3631.954467592592,MERGED,37,176,13,0,1,259,True,0,0,0,870,213,0.21,Bug
C#,80,125,793.4309953703704,MERGED,9,9469,16,0,5,206,False,0,0,0,929,9478,95.58527777777778,Document
TypeScript,2071,16638,1213.8062037037037,MERGED,10,4,2,0,1,71,True,0,0,0,2484,14,5.936111111111111,Bug
TypeScript,4,33,736.8244212962964,MERGED,15,48,4,1,2,66,False,0,1,1,908,63,2.206111111111111,Document
TypeScript,41369,87411,2913.0748611111107,MERGED,1,0,1,0,1,1886,True,0,0,0,2186,1,14.752777777777778,Document
TypeScript,139,827,722.1682060185185,MERGED,897,928,21,2,4,1248,True,0,2,2,893,1825,19.4625,Feature
Starlark,440,286,461.91089120370367,MERGED,0,3,1,0,1,28,False,0,0,0,832,3,0.08972222222222222,Feature
JavaScript,5139,7048,1175.665798611111,MERGED,22,1292,11,2,6,81,False,0,2,2,3387,1314,67.89916666666667,Feature
JavaScript,8844,63474,4045.754375,MERGED,4,50,7,0,2,57,True,0,0,0,2431,54,106.49388888888889,Bug
Vue,0,1,220.38916666666668,MERGED,1,56,2,0,3,0,False,0,0,0,979,57,13.513333333333334,Feature
JavaScript,5139,7048,1176.6746990740742,MERGED,786,189,49,1,2,100,False,0,1,1,4764,975,21.57611111111111,Document
C++,2234,23693,2327.8711921296294,MERGED,39,50,1,1,3,249,False,0,1,1,3486,89,24.115555555555556,Bug
TypeScript,1297,21107,388.7423148148148,MERGED,295,296,7,1,1,802,True,0,1,1,2479,591,0.011944444444444445,Document
Rust,128,2771,368.1914236111111,MERGED,6,69,3,0,2,447,True,0,0,0,2158,75,1.5491666666666666,Bug
TypeScript,1297,21107,388.5861689814815,MERGED,4,46,3,1,1,801,True,0,1,1,2244,50,0.01972222222222222,Document
JavaScript,5139,7048,1176.031539351852,MERGED,38,227,13,2,10,42,False,0,2,2,4825,265,27.273888888888887,Document
TypeScript,199,371,748.9225578703704,MERGED,2475,1835,28,2,7,208,True,0,2,2,3575,4310,21.928333333333335,Feature
TypeScript,218,1201,2901.879224537037,MERGED,15,48,1,5,6,15,False,3,2,2,2510,63,95.86972222222222,Feature
TypeScript,7,6,619.1683564814815,MERGED,6,80,2,2,8,254,False,0,2,2,4738,86,282.1025,Feature
TypeScript,4,33,735.3550462962962,MERGED,1,3,1,2,1,557,True,1,1,1,1103,4,3.4047222222222224,Feature
TypeScript,2071,16638,1217.0876041666668,CLOSED,2,2,2,6,3,0,False,4,2,2,4372,4,886.6180555555555,Bug
TypeScript,4,33,735.3926736111111,MERGED,13,0,1,1,1,62,False,0,1,1,946,13,0.03111111111111111,Document
TypeScript,4,33,735.2211921296297,MERGED,0,1,1,2,1,556,True,1,1,1,899,1,6.578333333333333,Feature
TypeScript,261,3765,649.5789699074074,MERGED,41,52,7,0,2,157,False,0,0,0,2022,93,2.9055555555555554,Document
Java,450,746,4046.2809837962964,MERGED,3,3,3,2,4,14,False,0,2,1,982,6,0.4583333333333333,Bug
TypeScript,41369,87411,2911.706875,MERGED,12,12,2,2,3,385,True,0,2,2,2155,24,0.8975,Document
TypeScript,41369,87411,2911.6296759259258,MERGED,4,3,2,6,3,192,False,2,4,3,2316,7,2.1,Document
C#,80,125,793.7247453703703,MERGED,6,12,2,0,1,4,False,0,0,0,764,18,2.6519444444444447,Document
TypeScript,1297,21107,387.6887152777778,MERGED,36,39,2,1,1,793,True,0,1,1,3136,75,0.17,Document
TypeScript,199,371,748.8741203703704,MERGED,297,336,11,2,6,175,True,0,2,2,803,633,2.4994444444444444,Feature
C++,363,552,509.10138888888883,MERGED,9,9,1,0,1,84,False,0,0,0,1039,18,0.8244444444444444,Document
TypeScript,41369,87411,2908.7812615740745,MERGED,1,1,1,1,2,63,True,0,1,1,2140,2,1.0844444444444445,Document
TypeScript,41369,87411,2911.0241782407406,CLOSED,3,4,1,0,1,1,False,0,0,0,2275,7,14.608055555555556,Document
C#,80,125,792.4543055555555,MERGED,29,1931,29,0,10,148,True,0,0,0,921,1960,45.90416666666667,Document
TypeScript,15,34,463.8247453703704,MERGED,32,89,4,0,2,297,False,0,0,0,2674,121,0.7897222222222222,Feature
TypeScript,3392,2334,940.1578587962963,MERGED,2,2,2,1,1,80,False,0,1,1,1167,4,0.21611111111111111,Feature
Vue,0,1,218.98377314814817,CLOSED,1,1,1,1,1,23,False,0,1,1,921,2,1.7580555555555555,Document
TypeScript,3392,2334,940.0602546296296,MERGED,0,8,11,1,3,262,False,0,1,1,992,8,0.37277777777777776,Feature
C#,80,125,792.7348842592593,MERGED,13,16,3,0,3,188,False,0,0,0,805,29,24.869722222222222,Document
C#,80,125,792.6709490740741,MERGED,5042,90,97,0,5,187,False,0,0,0,739,5132,27.139722222222222,Document
TypeScript,41369,87411,2910.871550925926,MERGED,4,4,4,0,2,191,False,0,0,0,2944,8,0.6966666666666667,Document
TypeScript,4,33,734.2850694444445,MERGED,1,3,1,2,1,553,True,1,1,1,953,4,0.5347222222222222,Document
Go,1295,18028,493.67607638888893,MERGED,2,6,3,0,1,435,True,0,0,0,1288,8,0.05277777777777778,Document
TypeScript,2071,16638,1217.442037037037,CLOSED,0,132,4,2,3,7,False,1,1,1,3500,132,183.38666666666666,Document
TypeScript,41369,87411,2910.502291666666,MERGED,0,140,2,0,2,1550,True,0,0,0,2378,140,2.694722222222222,Document
C#,80,125,790.8308796296296,MERGED,23,1195,12,0,16,127,True,0,0,0,845,1218,68.94305555555556,Bug
JavaScript,9664,43889,3628.59125,MERGED,0,1,1,0,1,23,False,0,0,0,683,1,0.3238888888888889,Bug
C#,80,125,791.8950810185185,MERGED,33,152,4,0,4,187,True,0,0,0,798,185,24.5775,Document
TypeScript,17,33,693.8371180555555,MERGED,83,222,22,2,10,22,False,1,1,1,3086,305,6.1866666666666665,Feature
C++,363,552,507.1221412037037,MERGED,9,29,1,0,1,82,False,0,0,0,1088,38,23.206944444444446,Document
TypeScript,15,34,462.3769791666667,MERGED,12,36,2,1,2,142,False,1,0,0,2991,48,7.543055555555555,Bug
Erlang,2054,12122,3768.178819444445,MERGED,95,2562,50,2,20,293,False,2,0,0,1340,2657,318.60833333333335,Document
TypeScript,41369,87411,2909.937048611111,MERGED,7,7,2,0,1,1883,True,0,0,0,2954,14,0.9638888888888889,Document
C#,80,125,792.1781018518518,CLOSED,0,0,0,0,0,185,False,0,0,0,958,0,0.020833333333333332,Document
TypeScript,1297,21107,385.96653935185185,MERGED,17,91,8,1,1,782,True,0,1,1,3242,108,0.1638888888888889,Document
TypeScript,184,1377,263.8765162037037,MERGED,768,1265,20,2,9,76,True,0,2,2,848,2033,3.841666666666667,Document
TypeScript,41369,87411,2909.5051620370373,MERGED,2,3,2,1,3,75,True,0,1,1,2759,5,1.6419444444444444,Document
TypeScript,1297,21107,385.7156597222222,MERGED,21,34,6,1,4,780,True,0,1,1,2354,55,0.4913888888888889,Document
TypeScript,41369,87411,2907.7368055555557,CLOSED,1,7,1,4,1,1,False,3,1,1,2494,8,69.05611111111111,Document
TypeScript,41369,87411,2909.499849537037,MERGED,3,3,3,0,1,383,True,0,0,0,2528,6,0.5241666666666667,Document
TypeScript,184,1377,263.19577546296296,MERGED,16,456,21,2,4,75,True,0,2,2,928,472,20.16138888888889,Bug
TypeScript,3392,2334,938.0859722222222,MERGED,1,1,1,2,1,330,False,0,2,1,1054,2,0.06277777777777778,Bug
TypeScript,48,54,3103.1858564814816,MERGED,500,328,11,0,3,54,True,0,0,0,1375,828,22.2275,Feature
TypeScript,3392,2334,937.9600231481481,MERGED,0,3,1,1,1,615,False,0,1,1,889,3,0.007222222222222222,Feature
TypeScript,3989,23860,2804.3754050925927,MERGED,0,24,2,1,2,166,False,0,1,1,1564,24,154.54361111111112,Document
C#,80,125,790.5601736111112,MERGED,3,3,1,0,3,181,False,0,0,0,808,6,26.386944444444445,Document
Starlark,440,286,466.1994907407407,CLOSED,38,75,1,0,5,1,False,0,0,0,3398,113,1539.0680555555555,Feature
TypeScript,1297,21107,385.0627662037037,MERGED,9,6,5,1,1,776,True,0,1,1,2744,15,0.008888888888888889,Document
TypeScript,7,6,619.1110416666667,CLOSED,49,115,5,2,6,209,False,1,1,1,5151,164,91.77333333333333,Feature
TypeScript,41369,87411,2907.9830902777776,MERGED,14,16,1,0,7,24,False,0,0,0,2565,30,34.97472222222222,Document
TypeScript,41369,87411,2908.8342013888887,MERGED,1,20,4,0,2,556,True,0,0,0,3253,21,0.7433333333333333,Document
TypeScript,41369,87411,2908.650833333333,MERGED,0,10,1,0,1,2,False,0,0,0,2507,10,1.3097222222222222,Document
TypeScript,41369,87411,2908.596238425926,CLOSED,2,2,2,2,1,382,True,1,1,1,2425,4,0.5097222222222222,Document
TypeScript,41369,87411,2907.486192129629,MERGED,5,2,5,0,2,1881,True,0,0,0,2635,7,1.9055555555555554,Document
TypeScript,41369,87411,2907.961493055556,MERGED,26,69,5,0,6,1546,True,0,0,0,2730,95,13.095,Document
Vue,0,1,216.2814236111111,MERGED,1,2,1,0,1,127,True,0,0,0,797,3,0.012222222222222223,Feature
TypeScript,17,33,690.0725462962963,MERGED,153,273,33,6,6,17,True,2,4,2,817,426,67.90527777777778,Bug
C++,2234,23693,2331.73875,CLOSED,2,2,2,0,6,201,False,0,0,0,1516,4,123.22111111111111,Bug
Python,72,25,1610.8458333333335,MERGED,899,2874,21,0,18,48,False,0,0,0,4167,3773,123.69583333333334,Bug
Erlang,2054,12122,3770.2702546296296,MERGED,4,188,4,1,3,34,False,1,0,0,1226,192,135.16444444444446,Document
TypeScript,7,6,618.2158796296296,MERGED,35,1230,26,2,20,238,False,0,2,2,5933,1265,857.9936111111111,Bug
Vue,293,495,803.9736689814814,MERGED,4,365,14,33,41,16,True,7,26,6,1359,369,164.52416666666667,Bug
Python,14532,41181,1056.5174537037037,MERGED,0,4,1,0,3,1396,True,0,0,0,1824,4,0.09277777777777778,Document
TypeScript,3989,23860,2805.3712731481482,CLOSED,3,6,3,1,1,233,True,0,1,1,1551,9,0.22138888888888889,Feature
TypeScript,261,3765,648.6570254629629,MERGED,660,415,41,0,4,84,False,0,0,0,1145,1075,1.6041666666666667,Document
Erlang,2054,12122,3769.977361111111,MERGED,7,1993,44,0,5,471,True,0,0,0,1447,2000,112.04583333333333,Document
Python,72,25,1610.7111458333331,MERGED,226,539,4,0,11,16,False,0,0,0,5114,765,91.12472222222222,Bug
TypeScript,139,827,724.5450231481482,MERGED,170,687,3,2,5,116,False,0,2,2,1118,857,109.895,Document
TypeScript,4,33,736.4183796296296,MERGED,42,45,1,4,1,564,True,3,1,1,1468,87,189.64555555555555,Bug
PHP,0,0,81.2252199074074,MERGED,6,1838,60,0,8,40,True,0,0,0,1031,1844,0.03833333333333333,Document
Starlark,440,286,463.12377314814813,MERGED,9,24,1,0,2,37,False,0,0,0,1409,33,115.1125,Bug
TypeScript,4,33,737.2760185185185,MERGED,48,49,4,2,1,566,True,1,1,1,1915,97,146.12055555555557,Feature
Rust,591,3260,522.0794097222223,MERGED,5,21,4,0,1,27,True,0,0,0,1548,26,2.0433333333333334,Document
Erlang,2054,12122,3770.435625,MERGED,101,640,15,1,1,295,False,1,0,0,1128,741,69.28055555555555,Document
Starlark,440,286,458.40871527777773,MERGED,0,548,2,3,8,0,False,2,1,1,1990,548,272.33694444444444,Document
TypeScript,3989,23860,2804.1950694444445,MERGED,1,21,2,2,2,231,True,0,2,2,1700,22,0.6105555555555555,Document
Erlang,2054,12122,3769.093402777778,MERGED,5,50,6,2,5,325,True,1,1,1,1160,55,111.1913888888889,Document
Rust,264,5382,376.9846412037037,MERGED,16,81,5,4,2,27,False,2,2,1,3212,97,1.033611111111111,Document
TypeScript,3989,23860,2798.9749305555556,MERGED,1,6,1,1,2,354,True,0,1,1,2195,7,31.592777777777776,Feature
Erlang,2054,12122,3769.166886574074,MERGED,3,26,3,0,3,33,False,0,0,0,877,29,98.02833333333334,Document
Go,1295,18028,493.4296527777778,MERGED,8,11,1,0,1,429,True,0,0,0,1580,19,0.034166666666666665,Bug
C++,2234,23693,2327.862800925926,MERGED,0,102,15,5,25,3,False,3,2,2,3643,102,193.78527777777776,Document
Go,1295,18028,493.4384606481481,MERGED,23,1,1,0,1,431,True,0,0,0,1322,24,0.03111111111111111,Bug
TypeScript,2147,14722,1446.1885300925926,MERGED,6824,7881,54,2,4,653,False,0,2,1,6865,14705,0.9555555555555556,Document
Rust,417,2801,897.9541666666668,MERGED,59,229,6,0,3,247,False,0,0,0,3566,288,11.233611111111111,Document
Erlang,2054,12122,3770.1946875,MERGED,5,12,1,0,2,328,True,0,0,0,1167,17,38.791666666666664,Document
TypeScript,2071,16638,1217.4067939814815,MERGED,1,23,2,0,2,23,True,0,0,0,3799,24,0.8463888888888889,Bug
Erlang,2054,12122,3770.224212962963,MERGED,11,12,1,0,1,329,True,0,0,0,1269,23,34.45166666666667,Document
Erlang,2054,12122,3767.9763541666666,MERGED,180,220,13,0,3,327,True,0,0,0,1440,400,116.51527777777778,Document
Erlang,2054,12122,3765.7045833333336,CLOSED,0,41,1,0,1,325,True,0,0,0,1161,41,198.63083333333333,Document
TypeScript,1297,21107,392.86920138888894,MERGED,53,36,4,2,1,821,True,0,2,2,4056,89,0.18833333333333332,Document
TypeScript,4,33,737.7280092592592,MERGED,6,38,2,1,2,144,False,0,1,1,1781,44,63.8675,Document
TypeScript,3392,2334,942.1182060185184,MERGED,7,7,1,1,4,633,False,0,1,1,1421,14,67.24305555555556,Bug
TypeScript,2147,14722,1445.259872685185,MERGED,11,145,8,0,3,154,False,0,0,0,6311,156,22.45722222222222,Feature
Erlang,2054,12122,3769.119212962963,MERGED,960,1328,265,0,28,69,True,0,0,0,1112,2288,29.563333333333333,Document
Erlang,2054,12122,3769.278240740741,MERGED,12,97,8,0,2,124,False,0,0,0,1201,109,16.143333333333334,Document
Erlang,2054,12122,3766.164166666667,MERGED,46,119,9,0,7,321,True,0,0,0,1173,165,135.5186111111111,Document
Erlang,2054,12122,3768.867037037037,MERGED,58,58,117,0,3,470,True,0,0,0,1156,116,28.510555555555555,Document
C#,80,125,794.3694791666667,MERGED,22,1169,23,0,20,149,True,0,0,0,1286,1191,98.26194444444444,Document
Erlang,2054,12122,3769.439502314815,MERGED,1,44,1,0,1,74,False,0,0,0,1062,45,1.0119444444444445,Document
Erlang,2054,12122,3769.1438773148147,MERGED,6,14,5,0,2,326,True,0,0,0,1324,20,12.07611111111111,Document
TypeScript,1297,21107,391.84091435185184,MERGED,173,173,2,2,1,812,True,0,2,2,4634,346,0.20555555555555555,Document
Vue,0,1,221.99493055555556,CLOSED,8,15,5,0,18,146,True,0,0,0,1274,23,7.565555555555555,Feature
TypeScript,7045,76149,2605.2057291666665,MERGED,14,1339,13,5,1,93,False,0,5,2,3487,1353,0.465,Document
Erlang,2054,12122,3768.857951388889,MERGED,5,13,5,0,2,324,True,0,0,0,1566,18,18.923055555555557,Document
Go,421,1654,1484.0600347222223,MERGED,86,93,11,1,4,401,True,1,0,0,6554,179,68.14,Bug
TypeScript,4,33,737.4629166666667,MERGED,2,48,2,2,5,186,True,1,1,1,1394,50,12.184722222222222,Bug
Erlang,2054,12122,3769.0543518518516,MERGED,8,8,1,0,1,73,False,0,0,0,1104,16,0.024722222222222222,Document
Python,19248,70257,2437.9263888888886,CLOSED,8,77,3,7,15,120,False,7,0,0,2028,85,208.07916666666668,Bug
Erlang,2054,12122,3768.715081018519,MERGED,2,2,1,1,2,469,True,0,1,1,1356,4,13.007777777777777,Document
Erlang,2054,12122,3767.9641435185185,MERGED,15,130,8,0,5,322,True,0,0,0,1451,145,40.10194444444444,Document
TypeScript,48,54,3105.1366666666668,MERGED,1050,979,54,0,5,55,True,0,0,0,1801,2029,20.01638888888889,Bug
Erlang,2054,12122,3768.747256944445,MERGED,20,1,1,0,1,328,True,0,0,0,1119,21,4.637222222222222,Document
TypeScript,3392,2334,940.4114004629629,MERGED,6,6,3,2,1,0,False,0,2,1,1336,12,9.43388888888889,Bug
Erlang,2054,12122,3768.6525231481482,MERGED,3,7,3,0,4,323,True,0,0,0,1307,10,4.927222222222222,Document
TypeScript,261,3765,649.7127430555555,MERGED,57,242,12,0,3,806,True,0,0,0,4753,299,4.354166666666667,Document
TypeScript,3392,2334,941.2697800925926,MERGED,12,12,1,2,1,234,False,0,2,1,1318,24,51.3575,Feature
Python,14532,41181,1061.36,MERGED,11,27,1,0,2,1397,True,0,0,0,1703,38,0.22416666666666665,Document
Erlang,2054,12122,3766.4657060185186,MERGED,67,1557,29,2,22,223,True,1,1,1,1472,1624,84.62444444444445,Document
TypeScript,1297,21107,390.7347453703704,MERGED,38,34,9,1,2,811,True,0,1,1,3733,72,10.261944444444444,Document
C#,80,125,791.8654282407407,MERGED,705,1177,17,0,43,164,False,0,0,0,1331,1882,158.38833333333332,Document
Erlang,2054,12122,3766.206076388889,MERGED,108,245,13,2,3,43,False,1,1,1,1228,353,90.40666666666667,Document
TypeScript,2071,16638,1211.3742939814815,MERGED,15,49,2,0,3,70,True,0,0,0,3760,64,93.5663888888889,Bug
C++,363,552,511.1783449074074,CLOSED,13,11,1,0,2,191,False,0,0,0,1420,24,0.5005555555555555,Document
TypeScript,4,33,736.2440856481481,MERGED,2,4,1,2,2,562,True,1,1,1,1279,6,28.14638888888889,Document
Go,30,295,316.0800810185185,MERGED,4,4,3,3,2,80,True,0,3,1,3470,8,97.22444444444444,Bug
Erlang,2054,12122,3767.1091319444445,MERGED,19,44,1,1,6,468,True,0,1,1,1149,63,51.48583333333333,Document
TypeScript,1297,21107,390.7754166666667,CLOSED,44,143,6,0,4,2,False,0,0,0,3934,187,0.005277777777777778,Document
TypeScript,307,2556,511.4312615740741,MERGED,65,97,5,2,2,6,False,1,1,1,3481,162,4.226944444444444,Bug
TypeScript,4,33,736.8163078703705,MERGED,14,146,7,1,5,65,False,0,1,1,1253,160,0.04055555555555555,Document
TypeScript,4,33,736.6696296296296,MERGED,3,21,6,1,3,142,False,0,1,1,1239,24,1.9513888888888888,Bug
TypeScript,307,2556,509.45506944444446,MERGED,7,7,4,3,3,543,True,2,1,1,966,14,23.42,Bug
TypeScript,3392,2334,942.104513888889,MERGED,1,6,2,2,3,632,False,0,2,2,1491,7,0.5172222222222222,Bug
TypeScript,2147,14722,1446.7747222222222,MERGED,347,320,32,0,1,155,False,0,0,0,9238,667,0.2325,Feature
Vue,0,1,220.9740046296296,MERGED,0,1,1,0,1,33,False,0,0,0,1002,1,0.1622222222222222,Bug
TypeScript,41369,87411,2913.667511574074,MERGED,23,28,1,0,2,0,False,0,0,0,3661,51,18.9775,Document
Starlark,440,286,461.9334490740741,MERGED,0,0,3,0,1,54,False,0,0,0,1434,0,0.12,Feature
Rust,433,2229,209.75363425925926,MERGED,4,8,1,1,1,209,False,0,1,1,1105,12,1.6047222222222222,Bug
TypeScript,3392,2334,941.5491782407407,MERGED,0,16,3,1,3,265,False,0,1,1,1517,16,8.358055555555556,Feature
JavaScript,5139,7048,1176.8722337962963,MERGED,21,367,9,3,9,82,False,1,2,2,5285,388,111.85916666666667,Feature
TypeScript,4,33,736.1324189814815,MERGED,1,5,1,2,2,560,True,1,1,1,1141,6,0.11333333333333333,Document
TypeScript,41369,87411,2908.999421296296,MERGED,30,308,9,1,27,0,False,0,1,1,4187,338,181.6211111111111,Document
Ruby,2,1,293.82234953703704,MERGED,0,2,1,0,1,3,True,0,0,0,1043,2,0.03944444444444444,Document
TypeScript,149,2900,351.9763541666667,MERGED,11,21,1,1,1,72,False,0,1,1,1464,32,18.82472222222222,Feature
TypeScript,3392,2334,940.402488425926,MERGED,39,40,3,1,3,625,False,0,1,1,1558,79,34.531666666666666,Document
TypeScript,149,2900,351.7929513888889,MERGED,10,409,4,1,1,70,False,0,1,1,1362,419,23.250833333333333,Bug
Vue,0,1,220.13547453703703,MERGED,0,1,1,0,1,30,False,0,0,0,1072,1,0.0175,Document
TypeScript,41369,87411,2913.0721875,MERGED,83,71,6,0,2,1885,True,0,0,0,3177,154,14.8725,Document
TypeScript,1297,21107,389.69785879629626,MERGED,4,215,6,1,1,809,True,0,1,1,3546,219,0.13805555555555554,Document
Erlang,2054,12122,3765.8768634259263,MERGED,66,141,7,0,5,467,True,0,0,0,1258,207,53.819722222222225,Document
Python,19248,70257,2435.637708333333,CLOSED,5,9,2,2,4,76,False,1,1,1,2460,14,148.74055555555555,Bug
Go,54,353,705.9096875,MERGED,0,20,1,0,2,204,True,0,0,0,1238,20,0.4083333333333333,Document
TypeScript,3392,2334,941.0908796296297,CLOSED,0,7,1,2,1,435,False,0,2,1,1405,7,0.04555555555555556,Bug
Erlang,2054,12122,3765.856655092593,MERGED,6,51,1,0,1,326,True,0,0,0,1134,57,49.111111111111114,Document
TypeScript,199,371,748.0450578703703,MERGED,125,216,13,2,7,174,True,0,2,2,7232,341,46.18527777777778,Feature
TypeScript,41369,87411,2910.8509722222225,CLOSED,0,60,7,2,1,0,False,1,1,1,1556,60,92.6625,Document
TypeScript,3392,2334,940.996712962963,MERGED,2,57,4,2,2,433,False,0,2,1,1303,59,0.4866666666666667,Feature
Python,2407,12180,210.236412037037,MERGED,20,19,1,16,9,193,True,5,11,2,1707,39,61.00194444444445,Document
C++,363,552,509.2343171296296,MERGED,6,17,1,0,3,151,False,0,0,0,1643,23,21.54277777777778,Document
TypeScript,3392,2334,940.8649884259258,MERGED,4,7,29,1,1,626,False,0,1,1,1630,11,2.6433333333333335,Feature
Rust,433,2229,208.81730324074076,MERGED,0,41,2,1,3,207,False,0,1,1,1380,41,0.8161111111111111,Document
Starlark,440,286,460.9634722222222,MERGED,4,4,1,0,1,53,False,0,0,0,1549,8,0.020277777777777777,Bug
TypeScript,4,33,735.4394560185186,MERGED,12,34,3,1,1,63,False,0,1,1,1206,46,0.06055555555555556,Document
TypeScript,4,33,735.2106597222222,MERGED,139,208,4,2,2,555,True,1,1,1,1728,347,6.789722222222222,Feature
TypeScript,3392,2334,940.4752199074073,MERGED,0,12,1,1,1,263,False,0,1,1,1124,12,9.243611111111111,Feature
Python,2407,12180,211.07483796296296,MERGED,0,0,0,4,4,0,False,2,2,1,1430,0,15.81638888888889,Bug
TypeScript,178,1359,290.4000462962963,MERGED,158,90,3,0,1,13,True,0,0,0,7931,248,2.671111111111111,Bug
TypeScript,4,33,734.709849537037,MERGED,122,182,13,1,4,139,False,0,1,1,1539,304,17.685277777777777,Feature
JavaScript,9664,43889,3629.911898148148,MERGED,15,253,7,0,2,258,True,0,0,0,1376,268,0.9402777777777778,Bug
Rust,433,2229,208.32197916666667,MERGED,3,4,1,1,1,203,False,0,1,1,1329,7,2.1597222222222223,Document
Python,2407,12180,210.2424421296296,MERGED,0,0,0,4,7,0,False,2,2,2,1534,0,35.089166666666664,Bug
TypeScript,139,827,724.2295370370371,MERGED,55,116,2,2,2,115,False,0,2,2,2100,171,211.5847222222222,Bug
TypeScript,3392,2334,940.295775462963,MERGED,1,20,2,1,1,623,False,0,1,1,1619,21,0.045,Feature
Vue,0,1,219.11707175925926,MERGED,2,4,1,0,1,24,False,0,0,0,1424,6,0.10194444444444445,Feature
TypeScript,3392,2334,940.157337962963,MERGED,9,1,1,1,1,621,False,0,1,1,1225,10,0.33305555555555555,Bug
Python,547,7159,2208.6081712962964,MERGED,76,176,5,0,28,65,False,0,0,0,1593,252,385.0286111111111,Document
TypeScript,4,33,734.6667824074075,MERGED,1,2,1,1,1,61,False,0,1,1,1475,3,0.05694444444444444,Document
C++,363,552,508.6017708333333,MERGED,0,66,2,1,5,186,False,0,1,1,1460,66,9.975555555555555,Document
C++,363,552,508.6104745370371,MERGED,22,32,2,0,3,187,False,0,0,0,1445,54,9.143333333333333,Document
TypeScript,3392,2334,938.9440277777777,MERGED,24,24,1,2,1,432,False,0,2,1,1238,48,36.65888888888889,Feature
TypeScript,4,33,734.3982060185185,MERGED,2,5,1,1,2,60,False,0,1,1,1725,7,0.04083333333333333,Document
TypeScript,4,33,734.3505092592592,MERGED,1,4,1,1,1,59,False,0,1,1,1318,5,0.050555555555555555,Bug
C++,2234,23693,2327.2196180555557,CLOSED,0,0,0,1,0,2,False,0,1,1,3443,0,12.850833333333334,Feature
TypeScript,4,33,734.3045717592591,MERGED,11,8,3,2,2,554,True,1,1,1,1159,19,0.3308333333333333,Feature
TypeScript,4,33,734.0320949074074,MERGED,1,24,1,1,3,351,False,0,1,1,1057,25,9.660555555555556,Document
Starlark,440,286,459.23657407407404,MERGED,1,1,1,0,1,36,False,0,0,0,1330,2,0.9997222222222222,Bug
C#,80,125,791.8652662037038,CLOSED,17573,52,250,1,3,184,False,1,0,0,1044,17625,44.190555555555555,Document
TypeScript,4,33,734.1012615740741,MERGED,1,1,1,1,3,352,False,0,1,1,1142,2,0.1225,Bug
C++,363,552,508.0522337962963,MERGED,23,19,5,0,3,185,False,0,0,0,1479,42,4.368055555555555,Document
TypeScript,3392,2334,939.2514004629629,MERGED,1,1,1,2,1,231,False,0,2,1,1227,2,1.0841666666666667,Bug
TypeScript,1297,21107,387.7230555555555,CLOSED,195,5322,55,2,3,794,True,0,2,2,4939,5517,1.636388888888889,Document
C#,80,125,791.0609375,CLOSED,90,62,6,1,4,182,False,1,0,0,1131,152,62.30777777777778,Document
TypeScript,3392,2334,939.1245486111111,MERGED,41,40,3,3,1,0,False,0,3,2,1638,81,2.852777777777778,Feature
TypeScript,3392,2334,939.1782407407408,CLOSED,6,4,2,1,1,79,False,0,1,1,1293,10,0.15083333333333335,Feature
Vue,0,1,216.3276388888889,MERGED,2,4,1,1,3,1,False,0,1,1,1051,6,66.0188888888889,Feature
Java,450,746,4044.3082407407405,MERGED,0,10,1,1,3,368,True,0,1,1,1329,10,19.848333333333333,Document
Go,421,1654,1481.1748726851854,CLOSED,1,276,8,0,1,224,False,0,0,0,5410,277,17.688333333333333,Bug
Erlang,2054,12122,3770.2661921296294,MERGED,36,111,5,2,3,11,False,1,1,1,1706,147,142.38166666666666,Document
TypeScript,3392,2334,938.9652430555556,CLOSED,1,1,1,2,1,230,False,0,2,1,1326,2,0.5027777777777778,Bug
TypeScript,3392,2334,940.2630787037037,CLOSED,1,8,1,2,1,232,False,0,2,1,2350,9,288.9272222222222,Feature
Starlark,440,286,462.9940277777778,CLOSED,0,11459,4,1,10,1,False,0,1,1,1945,11459,193.69694444444445,Document
TypeScript,4,33,733.2209490740742,MERGED,1,2,1,2,1,552,True,1,1,1,1125,3,0.03027777777777778,Feature
TypeScript,4,33,733.210625,MERGED,0,1,1,2,1,551,True,1,1,1,1256,1,0.03166666666666667,Bug
C#,80,125,791.8955208333333,MERGED,65,55,5,0,4,49,True,0,0,0,1911,120,1.8744444444444444,Document
Rust,417,2801,898.3009375,MERGED,405,455,44,1,9,248,False,0,1,1,6049,860,504.4716666666667,Document
TypeScript,1297,21107,386.9044791666667,MERGED,13,36,2,1,3,789,True,0,1,1,3510,49,0.014444444444444444,Document
C++,363,552,507.17118055555557,MERGED,0,12,2,0,2,182,False,0,0,0,1406,12,1.7177777777777778,Document
TypeScript,1297,21107,386.87813657407406,MERGED,21,17,8,1,1,787,True,0,1,1,4227,38,0.020277777777777777,Document
C++,363,552,507.16565972222224,MERGED,0,1,1,0,1,99,False,0,0,0,1265,1,0.1688888888888889,Document
JavaScript,8844,63474,4045.691828703704,MERGED,0,135,10,0,1,56,True,0,0,0,3810,135,16.495833333333334,Feature
TypeScript,3392,2334,938.3568055555555,MERGED,1,1,1,1,1,77,False,0,1,1,1502,2,0.2247222222222222,Document
TypeScript,3392,2334,938.3476157407407,MERGED,2,2,1,1,1,76,False,0,1,1,1307,4,0.2111111111111111,Feature
TypeScript,3392,2334,938.3198842592592,MERGED,6,15,1,1,2,75,False,0,1,1,1612,21,0.31,Bug
C++,363,552,507.03688657407406,MERGED,56,56,6,0,1,81,False,0,0,0,1330,112,2.7955555555555556,Document
C++,363,552,507.0226273148148,MERGED,387,427,6,0,2,80,False,0,0,0,1391,814,3.147222222222222,Document
TypeScript,3392,2334,938.2327199074074,MERGED,0,7,1,1,1,258,False,0,1,1,1275,7,0.155,Feature
TypeScript,3392,2334,938.225474537037,MERGED,0,5,1,1,1,618,False,0,1,1,1269,5,0.015,Feature
TypeScript,41369,87411,2909.7312962962965,MERGED,4,37,4,2,4,557,True,1,1,1,2774,41,25.04611111111111,Document
TypeScript,3392,2334,938.1419907407408,MERGED,1,4,1,1,1,74,False,0,1,1,1390,5,0.22777777777777777,Bug
Java,450,746,4043.338738425926,MERGED,23,16,5,2,9,366,True,0,2,1,1445,39,22.040277777777778,Bug
TypeScript,3392,2334,938.1110185185184,MERGED,0,12,1,1,1,256,False,0,1,1,1542,12,0.5011111111111111,Feature
TypeScript,4,33,732.6757986111111,MERGED,30,55,7,1,2,369,True,0,1,1,1501,85,0.17666666666666667,Bug
TypeScript,3392,2334,937.9756944444445,MERGED,0,3,1,1,1,616,False,0,1,1,1189,3,0.06555555555555556,Bug
TypeScript,3392,2334,937.9387847222223,MERGED,3,14,1,1,1,614,False,0,1,1,1734,17,0.15805555555555556,Bug
Java,450,746,4043.232905092593,MERGED,8,52,7,2,2,62,True,0,2,1,4853,60,16.9675,Bug
TypeScript,15,34,462.61268518518517,MERGED,101,79,5,0,1,853,False,0,0,0,5040,180,0.5313888888888889,Feature
Starlark,440,286,465.35405092592595,MERGED,9,23,1,0,1,38,False,0,0,0,1875,32,61.565555555555555,Bug
C++,363,552,505.56972222222225,MERGED,9,4,1,0,1,98,False,0,0,0,1288,13,40.528055555555554,Document
C++,363,552,506.14766203703704,MERGED,34,5,3,0,2,178,False,0,0,0,1733,39,17.18861111111111,Document
C#,80,125,790.5660532407406,MERGED,141,443,14,3,1,1,False,2,1,1,1012,584,24.47138888888889,Document
TypeScript,3392,2334,936.9275925925926,MERGED,7,35,2,1,1,72,False,0,1,1,1304,42,24.045833333333334,Feature
C++,363,552,506.1374421296296,MERGED,41,36,2,0,1,177,False,0,0,0,1401,77,6.429166666666666,Document
Vue,0,1,216.32413194444442,MERGED,1,2,1,1,1,0,False,0,1,1,1275,3,0.04055555555555555,Feature
JavaScript,8844,63474,4052.4332060185184,MERGED,4,160,14,12,3,0,False,6,6,2,4687,164,452.12944444444446,Document
Erlang,2054,12122,3771.1150347222224,MERGED,7,30,5,0,3,472,True,0,0,0,2015,37,45.13583333333333,Document
C++,363,552,506.1617476851852,MERGED,9,1,1,0,1,179,False,0,0,0,1372,10,2.1708333333333334,Document
Go,421,1654,1478.9211921296298,MERGED,138,156,11,1,1,398,True,1,0,0,5951,294,25.431944444444444,Bug
Rust,264,5382,375.85028935185187,MERGED,3,5,1,0,1,373,False,0,0,0,2242,8,26.229166666666668,Document
TypeScript,7,6,618.0622106481482,MERGED,65,62,2,2,2,201,False,0,2,2,2032,127,46.74583333333333,Feature
TypeScript,3392,2334,941.2575347222222,MERGED,2,2,1,2,3,233,False,0,2,1,1984,4,146.37777777777777,Feature
TypeScript,15,34,461.4558449074074,CLOSED,39,90,3,0,1,139,False,0,0,0,4047,129,0.03666666666666667,Feature
TypeScript,3392,2334,944.9621643518518,MERGED,1,4,1,2,1,437,False,0,2,1,2285,5,1.5569444444444445,Feature
TypeScript,41369,87411,2909.7180787037037,MERGED,43,1054,8,5,3,1549,True,1,4,2,5988,1097,0.4786111111111111,Document
TypeScript,1297,21107,384.93503472222227,MERGED,7,26,6,1,1,771,True,0,1,1,3561,33,0.13277777777777777,Document
TypeScript,1297,21107,384.8930324074074,MERGED,44,0,7,1,2,769,True,0,1,1,3661,44,0.026944444444444444,Document
TypeScript,1297,21107,384.88314814814817,MERGED,24,94,6,1,1,768,True,0,1,1,3776,118,0.06722222222222222,Document
Go,1295,18029,493.45855324074074,MERGED,6,15,2,0,1,433,True,0,0,0,2376,21,0.1622222222222222,Feature
Go,1295,18029,493.4574768518519,MERGED,1,52,2,0,1,432,True,0,0,0,1818,53,0.03305555555555555,Feature
TypeScript,1297,21107,384.59909722222227,MERGED,116,118,16,1,1,767,True,0,1,1,4634,234,0.13555555555555557,Document
TypeScript,3392,2334,944.1083680555556,MERGED,20,20,1,2,1,237,False,0,2,1,1967,40,6.534722222222222,Feature
Python,2407,12180,215.65553240740743,CLOSED,0,12,2,6,1,2,False,2,4,1,1801,12,9.095833333333333,Document
TypeScript,41369,87411,2907.5156134259255,MERGED,10,1,2,0,1,1882,True,0,0,0,2854,11,1.1947222222222222,Document
Python,2407,12180,215.77047453703702,MERGED,6,59,6,3,11,206,True,2,1,1,2119,65,0.9794444444444445,Document
Python,2407,12180,215.47685185185185,MERGED,1,1,1,2,2,0,False,1,1,1,1897,2,8.07611111111111,Document
Python,2407,12180,215.62684027777777,CLOSED,0,12,2,1,1,1,False,1,0,0,1733,12,0.5586111111111111,Document
TypeScript,15,34,460.0678703703704,MERGED,52,185,8,0,2,848,False,0,0,0,4534,237,11.810555555555556,Feature
JavaScript,3618,9017,2260.425335648148,MERGED,27,92,10,11,10,333,False,4,7,5,3557,119,122.46,Bug
TypeScript,41369,87411,2907.4984375,MERGED,2,30,4,2,2,65,True,1,1,1,4174,32,0.44916666666666666,Document
TypeScript,178,1359,296.4951388888889,MERGED,23,192,20,6,9,3,True,2,4,2,9011,215,13.159166666666666,Feature
Python,2407,12180,214.8492476851852,MERGED,219,217,131,8,9,9,False,4,4,1,1988,436,2.4272222222222224,Document
Erlang,2054,12122,3770.1260185185183,MERGED,44,215,18,1,5,294,False,0,1,1,1749,259,5.150277777777778,Document
Python,2407,12180,213.60645833333334,CLOSED,0,7,1,0,3,7,False,0,0,0,1760,7,0.37,Document
TypeScript,4,33,734.1006365740741,MERGED,136,157,55,2,13,183,True,1,1,1,2148,293,155.38861111111112,Feature
Python,2407,12180,214.13979166666664,MERGED,5,4,2,0,10,201,True,0,0,0,1945,9,2.9983333333333335,Document
Python,2407,12180,214.1088888888889,CLOSED,3,3,1,0,1,200,True,0,0,0,2049,6,0.7438888888888889,Document
TypeScript,3392,2334,942.2015509259259,MERGED,9,5,1,1,1,268,False,0,1,1,1937,14,0.17444444444444446,Bug
TypeScript,3392,2334,942.1795949074075,MERGED,12,27,2,1,1,267,False,0,1,1,2526,39,0.17916666666666667,Bug
TypeScript,4,33,737.6327777777778,MERGED,10,3,2,1,2,143,False,0,1,1,1841,13,0.12111111111111111,Bug
Python,2407,12180,213.6107986111111,MERGED,3,3,1,2,2,0,False,1,1,1,1867,6,3.0213888888888887,Document
TypeScript,4,33,737.2061342592592,MERGED,2,18,3,1,3,353,False,0,1,1,1891,20,0.13,Feature
TypeScript,4,33,736.3039467592592,MERGED,121,156,7,1,2,563,True,0,1,1,2343,277,25.920277777777777,Bug
Vue,0,1,220.97324074074075,MERGED,5,44,2,1,4,32,False,0,1,1,1638,49,1.1630555555555555,Feature
Go,1,4,188.09778935185184,MERGED,51,41,10,0,2,1,False,0,0,0,2294,92,1.3391666666666666,Document
TypeScript,3392,2334,941.0293865740741,MERGED,5,5,2,2,1,434,False,0,2,1,2351,10,2.9166666666666665,Feature
TypeScript,3392,2334,939.5230092592592,MERGED,7,5,2,1,1,260,False,0,1,1,2086,12,55.62027777777778,Feature
Go,421,1654,1481.486111111111,MERGED,198,2568,39,0,20,51,False,0,0,0,9133,2766,182.135,Bug
Python,24585,55553,4621.011284722222,MERGED,3,3,2,0,1,520,False,0,0,0,2122,6,25.74277777777778,Bug
TypeScript,4,33,735.4758217592592,MERGED,6,49,2,2,2,559,True,1,1,1,2042,55,0.5572222222222222,Bug
Starlark,440,286,460.8472106481481,MERGED,4,60,1,0,2,3,False,0,0,0,1951,64,2.3855555555555554,Feature
Starlark,440,286,460.8044675925926,CLOSED,0,328,2,0,23,2,False,0,0,0,2029,328,0.7105555555555556,Document
Python,2407,12180,210.92390046296296,MERGED,1,1,1,1,2,6,False,0,1,1,1701,2,1.7347222222222223,Document
TypeScript,139,827,720.2866666666667,MERGED,0,441,7,3,4,1243,True,1,2,2,1881,441,17.273611111111112,Document
TypeScript,3392,2334,939.3663541666666,MERGED,56,30,6,2,2,0,False,0,2,1,2096,86,3.5775,Bug
Vue,0,1,218.3710648148148,MERGED,3,8,3,1,5,136,True,1,0,0,2082,11,17.085833333333333,Feature
TypeScript,4,33,734.4775462962963,MERGED,15,28,4,1,1,137,False,0,1,1,2132,43,0.18666666666666668,Bug
TypeScript,4,33,734.0772685185185,CLOSED,122,115,12,2,15,181,True,1,1,1,2020,237,0.17333333333333334,Bug
Rust,433,2229,207.28952546296296,MERGED,0,80,3,1,2,198,False,0,1,1,2094,80,0.6433333333333333,Bug
Rust,433,2229,207.2675,MERGED,0,39,1,1,1,197,False,0,1,1,1629,39,0.3938888888888889,Feature
TypeScript,3392,2334,938.1094560185185,MERGED,3,3,1,2,1,331,False,0,2,1,2033,6,37.543055555555554,Feature
TypeScript,2071,16638,1218.2936458333334,MERGED,47,50,3,0,4,9,False,0,0,0,4840,97,163.29861111111111,Document
C++,363,552,505.5163310185185,MERGED,2803,341,30,6,10,97,False,2,4,3,1841,3144,88.97777777777777,Document
Python,547,7159,2210.6526736111114,MERGED,14,249,12,0,22,243,True,0,0,0,5330,263,356.97,Document
Starlark,440,286,459.360625,MERGED,0,398,2,1,4,0,False,1,0,0,2239,398,440.99361111111114,Document
C++,363,552,507.1187615740741,MERGED,0,17,4,6,9,181,False,3,3,1,1812,17,6.020555555555555,Document
Java,450,746,4043.3373032407403,CLOSED,9,8,4,1,2,365,True,0,1,1,1755,17,0.025,Bug
Starlark,440,286,461.988587962963,CLOSED,0,678,4,0,2,4,False,0,0,0,2412,678,336.1347222222222,Document
Python,19248,70257,2437.7705671296294,CLOSED,39,597,26,12,8,119,False,6,6,2,2987,636,122.62444444444445,Bug
Starlark,440,286,466.48576388888887,MERGED,0,235,4,1,4,2,False,1,0,0,2507,235,83.26,Feature
TypeScript,4,33,731.3371643518518,MERGED,12,115,9,1,2,366,True,0,1,1,1911,127,6.655277777777778,Feature
TypeScript,2071,16638,1218.9702893518518,CLOSED,0,371,10,1,3,0,False,0,1,1,5771,371,54.47472222222222,Document
TypeScript,58,78,795.2648032407407,MERGED,18,86,4,1,4,167,True,0,1,1,2773,104,91.3175,Document
PHP,0,0,78.07326388888889,MERGED,39,259,19,0,13,39,True,0,0,0,8434,298,189.91583333333332,Document
Rust,264,5382,380.795162037037,CLOSED,8,634,21,0,4,191,True,0,0,0,5229,642,4.703611111111111,Document
C++,2234,23694,2330.810497685185,MERGED,79,219,8,1,22,253,False,0,1,1,5283,298,140.39416666666668,Feature
Starlark,440,286,466.1566319444444,MERGED,0,363,2,0,4,5,False,0,0,0,2991,363,91.76805555555555,Feature
Rust,264,5382,380.21185185185186,MERGED,34,34,16,0,2,0,False,0,0,0,6093,68,0.44277777777777777,Bug
Starlark,440,286,467.0724074074074,CLOSED,0,308,6,1,7,2,False,1,0,0,5105,308,718.2880555555555,Feature
Go,1835,11245,1700.812222222222,MERGED,51,1597,22,1,2,9,True,0,1,1,6266,1648,44.1125,Bug
TypeScript,1297,21107,391.63916666666665,CLOSED,81,105,35,9,5,29,False,1,8,3,6153,186,74.705,Document
Starlark,440,286,464.10173611111117,MERGED,0,374,3,0,1,5,False,0,0,0,3397,374,140.8936111111111,Document
Rust,264,5382,375.7764814814814,MERGED,17,656,9,3,18,0,False,2,1,1,5277,673,104.98527777777778,Document
Starlark,440,286,465.8276388888889,MERGED,12,22,1,0,1,78,False,0,0,0,2330,34,50.18611111111111,Feature
Starlark,440,286,464.8887268518518,MERGED,0,189,2,0,2,77,False,0,0,0,2619,189,72.74583333333334,Document
Go,54,353,705.8994560185184,MERGED,25,33,2,5,5,203,True,2,3,1,2317,58,185.86777777777777,Document
Starlark,440,286,460.25650462962966,MERGED,0,239,3,2,1,0,False,2,0,0,2805,239,231.5727777777778,Feature
TypeScript,1297,21107,392.9378472222222,MERGED,49,98,14,2,1,825,True,0,2,2,6509,147,0.1463888888888889,Document
TypeScript,1297,21107,392.9294212962963,MERGED,40,66,6,1,3,824,True,0,1,1,6056,106,0.025277777777777777,Document
JavaScript,8844,63474,4050.3567476851854,MERGED,428,366,163,0,3,65,True,0,0,0,6523,794,48.3475,Bug
TypeScript,1297,21107,392.83133101851854,MERGED,18,47,4,2,1,820,True,0,2,2,6148,65,0.16055555555555556,Document
TypeScript,41369,87411,2911.667407407407,CLOSED,1061,1317,262,0,1,1884,True,0,0,0,8003,2378,703.1544444444445,Document
Go,789,5551,1015.1125462962963,MERGED,1,3,1,0,1,215,False,0,0,0,2456,4,0.8294444444444444,Document
Go,789,5551,1014.8254976851853,MERGED,1,1,1,0,1,8,False,0,0,0,2169,2,1.5072222222222222,Document
Starlark,440,286,461.1728703703704,MERGED,0,499,4,4,3,0,False,2,2,2,2516,499,161.79083333333332,Document
Starlark,440,286,461.10239583333333,MERGED,53,24,2,0,3,14,False,0,0,0,3156,77,163.37222222222223,Feature
Go,789,5551,1014.061712962963,MERGED,12,16,2,0,1,416,False,0,0,0,2266,28,25.574166666666667,Document
TypeScript,15,34,464.45152777777776,MERGED,817,1238,23,0,35,454,True,0,0,0,7421,2055,146.5325,Bug
Go,789,5551,1014.0739930555555,CLOSED,7,7,1,1,1,7,False,1,0,0,2958,14,1.1058333333333332,Document
Starlark,440,286,459.1009259259259,MERGED,2,2,1,0,3,1,False,0,0,0,2351,4,208.76527777777778,Document
Go,789,5551,1013.9694212962963,MERGED,4,4,1,0,1,415,False,0,0,0,2588,8,2.504722222222222,Document
Go,789,5551,1013.8952199074074,MERGED,21,23,3,0,1,245,True,0,0,0,3050,44,2.5505555555555555,Document
Go,789,5551,1013.8431828703705,MERGED,23,23,3,0,1,244,True,0,0,0,3077,46,1.0308333333333333,Document
Python,2407,12180,215.17039351851852,MERGED,1,1,1,2,2,0,False,1,1,1,2117,2,1.8305555555555555,Document
TypeScript,307,2556,511.4281134259259,MERGED,2,103,10,4,3,11,False,2,2,1,6761,105,30.994444444444444,Feature
Go,789,5551,1012.872650462963,MERGED,5,9,2,0,1,243,True,0,0,0,2549,14,23.780277777777776,Document
C,5529,39701,31.94880787037037,MERGED,43,123,1,2,6,13,True,1,1,1,3142,166,45.805277777777775,Bug
HTML,118,8,47.08700231481481,MERGED,34,54,4,0,44,10,True,0,0,0,2480,88,0.0225,Document
Go,789,5551,1012.8684143518518,MERGED,13,27,3,0,1,242,True,0,0,0,3174,40,0.8036111111111112,Document
C#,80,125,790.7368865740741,MERGED,62,63,4,1,6,186,True,1,0,0,9107,125,215.32055555555556,Document
Python,2407,12180,213.91512731481484,MERGED,7,8,4,0,12,199,True,0,0,0,2505,15,3.096111111111111,Document
TypeScript,3392,2334,942.1697453703704,MERGED,5,10,4,1,1,266,False,0,1,1,2700,15,0.32555555555555554,Document
TypeScript,4,33,736.6874305555556,MERGED,15,52,2,2,2,565,True,1,1,1,2595,67,14.696111111111112,Document
Vue,0,1,221.1049537037037,MERGED,8,87,4,0,3,143,True,0,0,0,2589,95,0.22527777777777777,Bug
TypeScript,1297,21107,388.8807291666667,MERGED,60,68,7,2,1,804,True,0,2,2,7275,128,0.1622222222222222,Document
TypeScript,1297,21107,388.8761342592593,MERGED,21,76,13,1,1,803,True,0,1,1,5517,97,0.023333333333333334,Document
TypeScript,1297,21107,388.57684027777776,MERGED,199,50,2,1,1,800,True,0,1,1,5509,249,0.035555555555555556,Document
Starlark,440,286,460.97430555555553,MERGED,6,9,1,0,4,4,False,0,0,0,2462,15,22.960833333333333,Feature
Vue,0,1,219.3296412037037,MERGED,12,18,3,0,2,138,True,0,0,0,2752,30,25.05,Feature
TypeScript,1297,21107,387.9893287037037,MERGED,17362,19233,39,2,8,799,True,0,2,2,7188,36595,1.5077777777777779,Document
TypeScript,1297,21107,387.9744097222222,MERGED,165,8,13,1,1,798,True,0,1,1,5559,173,0.011111111111111112,Document
TypeScript,4,33,735.6934490740741,MERGED,20,76,4,1,2,140,False,0,1,1,2564,96,0.195,Document
Starlark,440,286,460.9428356481481,MERGED,14,16,2,0,1,76,False,0,0,0,2924,30,0.07444444444444444,Document
TypeScript,139,827,720.5090624999999,MERGED,38,159,11,2,6,1244,True,0,2,2,3241,197,34.745,Bug
TypeScript,15,34,461.619537037037,MERGED,49,130,6,1,2,117,False,0,1,1,6218,179,64.67944444444444,Feature
TypeScript,4,33,734.2334837962962,MERGED,8,62,3,2,2,184,True,1,1,1,3233,70,22.71611111111111,Document
Rust,433,2229,207.79652777777778,MERGED,33,34,1,1,4,200,False,0,1,1,3042,67,12.484444444444444,Bug
Rust,433,2229,207.83211805555558,MERGED,12,13,1,2,1,201,False,0,2,2,2320,25,9.668888888888889,Feature
TypeScript,15,34,462.45577546296295,MERGED,36,138,6,0,3,143,False,0,0,0,6020,174,16.86138888888889,Feature
Rust,433,2229,207.3077546296296,MERGED,300,404,12,1,7,199,False,0,1,1,2379,704,14.903333333333334,Feature
TypeScript,3392,2334,938.1493402777778,MERGED,15,63,5,1,2,617,False,0,1,1,2679,78,1.246388888888889,Document
TypeScript,3392,2334,938.0320254629629,MERGED,12,18,6,1,5,255,False,0,1,1,2910,30,0.7677777777777778,Bug
Rust,433,2229,206.69822916666666,MERGED,0,254,7,1,1,195,False,0,1,1,2996,254,0.4486111111111111,Feature
TypeScript,3392,2334,937.031261574074,MERGED,12,113,4,1,1,73,False,0,1,1,2612,125,22.8775,Feature
TypeScript,41369,87411,2906.789861111111,MERGED,0,408,102,0,3,104,False,0,0,0,5360,408,39.843333333333334,Document
Python,19248,70257,2435.8209375,CLOSED,84,96,4,4,8,568,False,3,1,1,6059,180,101.15138888888889,Bug
Python,19248,70257,2435.6532060185186,CLOSED,208,46,3,2,2,567,False,1,1,1,5727,254,76.56027777777778,Feature
Python,2407,12180,212.94449074074075,MERGED,5,26,2,5,9,0,False,2,3,1,3408,31,26.57611111111111,Document
Python,2407,12180,211.77039351851852,CLOSED,10,99,6,18,11,0,False,7,11,3,4198,109,21.424444444444443,Document
Starlark,440,286,465.36785879629633,MERGED,0,230,4,2,13,0,False,2,0,0,3225,230,296.8311111111111,Document
TypeScript,2147,14722,1442.8077662037037,MERGED,891,2391,45,0,25,57,False,0,0,0,14750,3282,0.5566666666666666,Document
TypeScript,2147,14722,1442.803553240741,CLOSED,898,2399,45,0,25,56,False,0,0,0,14332,3297,0.1297222222222222,Document
C++,2234,23694,2329.8002546296298,MERGED,83,30,5,2,3,252,False,1,1,1,8449,113,166.48638888888888,Feature
Rust,264,5382,376.9971527777778,MERGED,93,15951,15,3,15,290,False,2,1,1,9176,16044,120.93083333333334,Feature
C++,2234,23694,2329.649351851852,MERGED,32,82,10,2,3,251,False,1,1,1,9414,114,144.26333333333332,Feature
Rust,591,3260,522.2237037037037,MERGED,149,281,9,0,13,175,True,0,0,0,6741,430,67.04388888888889,Document
Rust,591,3260,520.6167592592593,MERGED,65,800,17,4,7,66,False,3,1,1,6410,865,113.26138888888889,Document
TypeScript,58,78,793.2338541666667,MERGED,137,113,8,4,2,173,False,3,1,1,4156,250,123.59277777777778,Feature
C++,363,552,513.9327199074074,CLOSED,11,32,2,0,1,25,True,0,0,0,5575,43,861.8122222222222,Document
TypeScript,3989,23860,2804.2627893518516,MERGED,0,25,4,1,14,8,False,0,1,1,3852,25,67.17833333333333,Document
TypeScript,1297,21107,390.59171296296296,MERGED,130,78,8,2,1,810,True,0,2,2,8867,208,0.22,Document
Starlark,440,286,460.39251157407404,MERGED,0,380,4,2,10,0,False,1,1,1,3698,380,254.93333333333334,Document
Starlark,440,286,466.1899074074074,CLOSED,33,72,1,1,1,0,False,1,0,0,3974,105,0.14,Bug
Java,450,746,4046.205648148148,MERGED,159,457,15,2,3,64,True,0,2,1,10256,616,29.7625,Bug
Go,789,5551,1014.3955902777778,CLOSED,10,63,4,1,1,2,False,0,1,1,4218,73,23.690277777777776,Document
TypeScript,4,33,739.1946875,MERGED,126,288,4,1,5,356,False,0,1,1,3980,414,21.358333333333334,Feature
Vue,0,1,223.35868055555557,MERGED,759,617,97,0,14,148,True,0,0,0,4640,1376,20.31138888888889,Feature
Starlark,440,286,461.31697916666667,MERGED,4,299,8,1,15,4,False,0,1,1,3968,303,158.4,Bug
Go,1295,18029,493.4731828703704,MERGED,63,36,9,1,1,434,True,1,0,0,4473,99,0.06777777777777778,Bug
C++,363,552,511.51375,MERGED,174,376,19,0,1,153,False,0,0,0,3724,550,70.905,Document
Python,2407,12180,215.25980324074075,MERGED,23,10,4,0,20,205,True,0,0,0,3346,33,0.04694444444444444,Document
Go,1295,18029,493.0472569444444,MERGED,3443,3867,9,0,2,428,True,0,0,0,3650,7310,0.15555555555555556,Document
TypeScript,41369,87411,2913.9895833333335,CLOSED,18,33,4,0,2,0,False,0,0,0,2516,51,82.74138888888889,Bug
Java,450,746,4047.247986111111,MERGED,210,172,15,3,12,15,False,0,3,2,4239,382,69.5375,Feature
TypeScript,307,2556,511.5599884259259,MERGED,135,157,10,4,5,546,True,2,2,1,4023,292,98.27166666666666,Bug
TypeScript,149,2900,350.728587962963,MERGED,3888,6541,455,3,127,158,True,1,2,2,4372,10429,139.86,Document
Python,14532,41181,1061.3631828703703,MERGED,185,172,101,0,2,1398,True,0,0,0,3216,357,0.13527777777777777,Document
Erlang,2054,12122,3765.7147916666668,MERGED,10,17,4,0,2,320,True,0,0,0,2718,27,94.975,Document
TypeScript,3392,2334,941.887349537037,MERGED,716,26,9,1,2,628,False,0,1,1,3841,742,0.2038888888888889,Document
TypeScript,307,2556,508.7784027777778,MERGED,42,77,6,1,4,542,True,1,0,0,4209,119,40.010555555555555,Bug
TypeScript,3392,2334,941.1304976851852,MERGED,508,306,17,1,4,627,False,0,1,1,3681,814,17.035,Bug
Python,2407,12180,212.140625,MERGED,178,232,2,0,4,196,True,0,0,0,4167,410,0.10222222222222223,Document
Starlark,440,286,461.26856481481485,CLOSED,4,289,7,0,9,3,False,0,0,0,3632,293,0.07111111111111111,Bug
Python,2407,12180,211.72981481481483,MERGED,32,41,9,0,13,195,True,0,0,0,4811,73,3.3222222222222224,Document
TypeScript,4,33,735.4120370370371,MERGED,40,83,14,2,1,558,True,1,1,1,3107,123,2.8297222222222222,Bug
Python,2407,12180,214.85612268518517,MERGED,216,203,131,4,2,203,True,1,3,2,4587,419,0.08527777777777777,Document
Rust,433,2229,208.4224537037037,MERGED,0,27,3,0,2,204,False,0,0,0,4601,27,3.641388888888889,Feature
TypeScript,139,827,720.5612268518518,MERGED,9,101,6,2,3,8,False,0,2,2,3281,110,14.724444444444444,Feature
Python,2407,12180,210.96658564814814,MERGED,3,6,2,6,6,0,False,3,3,1,3265,9,6.7575,Document
TypeScript,3392,2334,940.2090393518519,MERGED,17,577,10,1,1,622,False,0,1,1,4411,594,0.1511111111111111,Feature
Ruby,2,1,292.44162037037034,MERGED,40,772,14,0,16,2,True,0,0,0,3230,812,0.4866666666666667,Document
TypeScript,4,33,734.5000347222222,MERGED,17,37,4,2,2,185,True,1,1,1,3930,54,0.06944444444444445,Feature
TypeScript,3392,2334,939.3972337962963,MERGED,30,170,15,1,4,620,False,0,1,1,3570,200,10.163055555555555,Feature
TypeScript,3392,2334,939.1462615740742,MERGED,38,65,12,1,10,259,False,0,1,1,3371,103,1.71,Bug
Java,450,746,4043.946736111111,CLOSED,121,34,5,2,6,367,True,0,2,1,3853,155,4.641944444444444,Bug
Go,789,5551,1015.4528819444445,MERGED,76,105,3,32,3,0,False,16,16,3,5770,181,610.2694444444444,Document
TypeScript,3989,23860,2806.2222569444443,CLOSED,42,53,6,2,15,9,False,0,2,2,6021,95,534.3805555555556,Document
TypeScript,1756,13210,2306.2178125,MERGED,42,92,4,1,1,87,False,0,1,1,4793,134,9.0425,Document
Python,137,75,660.9896296296296,MERGED,0,2877,111,0,127,71,False,0,0,0,7965,2877,1007.5538888888889,Bug
Python,2407,12180,212.34861111111113,CLOSED,3618,7397,237,1,11,0,False,0,1,1,6258,11015,0.06222222222222222,Document
Vue,0,1,215.35745370370373,MERGED,93,648,20,1,8,114,True,0,1,1,14328,741,20.58222222222222,Bug
Java,1,10,201.10253472222223,MERGED,5068,384,22,0,12,20,True,0,0,0,13855,5452,2.0366666666666666,Document
TypeScript,1297,21107,387.7915972222222,MERGED,205,5172,45,2,5,795,True,0,2,2,11053,5377,0.6394444444444445,Document
TypeScript,4705,54041,1199.8655208333332,MERGED,113,601,5,2,5,501,True,1,1,1,6088,714,12.089166666666667,Bug
TypeScript,15,34,461.5253356481482,MERGED,197,653,39,0,36,453,True,0,0,0,12285,850,26.64638888888889,Feature
TypeScript,3392,2334,941.4492708333333,MERGED,390,454,10,2,4,0,False,0,2,1,5471,844,252.58833333333334,Bug
TypeScript,3392,2334,944.9397685185186,MERGED,650,3134,75,3,162,436,False,0,3,2,10214,3784,749.5097222222222,Bug
TypeScript,3392,2334,940.9532407407409,MERGED,4735,8185,108,1,46,81,False,0,1,1,8131,12920,172.85916666666665,Feature
Rust,591,3260,521.2531712962963,MERGED,719,513,25,0,13,57,False,0,0,0,7748,1232,25.53,Document
TypeScript,3392,2334,944.9695949074074,MERGED,21,38,9,1,2,634,False,0,1,1,6322,59,1.0902777777777777,Feature
Python,2407,12180,215.80091435185184,MERGED,529,2570,106,0,34,207,True,0,0,0,5277,3099,22.585833333333333,Document
Go,30,295,319.17261574074075,MERGED,7,343,11,12,11,82,True,0,12,1,4908,350,69.95111111111112,Bug
Python,2407,12180,214.95291666666665,MERGED,34,43,8,0,7,204,True,0,0,0,6233,77,7.4558333333333335,Document
C++,2234,23694,2329.1169791666666,CLOSED,47,136,4,2,3,198,False,2,0,0,6951,183,72.34527777777778,Bug
TypeScript,4,33,736.210462962963,MERGED,64,125,16,2,4,561,True,1,1,1,5152,189,105.97944444444444,Bug
Python,2407,12180,213.85635416666665,MERGED,26,63,15,1,15,198,True,0,1,1,6862,89,5.113611111111111,Document
Python,2407,12180,214.2745601851852,MERGED,13,205,12,6,5,202,True,2,4,1,5308,218,0.22444444444444445,Document
TypeScript,3392,2334,942.0716898148148,MERGED,41,72,19,1,2,631,False,0,1,1,6168,113,0.30833333333333335,Bug
TypeScript,3392,2334,941.9367708333333,MERGED,99,123,13,1,2,630,False,0,1,1,5592,222,0.21194444444444444,Feature
C++,2234,23694,2328.764328703704,CLOSED,32,67,15,0,2,286,False,0,0,0,6151,99,3.493333333333333,Bug
TypeScript,4,33,736.8028356481482,MERGED,423,186,58,1,1,64,False,0,1,1,5170,609,0.12583333333333332,Document
Vue,0,1,216.28166666666667,MERGED,1141,2558,35,0,18,29,False,0,0,0,5691,3699,171.00555555555556,Document
Java,450,746,4044.9478587962963,MERGED,18,156,4,1,9,747,False,0,1,1,5330,174,54.005833333333335,Bug
Vue,0,1,219.05087962962963,MERGED,59,139,9,0,1,137,True,0,0,0,5582,198,1.021388888888889,Bug
Python,2407,12180,210.75362268518518,MERGED,198,224,16,0,8,194,True,0,0,0,7398,422,12.253055555555555,Document
TypeScript,3392,2334,939.0494791666666,MERGED,44,66,5,1,4,78,False,0,1,1,7852,110,8.615833333333333,Bug
Go,421,1654,1483.28625,MERGED,1369,1341,15,1,15,37,False,0,1,1,24971,2710,524.2075,Bug
TypeScript,4,33,733.2386805555556,MERGED,114,107,8,2,14,180,True,1,1,1,8002,221,20.037777777777777,Feature
TypeScript,3392,2334,936.8870833333334,MERGED,32,50,6,2,1,228,False,0,2,1,7185,82,28.319166666666668,Bug
Rust,413,5117,435.1862384259259,MERGED,5,90,5,0,9,0,False,0,0,0,5316,95,85.68055555555556,Document
Rust,413,5117,436.72554398148145,MERGED,76,7,10,0,1,0,False,0,0,0,5521,83,0.7152777777777778,Document
TypeScript,3392,2334,936.3259374999999,MERGED,91,231,9,1,7,254,False,0,1,1,7338,322,1.4638888888888888,Bug
Rust,591,3260,520.1652314814816,MERGED,239,922,18,1,11,174,True,1,0,0,11125,1161,48.06472222222222,Document
Rust,591,3260,519.2999074074074,MERGED,197,369,9,0,19,25,True,0,0,0,8045,566,64.33583333333333,Document
C++,2234,23694,2329.0336458333336,CLOSED,72,137,10,0,14,287,False,0,0,0,8974,209,210.01583333333335,Bug
TypeScript,4,33,739.5088773148149,MERGED,140,543,34,1,14,371,True,0,1,1,7827,683,37.5775,Document
TypeScript,3392,2334,941.0248611111111,MERGED,242,155,20,1,6,264,False,0,1,1,10979,397,120.14805555555556,Bug
Python,2407,12180,212.27997685185187,MERGED,99,129,9,6,20,197,True,4,2,1,9799,228,24.68777777777778,Document
TypeScript,3392,2334,937.4905902777778,MERGED,4691,206,76,3,3,0,False,0,3,2,8656,4897,64.03,Bug
TypeScript,3392,2334,937.865925925926,MERGED,313,1451,37,1,21,613,False,0,1,1,10509,1764,1.5158333333333334,Feature
Rust,433,2229,206.79666666666665,MERGED,23,687,10,0,3,196,False,0,0,0,8426,710,2.7472222222222222,Bug
TypeScript,3989,23860,2802.8748148148147,MERGED,161,279,16,2,14,61,True,0,2,1,11614,440,33.84111111111111,Bug
Rust,433,2229,208.5281828703704,MERGED,1653,2236,38,1,13,206,False,0,1,1,13205,3889,5.033611111111111,Bug
TypeScript,3392,2334,938.1111342592593,MERGED,70,122,15,1,22,257,False,0,1,1,10867,192,23.822222222222223,Bug
Python,2407,12180,209.8745486111111,MERGED,426,325,18,0,29,192,True,0,0,0,10895,751,8.699166666666667,Document
TypeScript,3392,2334,943.1426967592593,MERGED,119,406,33,5,43,236,False,1,4,3,16503,525,886.4205555555556,Feature
C++,2234,23694,2331.9333101851853,CLOSED,73,115,20,1,19,289,False,1,0,0,13990,188,140.42388888888888,Bug
Python,2407,12180,217.19979166666667,MERGED,57,619,64,0,49,209,True,0,0,0,23877,676,1.3027777777777778,Document
Python,2407,12180,216.79907407407407,MERGED,420,418,48,0,15,208,True,0,0,0,16700,838,1.496388888888889,Document
Python,19248,70257,2432.799328703704,CLOSED,649,1015,15,4,6,56,False,2,2,1,30474,1664,313.1672222222222,Document
TypeScript,85,721,297.00872685185186,MERGED,35,13,1,3,4,2,False,3,0,0,1144,48,72.8125,Document
TypeScript,202,107,1124.6414351851852,MERGED,1,13,2,4,1,199,True,0,4,4,1777,14,0.38416666666666666,Document
TypeScript,3392,2334,947.1773148148148,CLOSED,0,24,2,1,1,277,False,0,1,1,1704,24,23.21638888888889,Feature
TypeScript,4,33,741.2383101851851,CLOSED,1,141,9,2,11,188,True,1,1,1,1811,142,1390.5755555555556,Feature
C#,0,0,95.85230324074074,MERGED,53,69,8,0,8,0,True,0,0,0,3106,122,0.14083333333333334,Document
TypeScript,4,33,741.2396759259259,CLOSED,10,155,6,2,9,189,True,1,1,1,2768,165,1390.5472222222222,Feature
TypeScript,3392,2334,949.2365162037037,CLOSED,3,11,1,2,1,0,False,0,2,1,1639,14,2222.8333333333335,Bug
C++,2234,23694,2337.955034722222,MERGED,0,30,1,1,6,2,False,0,1,1,563,30,456.7388888888889,Document
Rust,417,2801,901.3973726851851,MERGED,84,220,4,2,4,9,False,1,1,1,481,304,1045.8055555555557,Document
TypeScript,149,2900,361.4866435185185,MERGED,160,2812,230,4,429,168,True,0,4,1,75,2972,597.2211111111111,Feature
Python,19248,70257,2439.6305787037036,CLOSED,20,18,3,2,3,1548,False,2,0,0,443,38,3.6491666666666664,Bug
PHP,1334,2960,4188.939814814815,MERGED,0,8,1,0,1,68,False,0,0,0,1880,8,0.48833333333333334,Document
TypeScript,178,1359,300.66697916666664,MERGED,0,4,1,7,1,2,False,1,6,3,628,4,4.266666666666667,Feature
TypeScript,2147,14722,1454.0000347222222,MERGED,0,2,2,0,1,12,False,0,0,0,924,2,72.7161111111111,Feature
TypeScript,178,1359,303.6284259259259,MERGED,3,3,2,1,1,2,True,0,1,1,986,6,0.011944444444444445,Feature
TypeScript,178,1359,299.61412037037036,CLOSED,10,17,1,2,1,0,False,0,2,2,646,27,14.132222222222222,Feature
TypeScript,178,1359,302.60508101851855,MERGED,1,4,1,1,1,1,False,0,1,1,814,5,9.026388888888889,Bug
TypeScript,2147,14722,1453.9257060185184,MERGED,3,3,1,0,1,284,False,0,0,0,1015,6,2.2022222222222223,Feature
Python,19248,70257,2439.6822685185184,CLOSED,1,1,1,1,1,83,False,0,1,1,439,2,1.1636111111111112,Feature
PHP,1334,2960,4185.157534722222,MERGED,1,1,1,3,2,7,False,1,2,2,1587,2,668.8433333333334,Document
TypeScript,178,1359,301.68258101851853,MERGED,2,6,1,1,1,5,True,0,1,1,980,8,0.10888888888888888,Bug
Go,421,1654,1489.9925231481482,CLOSED,238,656,17,10,14,1,False,7,3,1,1854,894,343.43055555555554,Bug
TypeScript,7,6,625.9982175925926,MERGED,1,65,2,0,5,212,False,0,0,0,848,66,289.6136111111111,Feature
TypeScript,2147,14722,1450.139988425926,MERGED,7,6,1,0,1,31,False,0,0,0,580,13,2.040277777777778,Bug
JavaScript,3618,9017,2263.6610416666667,MERGED,3,4,1,7,1,1779,False,2,5,4,832,7,26.859444444444446,Bug
TypeScript,178,1359,300.72219907407407,MERGED,1,1,1,2,2,0,False,0,2,2,905,2,2.7125,Bug
TypeScript,2147,14722,1453.2447685185186,MERGED,2,8,3,0,1,283,False,0,0,0,2223,10,349.7319444444444,Bug
TypeScript,261,3765,654.6058333333334,CLOSED,296,100,6,0,1,824,True,0,0,0,953,396,0.5625,Document
TypeScript,2147,14722,1452.1770949074073,MERGED,1,1,1,0,1,11,False,0,0,0,789,2,0.415,Bug
TypeScript,178,1359,299.8877430555555,MERGED,0,6,1,1,1,4,True,0,1,1,896,6,7.875555555555556,Feature
Python,72,25,1617.5044444444445,MERGED,0,1,1,0,1,21,False,0,0,0,499,1,0.12861111111111112,Bug
Java,547,304,207.88370370370373,MERGED,0,156,1,0,3,1,False,0,0,0,605,156,0.43805555555555553,Document
Java,547,304,207.9261226851852,MERGED,0,72,1,0,4,2,False,0,0,0,623,72,16.157222222222224,Document
TypeScript,199,371,754.9875347222222,MERGED,1,1,1,2,1,32,False,0,2,2,640,2,0.06194444444444445,Feature
TypeScript,85,721,293.2050925925926,MERGED,0,47,1,1,1,1,False,1,0,0,1092,47,0.19055555555555556,Document
C++,2234,23694,2337.907037037037,MERGED,2,2,1,1,1,194,False,0,1,1,516,4,1.5338888888888889,Bug
TypeScript,85,721,296.2452083333333,MERGED,25,10,2,3,2,4,False,2,1,1,1790,35,91.15833333333333,Document
Rust,264,5382,383.41086805555557,MERGED,58,8,6,14,7,0,False,7,7,1,1193,66,513.2680555555555,Feature
TypeScript,2147,14722,1450.0210069444445,MERGED,6,4,1,0,1,151,False,0,0,0,766,10,0.33,Bug
PHP,1334,2960,4187.538414351852,CLOSED,1,1,1,1,1,0,False,0,1,1,1553,2,441.6355555555556,Document
JavaScript,5139,7048,1184.110023148148,MERGED,49,0,3,1,1,92,False,0,1,1,713,49,0.9575,Feature
JavaScript,8844,63474,4058.0197569444445,MERGED,1,1,1,10,1,1,False,3,7,3,688,2,17.857777777777777,Bug
TypeScript,85,721,294.3840740740741,MERGED,5,66,2,4,5,3,False,3,1,1,1870,71,135.90277777777777,Document
JavaScript,5139,7048,1183.8090277777778,MERGED,20,0,2,1,1,87,False,0,1,1,564,20,0.1386111111111111,Feature
C++,2234,23694,2338.832974537037,MERGED,3,4,1,1,1,293,False,0,1,1,734,7,11.086666666666666,Bug
TypeScript,85,721,293.94425925925924,MERGED,4,4,2,0,2,144,False,0,0,0,1366,8,146.5025,Document
TypeScript,85,721,296.25487268518515,MERGED,98,2188,37,0,14,73,False,0,0,0,3206,2286,472.4925,Document
TypeScript,261,3765,657.776724537037,MERGED,1,1,1,0,1,562,True,0,0,0,1083,2,0.42,Document
TypeScript,261,3765,654.7915624999999,MERGED,22,33,4,0,1,87,False,0,0,0,1585,55,118.0625,Document
Go,421,1654,1490.219675925926,CLOSED,2,3,1,2,1,52,False,1,1,1,986,5,4.235,Bug
TypeScript,261,3765,657.5945138888889,MERGED,12,51,10,0,4,840,True,0,0,0,1419,63,4.983611111111111,Document
Starlark,440,286,469.99512731481485,CLOSED,0,126,2,2,6,0,False,2,0,0,1499,126,1447.9725,Feature
Rust,264,5382,382.84835648148146,MERGED,5,5,3,1,1,61,True,1,0,0,702,10,29.37,Bug
TypeScript,178,1359,302.5681597222222,CLOSED,1,2,1,1,1,0,False,0,1,1,1121,3,0.4136111111111111,Bug
Rust,264,5382,382.76017361111116,CLOSED,3,10,3,2,1,374,False,1,1,1,702,13,29.474166666666665,Feature
JavaScript,5139,7048,1184.6739699074074,MERGED,26,48,21,5,3,176,False,0,5,3,2379,74,690.7575,Document
TypeScript,307,2556,519.6564236111111,MERGED,1,208,6,2,4,169,True,0,2,1,2253,209,1098.5933333333332,Feature
TypeScript,2147,14722,1453.7744328703702,MERGED,18,18,2,0,1,93,False,0,0,0,1546,36,1.0394444444444444,Document
TypeScript,178,1359,301.75498842592594,MERGED,6,14,2,3,3,10,True,1,2,2,1711,20,6.822222222222222,Bug
TypeScript,2147,14722,1453.209837962963,MERGED,0,15,3,0,2,17,False,0,0,0,1625,15,14.005277777777778,Feature
TypeScript,261,3765,656.642951388889,MERGED,1,8,2,0,1,834,True,0,0,0,1453,9,0.22444444444444445,Document
TypeScript,2147,14722,1452.2248148148149,MERGED,12,19,4,0,1,662,False,0,0,0,1871,31,42.373333333333335,Document
JavaScript,8844,63474,4056.6390277777778,MERGED,0,13,1,0,3,71,True,0,0,0,1011,13,170.24277777777777,Feature
C++,2234,23694,2334.9035300925925,MERGED,2,2,1,1,1,188,False,0,1,1,545,4,0.04638888888888889,Feature
Go,421,1654,1488.3912152777777,MERGED,0,36,2,0,1,228,False,0,0,0,991,36,16.01888888888889,Bug
Go,421,1654,1488.2836574074074,MERGED,0,2,1,0,1,70,False,0,0,0,1021,2,14.934722222222222,Document
Go,421,1654,1488.2830671296297,MERGED,0,2,1,0,1,69,False,0,0,0,1017,2,14.945833333333333,Document
Go,421,1654,1488.2825810185186,MERGED,0,3,1,0,1,68,False,0,0,0,1021,3,14.953888888888889,Document
Rust,264,5382,382.2245023148148,MERGED,5,5,2,0,3,299,False,0,0,0,727,10,0.5030555555555556,Bug
TypeScript,261,3765,655.9007986111111,MERGED,1,7,2,0,2,245,True,0,0,0,1301,8,0.5275,Document
TypeScript,261,3765,655.7377662037037,MERGED,0,12,2,0,2,830,True,0,0,0,1540,12,0.2608333333333333,Document
TypeScript,178,1359,299.4288657407407,MERGED,1,1,1,1,1,0,False,0,1,1,673,2,15.714444444444444,Bug
TypeScript,261,3765,655.5750694444445,MERGED,4,11,4,0,2,163,False,0,0,0,1534,15,0.8125,Document
TypeScript,261,3765,655.4979398148148,MERGED,523,11,28,0,1,828,True,0,0,0,1253,534,0.6652777777777777,Document
Python,547,7159,2217.0414699074076,MERGED,3,127,6,0,21,93,False,0,0,0,970,130,874.0077777777777,Bug
PHP,883,2337,1811.887337962963,CLOSED,7,107,3,2,1,7,False,0,2,2,4265,114,1466.3930555555555,Document
Rust,511,2097,1658.6673611111112,MERGED,0,10,1,0,1,67,False,0,0,0,5211,10,0.5061111111111111,Document
TypeScript,261,3765,654.7605208333333,MERGED,1974,0,35,0,1,254,True,0,0,0,1576,1974,16.613611111111112,Document
TypeScript,181,3310,1605.2460879629627,MERGED,49,181,6,1,14,75,False,1,0,0,2090,230,467.2083333333333,Bug
JavaScript,5139,7048,1184.0812152777778,MERGED,2,2,2,1,13,91,False,0,1,1,1033,4,0.03027777777777778,Feature
JavaScript,5139,7048,1183.959201388889,MERGED,2,2,2,1,12,90,False,0,1,1,1093,4,0.04777777777777778,Bug
Go,421,1654,1490.9332986111112,MERGED,1,4,1,0,1,408,True,0,0,0,1480,5,77.21805555555555,Bug
Rust,264,5382,381.0020949074074,MERGED,0,4,1,1,1,192,True,1,0,0,738,4,0.30916666666666665,Feature
JavaScript,5139,7048,1183.753622685185,MERGED,15,2,2,1,2,85,False,0,1,1,961,17,0.3786111111111111,Bug
C++,2234,23694,2335.9952893518516,MERGED,1,1,1,1,1,191,False,0,1,1,542,2,0.034166666666666665,Bug
TypeScript,178,1359,299.47122685185184,MERGED,2,15,1,1,2,1,False,0,1,1,1387,17,17.520833333333332,Feature
PHP,1334,2960,4187.351840277778,MERGED,1,8,1,0,1,62,False,0,0,0,1654,9,137.36694444444444,Document
TypeScript,261,3765,654.6572685185185,MERGED,0,7,2,0,2,136,True,0,0,0,1467,7,0.23333333333333334,Document
Go,421,1654,1487.1545601851851,MERGED,1,1,1,0,1,402,True,0,0,0,811,2,0.6905555555555556,Bug
JavaScript,5139,7048,1183.4796527777778,MERGED,3,3,2,1,3,0,False,0,1,1,905,6,4.219166666666666,Document
TypeScript,261,3765,654.5045601851851,MERGED,2,5,3,0,1,554,True,0,0,0,1080,7,2.8,Document
TypeScript,2147,14722,1453.2369675925927,MERGED,6,33,6,0,1,282,False,0,0,0,2459,39,349.92277777777775,Feature
TypeScript,15,34,469.64038194444447,MERGED,0,4,1,0,1,869,False,0,0,0,560,4,0.04111111111111111,Feature
TypeScript,85,721,294.028125,MERGED,14,17,1,0,3,72,False,0,0,0,1302,31,0.051666666666666666,Document
PHP,883,2337,1813.0647800925926,CLOSED,26,26,1,2,1,14,False,0,2,2,1799,52,599.8830555555555,Document
TypeScript,2147,14722,1454.111111111111,MERGED,33,82,7,0,4,70,False,0,0,0,1971,115,44.7025,Feature
TypeScript,261,3765,653.8957175925926,MERGED,1,2,1,0,1,821,True,0,0,0,1217,3,2.9816666666666665,Document
TypeScript,7,6,625.1975810185185,CLOSED,2,2,1,1,1,211,False,1,0,0,897,4,18.605,Feature
TypeScript,2147,14722,1454.0631944444447,MERGED,168,19,4,0,1,94,False,0,0,0,2106,187,41.24527777777778,Document
Python,547,7159,2217.655462962963,MERGED,31,181,8,0,8,247,True,0,0,0,748,212,0.665,Bug
PHP,1334,2960,4185.989050925926,CLOSED,1,1,1,7,1,0,False,3,4,1,1337,2,144.42416666666668,Document
Rust,264,5382,383.78930555555553,MERGED,1,6,2,0,2,13,False,0,0,0,967,7,2.325833333333333,Bug
Rust,264,5382,383.7649768518518,MERGED,3,3,1,2,1,303,False,1,1,1,818,6,1.5102777777777778,Bug
TypeScript,2147,14722,1450.2122916666667,MERGED,1,67,3,0,1,660,False,0,0,0,1605,68,0.235,Document
TypeScript,15,34,471.0617824074074,MERGED,0,1,1,0,1,41,False,0,0,0,628,1,0.25,Document
TypeScript,7,6,624.9776273148149,MERGED,8,8,4,0,1,276,False,0,0,0,1123,16,0.1761111111111111,Bug
Go,421,1654,1490.9908796296295,MERGED,4,6,1,0,1,230,False,0,0,0,1515,10,4.114444444444445,Bug
TypeScript,15,34,470.2505092592592,MERGED,2,6,1,1,3,461,True,1,0,0,835,8,26.672777777777778,Bug
Rust,264,5382,383.0800462962963,MERGED,6,6,4,0,1,63,True,0,0,0,880,12,15.988611111111112,Bug
TypeScript,261,3765,657.6411574074074,MERGED,3,3,3,0,3,561,True,0,0,0,1780,6,0.7727777777777778,Document
Java,450,746,4052.2050810185187,MERGED,1,1,1,1,1,136,False,0,1,1,724,2,0.08138888888888889,Bug
JavaScript,9664,43889,3637.1174768518517,CLOSED,3,993,4,0,3,47,True,0,0,0,679,996,976.1027777777778,Feature
TypeScript,261,3765,657.4606018518518,MERGED,5,90,3,0,5,839,True,0,0,0,1876,95,1.4127777777777777,Document
TypeScript,261,3765,657.425625,MERGED,3,6,2,0,2,838,True,0,0,0,1970,9,1.183888888888889,Document
TypeScript,178,1359,301.7952777777778,MERGED,45,71,3,7,6,6,True,2,5,3,2244,116,19.240833333333335,Feature
TypeScript,178,1359,301.1745949074074,MERGED,279,528,4,9,10,0,False,3,6,3,2512,807,43.29694444444444,Bug
TypeScript,15,34,469.75695601851857,MERGED,0,6,1,0,2,871,False,0,0,0,757,6,20.81361111111111,Feature
Rust,264,5382,382.8797569444444,MERGED,1,1,1,1,1,62,True,1,0,0,776,2,1.0355555555555556,Feature
JavaScript,8844,63474,4056.3432638888885,MERGED,29,28,4,4,5,70,True,2,2,2,741,57,26.8825,Feature
JavaScript,8844,63474,4056.673125,MERGED,1,0,1,0,1,59,True,0,0,0,957,1,12.186111111111112,Document
Rust,264,5382,382.74065972222223,MERGED,2,3,1,0,1,300,False,0,0,0,945,5,0.6333333333333333,Feature
JavaScript,5139,7048,1181.8953935185184,MERGED,20,217,6,5,6,239,False,1,4,2,1476,237,191.74444444444444,Bug
TypeScript,261,3765,656.9547453703703,MERGED,19,9,1,0,1,47,False,0,0,0,1864,28,0.24944444444444444,Document
Vue,293,495,810.4011458333333,MERGED,45,51,4,12,8,247,True,5,7,5,1478,96,327.3230555555556,Bug
TypeScript,261,3765,656.7179282407408,MERGED,2,8,2,0,1,89,False,0,0,0,1947,10,0.22444444444444445,Document
C#,80,125,798.7888425925926,CLOSED,100,21,5,3,26,33,False,3,0,0,936,121,1000.4933333333333,Document
Go,421,1654,1489.2266550925926,MERGED,31,104,2,0,2,229,False,0,0,0,1216,135,22.860277777777778,Bug
TypeScript,261,3765,656.4754861111111,MERGED,38,38,1,0,1,25,True,0,0,0,1844,76,0.03388888888888889,Document
Rust,264,5382,382.1766550925926,MERGED,1,1,1,0,1,298,False,0,0,0,747,2,0.15944444444444444,Feature
Go,421,1654,1489.219039351852,MERGED,24,0,1,0,1,403,True,0,0,0,1531,24,16.605555555555554,Bug
TypeScript,261,3765,655.9114467592593,MERGED,17,13,2,0,2,833,True,0,0,0,1895,30,13.641388888888889,Document
PHP,1334,2960,4186.921782407408,MERGED,2,9,1,0,3,149,False,0,0,0,1118,11,27.85361111111111,Document
Go,421,1654,1488.1372453703705,CLOSED,5,5,5,0,1,66,False,0,0,0,1210,10,0.10972222222222222,Document
Erlang,2054,12122,3775.9533449074074,MERGED,87,3,3,0,2,973,True,0,0,0,326,90,290.4552777777778,Feature
TypeScript,261,3765,655.9803356481482,MERGED,9,12,4,0,3,246,True,0,0,0,1870,21,0.3486111111111111,Document
Java,450,746,4050.3157291666666,MERGED,0,4,1,0,1,369,True,0,0,0,693,4,0.018055555555555554,Bug
PHP,1334,2960,4186.152060185185,MERGED,1,1,1,0,1,62,False,0,0,0,1419,2,44.93611111111111,Document
TypeScript,178,1359,300.8524537037037,MERGED,1,89,4,1,1,1,True,0,1,1,2253,90,0.28055555555555556,Feature
Rust,264,5382,381.8972453703704,MERGED,7,8,3,0,1,297,False,0,0,0,934,15,0.03194444444444444,Feature
TypeScript,178,1359,300.6665162037037,MERGED,42,22,2,1,1,1,False,0,1,1,2455,64,4.213333333333333,Feature
Rust,264,5382,383.0011574074074,CLOSED,349,29,10,0,2,194,True,0,0,0,2130,378,2.4627777777777777,Document
TypeScript,2147,14722,1451.1994444444445,MERGED,10,13,4,0,2,60,False,0,0,0,1896,23,38.47527777777778,Bug
Go,421,1654,1487.178113425926,MERGED,10,21,1,0,2,65,False,0,0,0,1571,31,46.603611111111114,Document
TypeScript,2147,14722,1452.0178703703705,MERGED,11,48,6,0,3,69,False,0,0,0,2198,59,0.2225,Feature
Rust,264,5382,381.0157638888889,MERGED,9,10,6,1,10,4,False,1,0,0,1049,19,1.9675,Bug
Go,421,1654,1489.9457523148149,MERGED,5,31,4,0,5,72,False,0,0,0,2276,36,94.44583333333334,Document
Rust,417,2801,904.2391550925926,MERGED,3,3,1,0,1,10,False,0,0,0,211,6,1.9825,Document
TypeScript,261,3765,654.5292361111111,MERGED,153,510,21,0,2,161,False,0,0,0,1885,663,0.49916666666666665,Document
C++,2234,23694,2334.940300925926,MERGED,9,6,2,1,1,515,False,0,1,1,928,15,19.19361111111111,Bug
Python,547,7159,2218.6432754629627,CLOSED,153,192,17,0,7,98,False,0,0,0,548,345,380.2936111111111,Bug
TypeScript,7,6,624.0175347222222,MERGED,1844,521,42,2,48,256,False,1,1,1,3237,2365,719.4152777777778,Feature
JavaScript,5139,7048,1183.8960300925926,MERGED,4,4,2,1,10,89,False,0,1,1,1750,8,1.4130555555555555,Feature
TypeScript,85,721,294.0084027777778,MERGED,13,18,3,0,1,71,False,0,0,0,2057,31,0.03888888888888889,Document
Vue,293,495,811.8240856481481,MERGED,9,91,4,16,12,148,True,4,12,6,1737,100,409.5252777777778,Bug
TypeScript,15,34,467.2751041666667,MERGED,3,3,1,0,2,456,True,0,0,0,894,6,0.6547222222222222,Bug
JavaScript,5139,7048,1183.8402083333333,MERGED,0,49,3,1,8,88,False,0,1,1,1333,49,0.8819444444444444,Feature
JavaScript,5139,7048,1183.8049305555555,CLOSED,15,2,2,1,2,86,False,0,1,1,1086,17,0.011944444444444445,Feature
TypeScript,261,3765,653.8736226851852,MERGED,1,3,3,0,2,820,True,0,0,0,1722,4,0.46944444444444444,Document
Python,547,7159,2216.75931712963,MERGED,10,12,4,0,9,246,True,0,0,0,789,22,19.343055555555555,Bug
TypeScript,261,3765,653.7408680555556,MERGED,3,10,2,0,1,817,True,0,0,0,2075,13,0.6111111111111112,Document
Python,19248,70257,2440.4564583333336,CLOSED,0,1,1,1,1,1549,False,1,0,0,175,1,5.605,Bug
TypeScript,261,3765,653.7021296296297,MERGED,2,137,3,0,2,816,True,0,0,0,2109,139,0.4411111111111111,Document
JavaScript,5139,7048,1184.7629976851852,MERGED,357,1054,13,2,5,0,False,0,2,2,125,1411,91.92944444444444,Feature
TypeScript,7,6,625.0809606481481,MERGED,105,112,6,1,5,203,False,0,1,1,2274,217,336.28472222222223,Document
TypeScript,3989,23860,2807.095150462963,CLOSED,25,409,9,3,7,10,False,2,1,1,1322,434,243.7761111111111,Document
Vue,293,495,808.1260648148149,MERGED,373,166,2,4,1,287,True,0,4,3,725,539,16.64527777777778,Feature
TypeScript,41369,87411,2916.2293981481484,MERGED,4,9,2,3,3,0,False,1,2,1,2078,13,587.5819444444444,Document
TypeScript,15,34,470.52766203703703,MERGED,3,6,1,0,1,150,False,0,0,0,1045,9,3.305277777777778,Feature
TypeScript,3392,2334,948.2668518518518,MERGED,53,53,1,2,1,243,False,0,2,1,226,106,16.38888888888889,Feature
Go,421,1654,1490.218298611111,MERGED,28,30,1,0,1,404,True,0,0,0,2289,58,16.279444444444444,Bug
Rust,264,5382,384.98596064814814,MERGED,13,1,2,4,1,0,False,2,2,1,1838,14,44.23416666666667,Bug
Rust,417,2801,902.0942592592593,MERGED,139,649,3,0,1,250,False,0,0,0,265,788,0.18833333333333332,Document
Go,421,1654,1489.9429861111112,MERGED,0,4,2,2,1,0,False,1,1,1,2027,4,5.960833333333333,Bug
TypeScript,199,371,754.9962962962964,MERGED,10,0,4,2,1,33,False,0,2,2,2209,10,17.377222222222223,Feature
PHP,1334,2960,4187.926006944444,MERGED,1,2,1,0,1,65,False,0,0,0,1799,3,5.110833333333333,Document
JavaScript,5139,7048,1181.7665972222223,MERGED,3,4,3,2,1,84,False,1,1,1,1474,7,0.1988888888888889,Feature
PHP,1334,2960,4187.199444444444,MERGED,19,51,1,0,5,61,False,0,0,0,2605,70,18.06833333333333,Feature
Python,19248,70257,2440.716909722222,CLOSED,1,1,1,1,1,1551,False,1,0,0,202,2,15.7475,Bug
Rust,264,5382,384.9466550925926,MERGED,106,100,5,0,1,173,False,0,0,0,1552,206,17.765555555555554,Bug
Rust,264,5382,383.00500000000005,CLOSED,0,39,3,0,1,375,False,0,0,0,1326,39,93.62277777777778,Feature
TypeScript,261,3765,655.4934837962963,MERGED,7368,134,106,0,4,207,True,0,0,0,1765,7502,0.7358333333333333,Document
PHP,1334,2960,4186.189942129629,MERGED,7,13,2,1,4,63,False,1,0,0,2055,20,47.55916666666667,Document
Rust,264,5382,385.0138773148148,CLOSED,4605,47,5,0,1,65,True,0,0,0,1566,4652,0.7980555555555555,Feature
PHP,1334,2960,4187.247152777778,MERGED,14,17,2,0,2,80,False,0,0,0,1938,31,1.4975,Document
Rust,433,2229,216.82297453703703,MERGED,2,1,1,1,1,675,False,0,1,1,230,3,1.9469444444444444,Bug
PHP,883,2337,1811.0652893518518,CLOSED,23,406,12,5,1,18,False,3,2,2,3160,429,1029.8505555555555,Document
TypeScript,261,3765,657.7829050925926,MERGED,6,28,4,0,4,91,False,0,0,0,2844,34,1.3366666666666667,Document
TypeScript,7,6,624.9912615740741,MERGED,4,4,4,0,1,277,False,0,0,0,1259,8,0.05472222222222222,Document
Rust,417,2801,902.9971875,MERGED,75,160,8,1,3,253,False,0,1,1,382,235,24.49277777777778,Bug
Blade,0,0,95.00945601851852,MERGED,4,75,2,0,2,12,False,0,0,0,900,79,0.056666666666666664,Feature
Rust,264,5382,383.9597685185185,MERGED,117,259,4,1,1,197,True,1,0,0,1700,376,0.8180555555555555,Feature
Kotlin,164,4296,384.8280671296296,MERGED,0,59,7,3,2,1,False,1,2,1,443,59,142.31416666666667,Bug
PHP,1334,2960,4184.867523148148,MERGED,7,12,2,0,3,57,False,0,0,0,2217,19,8.498611111111112,Document
C++,2234,23694,2337.5960300925926,MERGED,47,51,10,1,3,175,False,0,1,1,1778,98,32.51444444444444,Feature
TypeScript,3392,2334,945.3603356481482,MERGED,553,2,2,2,2,0,False,0,2,1,226,555,18.5825,Feature
Go,395,660,1245.9215162037037,MERGED,3,10,1,0,1,60,False,0,0,0,252,13,95.64916666666667,Feature
TypeScript,178,1359,301.2334375,MERGED,5,29,7,2,2,17,True,1,1,1,2865,34,0.5141666666666667,Bug
TypeScript,15,34,467.3566550925926,MERGED,1,2,1,0,1,458,True,0,0,0,951,3,0.23805555555555555,Feature
TypeScript,2147,14722,1452.201550925926,MERGED,19,35,12,0,2,661,False,0,0,0,2771,54,42.970555555555556,Bug
TypeScript,261,3765,656.6809259259259,MERGED,41,9,5,0,4,836,True,0,0,0,2356,50,6.009166666666666,Document
Starlark,440,286,470.6403356481481,CLOSED,17,72,2,0,3,40,False,0,0,0,327,89,0.3977777777777778,Feature
TypeScript,261,3765,656.6619560185185,MERGED,5,126,2,0,2,835,True,0,0,0,2650,131,5.727777777777778,Document
Python,547,7160,2217.4433680555553,MERGED,16,461,8,0,35,8,False,0,0,0,893,477,502.2391666666667,Bug
PHP,1334,2960,4189.01880787037,MERGED,14,46,3,1,4,69,False,1,0,0,2254,60,118.97222222222223,Document
PHP,1334,2960,4188.880474537037,MERGED,0,16,2,0,2,67,False,0,0,0,3093,16,123.27972222222222,Document
Go,395,660,1246.8534606481483,MERGED,2,7,1,0,1,334,False,0,0,0,210,9,0.22305555555555556,Feature
Rust,417,2801,902.441261574074,MERGED,7,2,3,0,3,251,False,0,0,0,317,9,12.729444444444445,Bug
TypeScript,2071,16638,1222.0319560185185,MERGED,7,7,1,0,1,6,False,0,0,0,1278,14,11.254166666666666,Bug
Rust,264,5382,383.0314351851852,MERGED,2,19,2,0,2,302,False,0,0,0,1324,21,1.0252777777777777,Document
JavaScript,8844,63474,4057.2093171296297,MERGED,22,47,3,5,3,93,True,3,2,2,1111,69,1.7161111111111111,Bug
Vue,293,495,808.6091550925926,MERGED,5,13,2,8,3,246,True,2,6,5,1409,18,127.70027777777777,Bug
Java,450,746,4051.096898148148,MERGED,11,30,2,1,2,68,True,0,1,1,1507,41,190.53666666666666,Bug
Rust,433,2229,214.8340509259259,MERGED,0,3,1,1,1,671,False,0,1,1,226,3,0.4988888888888889,Bug
TypeScript,85,721,295.17976851851853,MERGED,27,146,5,0,3,91,False,0,0,0,3293,173,12.736944444444445,Document
Rust,264,5382,382.9356597222222,CLOSED,2,4,6,1,6,301,False,1,0,0,2810,6,93.64916666666667,Bug
C++,2234,23694,2336.974513888889,MERGED,137,197,1,1,7,193,False,0,1,1,308,334,17.689444444444444,Document
TypeScript,61,71,1654.2524074074074,MERGED,6,30,4,0,2,162,True,0,0,0,1801,36,0.9952777777777778,Feature
TypeScript,261,3765,655.6267361111111,MERGED,7,39,8,1,3,556,True,1,0,0,2748,46,3.243888888888889,Document
Vue,293,495,811.0193402777778,MERGED,8,10,1,5,1,342,False,0,5,3,1662,18,4.895,Bug
JavaScript,5139,7048,1182.548136574074,MERGED,4,8,2,3,2,74,False,1,2,2,2121,12,25.98027777777778,Feature
TypeScript,2071,16638,1222.6400810185185,MERGED,40,386,7,8,3,21,True,5,3,2,6581,426,467.7708333333333,Bug
Go,395,660,1243.862974537037,MERGED,1,8,1,0,2,57,False,0,0,0,203,9,7.014444444444444,Feature
Go,395,660,1245.8080555555555,MERGED,5,8,1,0,1,191,False,0,0,0,216,13,0.9344444444444444,Feature
Vue,293,495,810.847986111111,MERGED,18,3,2,8,4,20,True,0,8,4,1547,21,8.768333333333333,Bug
Rust,417,2801,901.2516666666667,MERGED,21,99,6,0,5,21,False,0,0,0,516,120,138.13222222222223,Document
Rust,591,3260,525.0853472222223,MERGED,1,1,1,0,1,176,True,0,0,0,1262,2,0.47333333333333333,Document
Rust,264,5382,382.16848379629624,MERGED,4,4,4,0,1,60,True,0,0,0,1396,8,0.32416666666666666,Document
Rust,264,5382,381.89164351851855,MERGED,0,2,2,0,1,59,True,0,0,0,1211,2,0.5825,Feature
TypeScript,261,3765,654.6440162037037,MERGED,3,110,20,0,3,135,True,0,0,0,2842,113,21.791944444444443,Document
Python,547,7160,2218.961863425926,MERGED,0,1,1,0,1,99,False,0,0,0,343,1,0.7047222222222222,Feature
Vue,293,495,809.1347569444443,MERGED,0,3,1,6,2,19,True,1,5,4,1464,3,40.719166666666666,Bug
Vue,293,495,809.129849537037,MERGED,6,49,2,12,10,18,True,2,10,4,1548,55,40.81638888888889,Bug
Vue,293,495,809.066550925926,MERGED,1,1,1,4,2,339,False,0,4,3,1625,2,42.37583333333333,Bug
Vue,293,495,808.8973611111111,MERGED,868,1257,71,5,116,328,True,0,5,3,1201,2125,46.78472222222222,Document
Go,184,661,1999.329861111111,CLOSED,2,4,2,2,2,17,True,2,0,0,336,6,5.504722222222222,Feature
Go,395,660,1245.0212152777779,MERGED,1,2,1,0,2,190,False,0,0,0,250,3,0.4122222222222222,Feature
C++,2234,23694,2334.8613310185187,MERGED,7,31,9,1,10,255,False,0,1,1,1707,38,43.66,Feature
C++,2234,23694,2335.8588425925927,MERGED,53,59,1,1,5,12,False,0,1,1,1566,112,2.6144444444444446,Bug
JavaScript,8844,63474,4055.088414351852,MERGED,0,13,4,0,1,68,True,0,0,0,1723,13,2.9763888888888888,Bug
TypeScript,15,34,470.7639467592592,MERGED,3,36,5,0,18,874,False,0,0,0,1667,39,69.54611111111112,Bug
TypeScript,85,721,293.02012731481483,CLOSED,161,7311,11,0,5,89,False,0,0,0,2718,7472,23.959722222222222,Document
Python,547,7160,2217.6510300925925,MERGED,15,16,3,0,12,94,False,0,0,0,498,31,166.9675,Document
Go,395,660,1243.9841435185185,MERGED,5,5,1,0,5,58,False,0,0,0,232,10,28.177777777777777,Bug
Python,547,7160,2218.678888888889,MERGED,2,6,1,0,1,249,True,0,0,0,453,8,0.02388888888888889,Bug
TypeScript,42,46,750.7778935185185,MERGED,6,29,2,1,1,61,False,0,1,1,1158,35,23.649444444444445,Feature
Java,547,304,208.14576388888887,MERGED,14,29,2,0,8,0,False,0,0,0,1583,43,157.96555555555557,Feature
TypeScript,261,3765,654.029675925926,MERGED,0,46,3,0,2,244,True,0,0,0,2516,46,11.748055555555556,Document
Rust,433,2229,216.83315972222223,MERGED,2,3,2,1,1,676,False,0,1,1,263,5,1.6494444444444445,Document
Vue,293,495,808.6927546296297,MERGED,0,86,1,4,2,0,True,0,4,3,1185,86,26.91583333333333,Bug
Go,395,660,1244.038773148148,MERGED,11,6,2,0,1,62,False,0,0,0,302,17,0.25027777777777777,Feature
TypeScript,3989,23860,2807.0561458333336,MERGED,11,24,2,1,2,62,True,0,1,1,775,35,5.13,Document
Vue,293,495,809.0846527777777,CLOSED,7,3,2,3,1,340,False,0,3,2,1548,10,0.15833333333333333,Bug
V,2097,34361,1530.451215277778,MERGED,1,19,3,4,1,159,True,0,4,2,1335,20,74.93194444444444,Bug
TypeScript,307,2556,519.4616782407408,MERGED,31,0,2,24,1,0,False,2,22,2,918,31,4.881666666666667,Feature
TypeScript,261,3765,653.8266087962962,MERGED,161,162,5,0,1,818,True,0,0,0,2821,323,3.2827777777777776,Document
TypeScript,261,3765,653.8451388888889,MERGED,7,21,6,0,2,819,True,0,0,0,2761,28,0.26472222222222225,Document
Rust,417,2801,902.9878240740741,MERGED,1,24,1,0,1,252,False,0,0,0,406,25,0.815,Feature
Kotlin,164,4296,384.8263541666667,CLOSED,2,57,8,0,1,0,False,0,0,0,487,59,0.018055555555555554,Bug
TypeScript,15,34,467.548900462963,MERGED,46,313,13,0,8,298,False,0,0,0,1923,359,382.9247222222222,Document
Vue,293,495,808.6314583333333,MERGED,50,41,7,11,6,46,False,2,9,5,1399,91,5.423055555555556,Bug
Python,2407,12180,218.7251736111111,MERGED,50,174,15,0,12,210,True,0,0,0,282,224,4.1875,Bug
Rust,433,2229,215.47418981481482,MERGED,2,3,2,3,1,672,False,1,2,1,323,5,20.922777777777778,Feature
TypeScript,261,3765,654.662013888889,MERGED,1,11,2,0,1,5,False,0,0,0,1107,12,19.22222222222222,Document
JavaScript,8844,63474,4056.197789351852,MERGED,1,1,1,8,1,0,False,2,6,3,492,2,11.293055555555556,Bug
TypeScript,307,2556,518.7501620370371,MERGED,0,21,1,0,1,186,True,0,0,0,1059,21,2.681111111111111,Bug
JavaScript,9664,43889,3637.1825000000003,MERGED,14,116,10,0,1,71,False,0,0,0,365,130,0.22583333333333333,Feature
TypeScript,2147,14722,1451.180162037037,MERGED,276,1171,19,0,1,28,False,0,0,0,10907,1447,20.190555555555555,Feature
Rust,264,5382,381.119375,MERGED,82,108,7,0,7,293,False,0,0,0,1883,190,162.42305555555555,Bug
Python,547,7160,2217.0246643518517,MERGED,0,2,1,0,3,4,False,0,0,0,482,2,11.388055555555555,Feature
Go,395,660,1246.0210185185185,MERGED,5,14,2,0,3,61,False,0,0,0,290,19,23.649722222222223,Feature
Vue,293,495,811.8249884259259,MERGED,4,8,2,4,1,22,True,1,3,3,1625,12,50.5625,Bug
Rust,417,2801,901.9413425925926,MERGED,6,6,4,0,1,249,False,0,0,0,398,12,0.19777777777777777,Document
TypeScript,139,827,727.8583912037037,MERGED,53,52,1,2,1,117,False,0,2,2,375,105,4.358333333333333,Document
Go,395,660,1243.1169328703704,MERGED,625,864,19,0,956,20,False,0,0,0,480,1489,246.35,Feature
TypeScript,202,107,1122.840300925926,MERGED,1,1,1,4,7,1,False,0,4,4,1250,2,24.81833333333333,Document
Rust,264,5382,384.8198611111111,MERGED,29,31,2,0,2,199,True,0,0,0,1744,60,0.29694444444444446,Bug
PHP,1334,2960,4187.178645833334,MERGED,17,11,2,0,1,64,False,0,0,0,3069,28,24.175,Document
Python,19248,70257,2441.612858796296,CLOSED,4,175,3,3,3,79,False,2,1,1,2308,179,30.459722222222222,Bug
Vue,293,495,810.696400462963,MERGED,5,80,7,6,6,1,False,1,5,4,1877,85,101.96972222222222,Bug
TypeScript,15,34,469.34180555555554,MERGED,7,7,4,0,3,460,True,0,0,0,1449,14,26.490555555555556,Document
JavaScript,9664,43889,3638.941388888889,MERGED,4,23,4,0,9,49,True,0,0,0,418,27,1.7963888888888888,Feature
TypeScript,307,2556,517.6360069444444,MERGED,1,1,1,0,2,549,True,0,0,0,911,2,0.24166666666666667,Bug
TypeScript,7,6,625.0982523148149,MERGED,23,80,6,1,9,278,False,0,1,1,2364,103,1.7869444444444444,Feature
Rust,264,5382,383.78962962962964,MERGED,1,19,7,0,2,0,True,0,0,0,1965,20,1.1205555555555555,Bug
PHP,1334,2960,4185.967384259259,MERGED,16,21,2,1,5,60,False,1,0,0,2980,37,27.750555555555554,Document
JavaScript,5139,7048,1184.644224537037,MERGED,17,122,6,3,5,76,False,1,2,2,3666,139,25.586944444444445,Bug
PHP,1334,2960,4186.001655092593,MERGED,22,49,5,0,9,61,False,0,0,0,2246,71,24.27888888888889,Document
Java,450,746,4050.1185532407403,MERGED,6,43,3,1,3,67,True,0,1,1,1784,49,21.550833333333333,Bug
Python,547,7160,2218.1828935185185,MERGED,3,3,1,0,1,0,False,0,0,0,531,6,4.1177777777777775,Document
PHP,1334,2960,4185.905856481481,MERGED,10,17,1,0,1,59,False,0,0,0,2474,27,23.508333333333333,Document
PHP,1334,2960,4185.164884259259,MERGED,11,17,2,1,1,58,False,1,0,0,2826,28,0.8927777777777778,Document
Python,547,7160,2217.6136921296297,MERGED,4,33,2,0,2,24,False,0,0,0,593,37,0.23527777777777778,Bug
TypeScript,17,33,699.8238773148149,MERGED,3,2,1,1,1,26,False,0,1,1,313,5,0.18416666666666667,Bug
JavaScript,9664,43889,3635.114340277778,MERGED,1,75,6,0,2,28,False,0,0,0,302,76,0.5336111111111111,Feature
Go,395,660,1244.0676851851852,MERGED,19,23,1,0,1,59,False,0,0,0,246,42,23.570833333333333,Feature
Rust,264,5382,383.0100347222222,MERGED,347,24,8,0,1,195,True,0,0,0,2085,371,0.6097222222222223,Document
Java,450,746,4050.002025462963,MERGED,15,45,4,1,2,66,True,0,1,1,1726,60,1.8597222222222223,Bug
TypeScript,42,46,750.9286574074075,MERGED,2,3,1,2,3,76,False,1,1,1,397,5,1.1727777777777777,Bug
TypeScript,41369,87411,2917.7829861111113,MERGED,30,79,4,10,4,42,False,4,6,3,6024,109,1656.9686111111112,Document
TypeScript,307,2556,515.6980555555556,MERGED,2,7,1,0,1,547,True,0,0,0,907,9,17.831944444444446,Bug
TypeScript,1297,21107,397.7861574074074,MERGED,10,5,3,1,2,853,True,0,1,1,1864,15,0.6341666666666667,Document
C#,80,125,800.7421527777778,MERGED,7,21,1,0,1,193,False,0,0,0,516,28,1.9325,Document
TypeScript,1297,21107,397.76418981481487,MERGED,2,8,1,1,1,35,False,0,1,1,1892,10,0.485,Document
TypeScript,216,520,1676.9889583333334,MERGED,1,9,2,0,1,157,False,0,0,0,360,10,44.109722222222224,Feature
Python,547,7160,2217.725,MERGED,4,15,5,0,2,219,False,0,0,0,484,19,0.02722222222222222,Bug
TypeScript,202,107,1122.0131712962964,CLOSED,0,0,0,6,4,114,True,0,6,5,3155,0,517.8747222222222,Document
TypeScript,4,33,741.8054976851853,CLOSED,0,1199,4,1,20,68,False,0,1,1,1484,1199,890.9091666666667,Document
Go,395,660,1243.9317939814816,MERGED,4,2,3,0,3,61,False,0,0,0,292,6,2.4494444444444445,Feature
TypeScript,15,34,467.3206597222222,MERGED,9,11,4,0,2,457,True,0,0,0,1542,20,23.76861111111111,Feature
Python,547,7160,2216.9915625,CLOSED,0,2,1,0,1,218,False,0,0,0,539,2,12.338055555555556,Bug
TypeScript,184,1377,269.6456597222222,MERGED,15,83,3,1,4,1,False,0,1,1,340,98,3.4522222222222223,Bug
TypeScript,2147,14722,1453.9916203703704,MERGED,12,26,5,0,1,62,False,0,0,0,3600,38,66.71138888888889,Bug
Rust,264,5382,382.1046527777778,MERGED,4,20,2,0,1,125,False,0,0,0,1903,24,0.10416666666666667,Bug
V,2097,34361,1531.4407986111112,MERGED,18,137,3,1,3,160,True,0,1,1,590,155,51.19916666666666,Bug
C#,80,125,800.893900462963,MERGED,14,10,5,0,4,190,True,0,0,0,616,24,137.74083333333334,Document
TypeScript,178,1359,301.8187384259259,MERGED,157,186,3,3,4,18,True,1,2,2,4179,343,79.64361111111111,Feature
JavaScript,8844,63474,4055.8629513888886,CLOSED,0,29,4,2,1,6,False,1,1,1,2313,29,6.288333333333333,Feature
Python,547,7160,2216.3015856481484,MERGED,16,13,4,0,4,218,False,0,0,0,512,29,27.153333333333332,Document
Rust,264,5382,381.76125,MERGED,2,6,5,0,1,58,True,0,0,0,1890,8,2.121111111111111,Feature
Python,547,7160,2215.5324768518517,CLOSED,68,1722,38,0,17,216,False,0,0,0,555,1790,52.74055555555555,Bug
JavaScript,3618,9017,2266.2532175925926,MERGED,2,2,1,2,2,334,False,1,1,1,1845,4,0.5752777777777778,Bug
Rust,264,5382,381.1688657407407,MERGED,0,1114,9,0,8,246,True,0,0,0,1936,1114,18.164444444444445,Feature
TypeScript,3989,23860,2809.059409722222,MERGED,32,44,4,2,6,63,True,1,1,1,781,76,53.57138888888889,Bug
Rust,264,5382,381.21510416666666,MERGED,2,3,1,0,5,296,False,0,0,0,2074,5,13.865277777777777,Feature
JavaScript,9664,43889,3636.1134027777775,MERGED,1,2,1,0,1,189,True,0,0,0,427,3,0.7683333333333333,Feature
JavaScript,5139,7048,1182.930150462963,MERGED,23,23,22,2,3,47,False,1,1,1,3347,46,0.28805555555555556,Bug
JavaScript,5139,7048,1181.534525462963,MERGED,118,506,22,4,11,86,False,2,2,2,3140,624,50.19305555555555,Feature
Rust,417,2801,902.3034027777777,MERGED,1,7,1,0,2,7,False,0,0,0,545,8,0.37194444444444447,Bug
TypeScript,4,33,741.8157523148147,MERGED,0,41,1,2,8,69,False,0,2,2,1383,41,815.4527777777778,Document
TypeScript,17,33,699.8076273148148,MERGED,85,173,22,1,8,25,False,0,1,1,473,258,26.815277777777776,Feature
TypeScript,1297,21107,395.71982638888886,MERGED,3,7,1,1,1,849,True,0,1,1,2084,10,1.2458333333333333,Document
JavaScript,9664,43889,3634.9991898148146,MERGED,11,54,6,0,1,67,False,0,0,0,446,65,2.5169444444444444,Feature
TypeScript,307,2556,519.6669675925926,MERGED,8,7,2,7,1,295,True,0,7,3,1850,15,1.4777777777777779,Bug
JavaScript,9664,43889,3638.9772800925925,MERGED,5,18,6,0,2,614,False,0,0,0,467,23,0.4263888888888889,Feature
TypeScript,307,2556,518.986238425926,CLOSED,6,5,2,0,2,14,False,0,0,0,1670,11,16.2275,Bug
TypeScript,307,2556,518.7473263888888,MERGED,1,11,3,2,3,185,True,1,1,1,1614,12,24.195833333333333,Bug
Python,547,7160,2218.804733796296,MERGED,2,2,1,1,1,250,True,0,1,1,747,4,0.11361111111111111,Bug
TypeScript,261,3765,657.5409606481481,MERGED,70,82,3,0,2,166,False,0,0,0,1199,152,0.6402777777777777,Document
JavaScript,9664,43889,3637.966087962963,CLOSED,0,1,1,0,1,33,False,0,0,0,620,1,27.468888888888888,Feature
JavaScript,9664,43889,3638.1964351851852,MERGED,190,196,2,0,4,48,True,0,0,0,550,386,16.89,Feature
TypeScript,1297,21107,394.81469907407404,MERGED,10,11,5,1,3,844,True,0,1,1,2200,21,0.03,Document
Python,547,7160,2218.353622685185,CLOSED,20,26,1,0,6,221,False,0,0,0,624,46,7.698055555555555,Bug
TypeScript,261,3765,657.5609953703704,MERGED,165,392,37,0,3,145,False,0,0,0,3306,557,1.7969444444444445,Document
C#,80,125,797.7457407407406,MERGED,6,6,1,0,1,154,True,0,0,0,441,12,0.1411111111111111,Document
TypeScript,307,2556,518.583125,MERGED,3,30,3,0,1,184,True,0,0,0,1642,33,6.573611111111111,Bug
TypeScript,42,46,749.7589467592593,MERGED,15,140,6,2,1,60,False,1,1,1,1799,155,18.94361111111111,Feature
TypeScript,178,1359,299.6920601851852,MERGED,798,1025,12,3,11,15,True,1,2,2,4647,1823,11.635833333333334,Bug
TypeScript,15,34,470.6225231481481,MERGED,152,173,7,0,2,873,False,0,0,0,1794,325,1.0208333333333333,Bug
JavaScript,5139,7048,1181.6342476851853,MERGED,276,305,15,3,119,101,False,2,1,1,3342,581,358.0911111111111,Document
TypeScript,7,6,624.1348726851852,CLOSED,24,96,3,1,6,210,False,0,1,1,2931,120,45.005833333333335,Bug
Python,547,7160,2216.788449074074,MERGED,5,35,3,0,10,92,False,0,0,0,880,40,30.122222222222224,Bug
TypeScript,178,1359,300.3936342592593,MERGED,13,76,3,2,4,8,True,0,2,2,4831,89,9.400555555555556,Feature
TypeScript,2147,14722,1452.233240740741,MERGED,46,77,37,0,3,29,False,0,0,0,4165,123,19.816666666666666,Feature
TypeScript,307,2556,517.5109027777778,MERGED,2,2,2,2,2,11,False,1,1,1,1447,4,25.704166666666666,Bug
Python,547,7160,2217.8000694444445,MERGED,0,13,1,1,3,96,False,0,1,1,832,13,0.38333333333333336,Bug
TypeScript,85,721,292.9016203703704,CLOSED,217,51,9,0,11,88,False,0,0,0,4643,268,103.43472222222222,Document
JavaScript,9664,43889,3636.8875231481484,MERGED,17,28,1,0,1,240,True,0,0,0,748,45,292.6455555555556,Bug
Python,547,7160,2217.6823726851853,MERGED,100,81,5,0,2,248,True,0,0,0,653,181,0.25222222222222224,Bug
Go,395,660,1242.9994212962963,MERGED,9,19,12,0,3,36,False,0,0,0,394,28,1.1116666666666666,Bug
JavaScript,5139,7048,1183.8629398148148,MERGED,295,470,30,15,17,49,False,7,8,3,5399,765,837.4841666666666,Bug
TypeScript,261,3765,655.7366319444444,MERGED,36,103,8,0,3,24,True,0,0,0,3207,139,3.0925,Document
TypeScript,261,3765,655.4780671296296,MERGED,2,96,8,0,3,827,True,0,0,0,1830,98,4.684166666666667,Document
C#,80,125,800.4644560185185,MERGED,3,39,2,0,2,153,True,0,0,0,598,42,5.545,Document
PHP,1334,2960,4188.172060185186,MERGED,24,36,4,0,7,66,False,0,0,0,4252,60,96.23944444444444,Document
Java,547,304,208.68143518518517,MERGED,0,62,2,2,26,7,False,2,0,0,2086,62,114.63416666666667,Feature
TypeScript,41369,87411,2916.7990162037036,MERGED,1,1,1,1,1,386,True,1,0,0,1883,2,0.009722222222222222,Document
TypeScript,41369,87411,2916.5938657407405,MERGED,59,63,2,0,1,1554,True,0,0,0,2077,122,0.5152777777777777,Document
Java,547,304,208.32841435185185,MERGED,0,8,1,0,1,1,False,0,0,0,1938,8,6.465277777777778,Document
TypeScript,261,3765,655.7490509259259,MERGED,39,14,10,0,6,831,True,0,0,0,3603,53,0.9258333333333333,Document
TypeScript,261,3765,655.6964583333333,MERGED,36,18,9,0,1,829,True,0,0,0,3566,54,0.4186111111111111,Document
Python,72,25,1617.7102083333332,MERGED,5,618,6,1,4,22,False,1,0,0,2811,623,65.00666666666666,Bug
TypeScript,307,2556,516.7022685185185,MERGED,2,11,2,0,1,166,True,0,0,0,1562,13,1.2397222222222222,Bug
Python,19248,70257,2439.6876851851853,CLOSED,11,17,2,4,3,84,False,4,0,0,746,28,21.538333333333334,Document
TypeScript,41369,87411,2915.945416666667,MERGED,22,22,5,3,3,1553,True,1,2,2,2083,44,13.056111111111111,Document
PHP,1093,3326,2833.2634490740743,MERGED,0,4,1,0,1,835,False,0,0,0,566,4,16.844722222222224,Bug
JavaScript,9664,43889,3636.0717476851855,CLOSED,19,89,3,0,3,45,True,0,0,0,600,108,1.1011111111111112,Feature
TypeScript,307,2556,516.4687962962963,MERGED,1,1,1,0,1,51,True,0,0,0,1062,2,4.438611111111111,Bug
TypeScript,261,3765,654.8002314814815,MERGED,8,160,13,2,3,88,False,2,0,0,3316,168,22.137777777777778,Document
Python,547,7160,2215.3527546296295,CLOSED,0,1931,10,1,62,3,False,0,1,1,564,1931,34.58833333333333,Feature
TypeScript,2147,14722,1450.9499421296296,MERGED,61,145,8,0,1,92,False,0,0,0,4505,206,0.9102777777777777,Bug
JavaScript,9664,43889,3635.8338657407407,MERGED,0,152,2,0,1,68,False,0,0,0,620,152,0.5302777777777777,Feature
TypeScript,307,2556,515.7357060185185,MERGED,4,12,1,0,2,164,True,0,0,0,1374,16,21.210833333333333,Feature
Python,14532,41181,1064.4634259259258,MERGED,2,2,1,1,1,0,False,0,1,1,802,4,19.484444444444446,Bug
TypeScript,261,3765,654.7921875000001,MERGED,16,62,4,0,1,826,True,0,0,0,4178,78,4.9447222222222225,Document
TypeScript,15,34,467.64170138888886,MERGED,12,14,7,0,2,299,False,0,0,0,2056,26,17.740555555555556,Feature
TypeScript,261,3765,654.6991898148148,MERGED,2572,11,102,0,1,825,True,0,0,0,4532,2583,0.31194444444444447,Document
Go,421,1654,1490.9259375000001,MERGED,99,65,3,0,2,407,True,0,0,0,3809,164,5.6627777777777775,Bug
PHP,1334,2960,4189.071412037037,MERGED,255,6,4,1,2,38,False,0,1,1,3411,261,1.4697222222222222,Document
TypeScript,261,3765,654.4849189814814,MERGED,245,62,12,0,2,822,True,0,0,0,4207,307,0.42388888888888887,Document
TypeScript,2147,14722,1450.2212152777777,MERGED,119,0,25,0,1,129,False,0,0,0,4288,119,0.2619444444444444,Feature
JavaScript,9664,43889,3635.0021064814814,MERGED,6,242,5,0,1,27,False,0,0,0,461,248,1.5702777777777779,Document
Go,30,295,325.9669791666667,MERGED,96,149,8,7,12,85,True,0,7,1,2815,245,60.79277777777778,Bug
TypeScript,139,827,728.2247106481482,MERGED,1,1,1,2,1,11,False,0,2,2,998,2,0.6019444444444444,Document
TypeScript,2071,16638,1221.2505208333334,MERGED,0,2,1,0,5,2,False,0,0,0,2426,2,92.25111111111111,Bug
JavaScript,5139,7048,1183.6902430555556,MERGED,4,644,15,3,13,75,False,1,2,2,5223,648,142.29166666666666,Feature
Rust,264,5382,384.031724537037,MERGED,12,14,5,0,1,64,True,0,0,0,2981,26,0.35194444444444445,Feature
TypeScript,2071,16638,1222.504097222222,MERGED,1,1,1,0,1,0,False,0,0,0,2377,2,20.480555555555554,Bug
C#,80,125,801.4894791666667,MERGED,538,1812,24,0,19,154,True,0,0,0,741,2350,117.52027777777778,Document
Go,421,1654,1488.1741898148148,MERGED,3,2,23,0,1,227,False,0,0,0,4002,5,1.8083333333333333,Bug
PHP,1334,2960,4186.053310185185,MERGED,10,16,1,5,11,0,False,2,3,2,7048,26,651.1516666666666,Document
TypeScript,2071,16638,1220.9954745370371,MERGED,2,0,1,4,1,0,False,2,2,1,2732,2,5.768888888888889,Document
TypeScript,2071,16638,1222.0300578703702,MERGED,6,56,3,0,1,1,False,0,0,0,3182,62,11.275,Bug
TypeScript,307,2556,518.6023611111111,MERGED,7,7,2,1,2,13,False,1,0,0,1693,14,139.71,Bug
PHP,1334,2960,4187.060960648148,MERGED,9,23,2,0,3,79,False,0,0,0,3671,32,4.3308333333333335,Document
Rust,264,5382,382.6668634259259,MERGED,2,64,13,1,4,0,False,0,1,1,2802,66,3.368333333333333,Feature
TypeScript,41369,87411,2917.808564814815,MERGED,7,7,5,3,6,67,True,2,1,1,2911,14,139.86083333333335,Document
PHP,0,0,85.00486111111111,MERGED,16,369,8,0,5,22,False,0,0,0,2820,385,0.021388888888888888,Document
Python,547,7160,2215.5482175925927,CLOSED,0,11,1,1,3,12,False,0,1,1,824,11,166.35555555555555,Bug
TypeScript,7,6,626.0739583333333,CLOSED,1238,246,77,0,17,242,False,0,0,0,9516,1484,1604.0997222222222,Document
TypeScript,307,2556,519.6582291666667,MERGED,2,21,3,0,1,14,False,0,0,0,2248,23,72.0875,Feature
C#,80,125,800.8665509259259,MERGED,29,74,7,0,6,6,False,0,0,0,809,103,96.04694444444445,Document
C#,80,125,800.6078703703703,MERGED,556,643,27,0,8,189,True,0,0,0,940,1199,99.55805555555555,Document
TypeScript,2071,16638,1221.1915277777778,MERGED,0,2,1,0,2,1,False,0,0,0,2415,2,1.0369444444444444,Bug
TypeScript,2071,16638,1220.3219097222222,MERGED,1,1,1,0,2,0,False,0,0,0,3098,2,22.002777777777776,Document
PHP,883,2337,1811.9829282407409,CLOSED,1,173,3,1,1,4,False,0,1,1,3247,174,8.526111111111112,Document
TypeScript,2071,16638,1220.216412037037,MERGED,1,1,1,0,1,10,False,0,0,0,2261,2,3.0344444444444445,Document
Python,547,7160,2218.2772685185187,MERGED,4,3,2,0,3,220,False,0,0,0,809,7,3.8,Bug
Rust,264,5382,381.04950231481484,MERGED,77,54,8,0,1,292,False,0,0,0,2958,131,0.08416666666666667,Bug
TypeScript,2147,14722,1454.0815162037036,MERGED,16,29,3,0,1,664,False,0,0,0,5216,45,310.4211111111111,Bug
C#,80,125,800.772638888889,MERGED,79,752,26,0,4,173,False,0,0,0,914,831,19.814166666666665,Document
C++,363,552,516.2661805555556,MERGED,18,124,2,0,14,195,False,0,0,0,1921,142,813.9344444444445,Document
TypeScript,7,6,625.1667361111112,MERGED,0,102,2,0,3,257,False,0,0,0,4021,102,335.27777777777777,Feature
TypeScript,261,3765,654.9917592592593,MERGED,422,240,11,2,1,45,False,0,2,1,3201,662,17.353055555555557,Document
TypeScript,3392,2334,947.9193402777778,MERGED,3,3,1,1,1,644,False,0,1,1,1008,6,0.19611111111111112,Feature
TypeScript,307,2556,519.4844560185185,MERGED,5,7,3,1,1,552,True,1,0,0,627,12,5.961111111111111,Bug
JavaScript,9664,43889,3637.020023148148,MERGED,41,71,2,0,1,613,False,0,0,0,791,112,1.3258333333333334,Feature
TypeScript,1297,21107,394.7086458333333,MERGED,20,55,3,1,2,839,True,0,1,1,2731,75,0.10194444444444445,Document
Java,450,746,4052.0425925925924,MERGED,10,21,4,2,2,135,False,0,2,1,2753,31,2.8325,Bug
TypeScript,307,2556,518.4893981481481,CLOSED,7,7,2,1,2,12,False,1,0,0,1772,14,2.398888888888889,Bug
TypeScript,1297,21107,394.6156712962963,MERGED,5,31,4,1,3,837,True,0,1,1,3020,36,0.029722222222222223,Document
C#,80,125,797.5925231481482,MERGED,10,1822,33,0,5,150,True,0,0,0,787,1832,94.43111111111111,Document
TypeScript,3392,2334,947.0090972222223,MERGED,4,13,3,1,3,641,False,0,1,1,1101,17,0.8519444444444444,Feature
C#,80,125,798.4647106481481,MERGED,1,4441,41,0,12,151,True,0,0,0,912,4442,53.53388888888889,Document
JavaScript,9664,43889,3636.5443171296297,MERGED,1,1,1,0,1,612,False,0,0,0,857,2,0.12555555555555556,Feature
TypeScript,3392,2334,946.8418171296297,MERGED,1,1,1,1,1,639,False,0,1,1,877,2,1.0030555555555556,Bug
TypeScript,41369,87411,2917.71193287037,CLOSED,0,14,1,1,1,0,False,0,1,1,2135,14,0.32916666666666666,Document
Python,547,7160,2215.999490740741,MERGED,9,51,2,0,6,217,False,0,0,0,848,60,9.818055555555556,Document
TypeScript,15,34,469.60884259259257,MERGED,13,27,2,0,2,868,False,0,0,0,2812,40,15.46111111111111,Feature
TypeScript,4,33,741.0081712962964,MERGED,1,1,1,0,1,54,False,0,0,0,956,2,0.3641666666666667,Bug
JavaScript,5139,7048,1181.559375,MERGED,9,36,5,3,3,238,False,1,2,2,3714,45,2.2952777777777778,Document
TypeScript,41369,87411,2916.8923842592594,MERGED,16,16,2,0,2,563,True,0,0,0,3202,32,13.744722222222222,Document
Go,2083,11768,1500.0200578703705,MERGED,4,11,1,3,1,0,False,1,2,2,1025,15,4.63,Document
TypeScript,307,2556,516.9872685185186,CLOSED,1,5,2,3,1,10,False,1,2,2,1560,6,12.568888888888889,Bug
TypeScript,41369,87411,2916.856261574074,MERGED,1,1,1,0,1,562,True,0,0,0,2152,2,0.8788888888888889,Document
TypeScript,307,2556,516.9598726851851,CLOSED,1,5,2,0,1,8,False,0,0,0,1621,6,0.5133333333333333,Bug
TypeScript,41369,87411,2916.7267476851853,MERGED,242,1,11,1,1,193,False,1,0,0,2356,243,0.6336111111111111,Document
Erlang,2054,12122,3773.102337962963,MERGED,17,15,4,0,2,125,False,0,0,0,921,32,386.36083333333335,Document
TypeScript,41369,87411,2916.655300925926,MERGED,2,2,2,0,1,1555,True,0,0,0,2696,4,0.4791666666666667,Document
TypeScript,41369,87411,2915.944965277778,MERGED,2,11,2,1,1,561,True,0,1,1,2967,13,17.5925,Document
Vue,0,1,224.19332175925925,MERGED,1,2,1,0,1,149,True,0,0,0,756,3,0.011111111111111112,Feature
TypeScript,41369,87411,2915.66181712963,MERGED,141,177,5,0,3,1887,True,0,0,0,2286,318,20.430555555555557,Document
TypeScript,307,2556,515.7701388888889,MERGED,286,295,68,0,4,548,True,0,0,0,557,581,16.253888888888888,Feature
TypeScript,41369,87411,2914.9739930555556,MERGED,17,12,4,0,3,560,True,0,0,0,2497,29,12.58611111111111,Document
TypeScript,202,107,1123.5583912037036,MERGED,33,37,3,4,6,236,True,0,4,4,3280,70,356.9633333333333,Bug
Rust,591,3260,527.1570370370371,MERGED,7,7,1,1,1,158,True,1,0,0,1592,14,2.106388888888889,Document
TypeScript,5735,42500,3124.906805555556,MERGED,24,109,7,3,14,916,True,3,0,0,5423,133,315.2269444444444,Document
Python,137,75,665.9533796296297,CLOSED,0,224,2,0,7,0,False,0,0,0,1179,224,160.105,Feature
TypeScript,17,33,697.0446527777777,MERGED,71,245,21,1,4,23,False,0,1,1,920,316,40.48861111111111,Bug
C#,80,125,798.6095949074074,MERGED,4556,22090,9,1,22,32,False,1,0,0,1042,26646,333.96194444444444,Document
TypeScript,3392,2334,949.0828472222223,CLOSED,115,163,9,1,4,646,False,0,1,1,1422,278,69.2911111111111,Feature
Java,547,304,208.64885416666667,MERGED,0,12,1,0,1,0,False,0,0,0,2154,12,47.519444444444446,Document
Java,547,304,208.55765046296298,MERGED,0,15,1,1,4,0,False,1,0,0,2189,15,25.20916666666667,Document
TypeScript,2147,14722,1452.083726851852,MERGED,72,207,11,0,5,61,False,0,0,0,5777,279,118.67666666666666,Feature
Starlark,440,286,468.14649305555554,MERGED,1,1,1,0,1,21,False,0,0,0,1207,2,41.85333333333333,Bug
C++,2234,23694,2338.9387037037036,MERGED,0,54,2,1,1,294,False,0,1,1,1629,54,46.146388888888886,Bug
Rust,264,5382,385.1219212962963,MERGED,21,269,11,0,3,127,False,0,0,0,3891,290,40.903888888888886,Bug
Erlang,2054,12122,3775.1242592592594,MERGED,0,27,2,0,2,476,True,0,0,0,1318,27,137.62083333333334,Document
Erlang,2054,12122,3776.0774768518518,MERGED,12,14,6,0,2,975,True,0,0,0,1223,26,91.71444444444444,Document
Erlang,2054,12122,3775.148356481481,MERGED,0,3,1,0,1,299,False,0,0,0,991,3,46.169444444444444,Document
Erlang,2054,12122,3775.1377430555553,MERGED,19,39,13,0,2,298,False,0,0,0,1294,58,41.265277777777776,Document
Erlang,2054,12122,3777.0105671296296,MERGED,115,196,3,1,1,337,True,0,1,1,1401,311,44.04083333333333,Document
Erlang,2054,12122,3775.2390046296296,MERGED,7,53,5,0,2,47,False,0,0,0,1047,60,26.852777777777778,Document
C#,80,125,800.5296527777778,MERGED,18,63,8,1,28,62,False,1,0,0,1008,81,189.57611111111112,Document
Go,789,5551,1021.1962268518519,MERGED,11,137,3,0,1,20,False,0,0,0,1172,148,15.163055555555555,Document
TypeScript,2147,14722,1453.8210185185187,MERGED,7,24,7,0,1,32,False,0,0,0,1183,31,4.315555555555555,Feature
TypeScript,2147,14722,1450.154340277778,MERGED,1166,293,8,0,1,42,False,0,0,0,7187,1459,135.0886111111111,Bug
Go,421,1654,1491.0822685185185,CLOSED,73,106,13,4,8,8,False,2,2,2,6702,179,139.4875,Bug
Rust,264,5382,385.06269675925927,MERGED,104,112,5,2,2,200,True,1,1,1,4370,216,0.9669444444444445,Feature
Rust,264,5382,384.9092013888889,MERGED,22,178,10,1,3,146,False,0,1,1,3569,200,5.055833333333333,Bug
Python,137,75,664.9603009259259,CLOSED,0,94,5,0,4,0,False,0,0,0,1579,94,47.710277777777776,Document
Go,421,1654,1488.3380555555557,MERGED,125,515,8,2,6,7,False,1,1,1,5499,640,161.96194444444444,Bug
Rust,264,5382,384.8709143518518,MERGED,67,70,6,0,2,145,False,0,0,0,3798,137,0.16972222222222222,Bug
Go,1295,18029,494.99642361111114,MERGED,22,33,1,0,1,437,True,0,0,0,1413,55,0.029722222222222223,Feature
TypeScript,3392,2334,949.1982175925926,MERGED,2,7,1,1,4,284,False,0,1,1,1273,9,66.35916666666667,Feature
TypeScript,2071,16638,1222.0536921296296,MERGED,1,16,1,0,2,0,False,0,0,0,3206,17,72.98527777777778,Document
Erlang,2054,12122,3776.8927430555555,MERGED,16,183,5,3,6,336,True,1,2,1,1275,199,6.510555555555555,Document
Erlang,2054,12122,3776.86943287037,MERGED,7,60,3,3,3,335,True,1,2,1,1450,67,6.867222222222222,Document
Python,847,3032,2522.654340277778,MERGED,2,5,1,5,3,160,True,3,2,1,1274,7,77.40472222222222,Bug
Erlang,2054,12122,3776.8809375,MERGED,5,23,2,0,1,336,True,0,0,0,1397,28,4.605277777777777,Document
Python,2407,12180,221.47728009259257,MERGED,0,3,1,1,2,62,True,0,1,1,1551,3,8.369722222222222,Feature
Erlang,2054,12122,3773.8943287037036,CLOSED,45,66,8,0,5,224,True,0,0,0,1349,111,118.70333333333333,Document
Erlang,2054,12122,3773.6853587962964,MERGED,5,924,24,0,6,329,True,0,0,0,1326,929,125.20472222222222,Document
Erlang,2054,12122,3776.8164699074073,MERGED,2,5,1,0,1,335,True,0,0,0,1156,7,0.7825,Document
TypeScript,261,3765,655.6271527777777,MERGED,369,792,36,0,9,255,True,0,0,0,7031,1161,100.68111111111111,Document
Python,2407,12180,220.74430555555557,MERGED,5,6,1,0,3,119,True,0,0,0,1233,11,25.975277777777777,Document
TypeScript,178,1359,300.5069560185185,MERGED,49,59,8,2,9,9,True,1,1,1,5018,108,6.926111111111111,Bug
Rust,264,5382,383.9944791666667,MERGED,219,130,16,5,3,198,True,4,1,1,3855,349,3.1519444444444447,Feature
Erlang,2054,12122,3775.9952083333333,MERGED,7,6,2,0,2,334,True,0,0,0,1131,13,20.613055555555555,Document
C#,80,125,797.6415162037038,CLOSED,242,26714,24,0,4,20,False,0,0,0,1331,26956,239.98305555555555,Document
C#,80,125,800.8150810185185,MERGED,173,122,7,0,9,5,False,0,0,0,1343,295,114.1575,Document
TypeScript,7,6,624.0753472222221,MERGED,21,47,7,1,8,5,False,0,1,1,5088,68,21.203333333333333,Feature
Erlang,2054,12122,3776.154085648148,MERGED,18,93,5,0,1,12,False,0,0,0,1460,111,3.9763888888888888,Document
Erlang,2054,12122,3774.9420254629626,MERGED,36,163,8,0,5,333,True,0,0,0,1539,199,45.714166666666664,Document
Erlang,2054,12122,3774.7966666666666,MERGED,28,96,19,0,4,475,True,0,0,0,1378,124,55.49861111111111,Document
Erlang,2054,12122,3775.9618171296297,MERGED,64,109,11,0,18,974,True,0,0,0,1325,173,5.4847222222222225,Document
JavaScript,34,25,177.37737268518518,MERGED,7,33,1,3,3,2,False,2,1,1,2332,40,181.7236111111111,Bug
TypeScript,178,1359,299.7656597222222,MERGED,38,100,7,1,4,7,True,0,1,1,5396,138,10.789722222222222,Bug
Rust,264,5382,383.0402777777778,MERGED,13,14,14,0,2,196,True,0,0,0,3846,27,20.783055555555556,Document
Erlang,2054,12122,3775.8405208333334,MERGED,2,9,4,0,2,477,True,0,0,0,1280,11,3.024722222222222,Document
Erlang,2054,12122,3775.8894791666667,MERGED,16,16,6,0,2,334,True,0,0,0,1256,32,3.2625,Document
TypeScript,4,33,743.6194328703704,MERGED,34,80,6,1,5,372,True,0,1,1,1459,114,36.4425,Feature
PHP,1334,2960,4187.324837962963,MERGED,1222,743,86,0,30,858,False,0,0,0,7374,1965,116.71888888888888,Feature
TypeScript,261,3765,656.7228356481481,MERGED,38,334,18,0,9,164,False,0,0,0,5756,372,3.2994444444444446,Document
TypeScript,261,3765,656.7078009259259,MERGED,592,823,24,0,6,46,False,0,0,0,6817,1415,2.8583333333333334,Document
Starlark,440,286,469.0304050925926,MERGED,1,14,1,0,16,3,False,0,0,0,1547,15,17.341944444444444,Bug
Erlang,2054,12122,3773.9817708333335,MERGED,273,63,2,0,5,473,True,0,0,0,1435,336,52.940555555555555,Document
TypeScript,3392,2334,949.0943055555555,MERGED,3,7,1,1,1,84,False,0,1,1,1516,10,0.19333333333333333,Bug
TypeScript,3392,2334,949.0309953703704,MERGED,5,9,1,1,1,82,False,0,1,1,1700,14,0.16666666666666666,Bug
TypeScript,2147,14722,1450.200474537037,MERGED,737,87047,81,0,6,655,False,0,0,0,7052,87784,37.29222222222222,Document
C++,363,552,517.9711921296297,MERGED,4,0,3,0,1,203,False,0,0,0,1581,4,1.7977777777777777,Document
TypeScript,3392,2334,948.9301388888889,MERGED,2,6,2,2,1,333,False,0,2,1,1787,8,0.2608333333333333,Bug
Erlang,2054,12122,3774.8416319444445,MERGED,49,116,6,0,3,333,True,0,0,0,1196,165,8.994166666666667,Document
Erlang,2054,12122,3773.845173611111,MERGED,28,30,12,0,8,331,True,0,0,0,1408,58,7.8661111111111115,Document
TypeScript,261,3765,655.909525462963,MERGED,71,241,13,0,3,832,True,0,0,0,6752,312,1.6705555555555556,Document
TypeScript,4,33,742.1716550925926,MERGED,0,21,2,2,1,573,True,1,1,1,1256,21,51.7125,Document
TypeScript,41369,87411,2918.4343171296296,CLOSED,6,90,5,6,2,0,False,3,3,3,3347,96,96.5375,Document
Erlang,2054,12122,3774.0333680555555,MERGED,57,90,5,0,3,332,True,0,0,0,1326,147,28.352777777777778,Document
Erlang,2054,12122,3774.1343287037034,MERGED,5,8,3,2,1,297,False,2,0,0,1160,13,23.00027777777778,Document
Java,450,746,4050.274513888889,MERGED,303,545,7,3,8,370,False,1,2,2,4138,848,166.98444444444445,Document
C++,363,552,517.4294212962963,MERGED,14,8,4,0,1,201,False,0,0,0,1786,22,2.7308333333333334,Document
Python,72,25,1614.7195486111111,MERGED,111,250,2,0,3,17,False,0,0,0,4935,361,18.81277777777778,Bug
TypeScript,2071,16638,1221.0197453703704,CLOSED,0,115,3,1,3,0,False,0,1,1,2963,115,5.179444444444444,Document
TypeScript,3392,2334,948.2357523148148,MERGED,6,11,4,1,1,281,False,0,1,1,1864,17,0.17583333333333334,Feature
Erlang,2054,12122,3773.982523148148,MERGED,0,47,1,0,3,331,True,0,0,0,1182,47,16.39138888888889,Document
TypeScript,3392,2334,948.2204398148148,MERGED,6,5,2,1,4,645,False,0,1,1,1338,11,0.18861111111111112,Feature
TypeScript,4,33,742.5026041666666,CLOSED,53,213,4,2,2,576,True,1,1,1,1471,266,20.556944444444444,Document
TypeScript,3989,23860,2807.3146759259257,MERGED,33,45,5,1,2,237,True,0,1,1,1781,78,0.4047222222222222,Feature
TypeScript,202,107,1124.7480439814815,MERGED,12,65,13,4,4,143,True,0,4,4,4682,77,27.763055555555557,Document
TypeScript,3392,2334,948.1601273148149,MERGED,0,8,1,1,1,280,False,0,1,1,1516,8,0.18,Feature
Vue,293,495,807.9459837962963,MERGED,333,610,15,6,17,45,False,0,6,6,1374,943,78.43277777777777,Bug
TypeScript,3392,2334,948.0960648148148,MERGED,4,10,1,1,1,278,False,0,1,1,1991,14,0.1922222222222222,Bug
TypeScript,3989,23860,2807.104756944444,MERGED,9,51,4,1,5,236,True,0,1,1,1645,60,0.6169444444444444,Document
Erlang,2054,12122,3774.1450810185183,MERGED,6,7,1,0,1,474,True,0,0,0,1159,13,1.1380555555555556,Document
TypeScript,261,3765,654.8073611111112,MERGED,83,266,13,0,2,89,True,0,0,0,5077,349,17.939444444444444,Document
TypeScript,3392,2334,947.3939467592592,CLOSED,24,24,1,3,1,242,False,0,3,2,1148,48,20.858055555555556,Feature
TypeScript,3392,2334,947.8955324074074,MERGED,1,2,1,1,2,643,False,0,1,1,1170,3,0.36,Feature
Rust,264,5382,381.0255902777778,MERGED,8,630,20,0,1,193,True,0,0,0,4910,638,21.530555555555555,Feature
Erlang,2054,12122,3773.920925925926,MERGED,2,0,1,0,1,332,True,0,0,0,1209,2,1.446388888888889,Document
Java,547,304,208.1713888888889,CLOSED,0,0,0,2,0,0,False,1,1,1,2042,0,59.415277777777774,Document
Erlang,2054,12122,3773.901377314815,MERGED,2,7,2,0,2,330,True,0,0,0,1141,9,0.5680555555555555,Document
C#,80,125,799.4613541666666,MERGED,379,873,7,0,6,152,True,0,0,0,1162,1252,51.39361111111111,Document
Erlang,2054,12122,3773.386701388889,MERGED,134,183,30,2,3,969,True,1,1,1,1353,317,16.662777777777777,Document
Starlark,440,286,467.89678240740744,MERGED,1,1,1,0,1,57,False,0,0,0,1095,2,0.028888888888888888,Document
Starlark,440,286,467.80871527777776,MERGED,0,0,16,2,1,56,False,0,2,1,1100,0,2.1705555555555556,Feature
Starlark,440,286,467.70269675925925,MERGED,1,1,1,0,1,55,False,0,0,0,1217,2,0.0125,Feature
TypeScript,4,33,742.2199421296297,MERGED,3,11,2,1,3,361,False,0,1,1,1559,14,0.3244444444444444,Document
Python,2407,12180,219.80778935185185,MERGED,4,9,3,2,5,0,False,1,1,1,1957,13,5.588055555555556,Document
Rust,264,5382,381.1376388888889,CLOSED,7,31547,646,0,2,294,False,0,0,0,4546,31554,0.024166666666666666,Bug
TypeScript,307,2556,518.5022337962963,MERGED,3,0,1,4,1,550,True,2,2,1,639,3,30.06972222222222,Bug
TypeScript,261,3765,654.578599537037,MERGED,72,90,21,0,1,823,True,0,0,0,5681,162,1.708888888888889,Document
Rust,264,5382,380.95907407407407,MERGED,9,43,6,0,2,291,False,0,0,0,4436,52,0.42333333333333334,Feature
Vue,0,1,226.03662037037034,MERGED,11,2,3,0,1,157,True,0,0,0,1444,13,0.11972222222222222,Feature
Python,547,7160,2216.569039351852,MERGED,48,501,20,0,24,245,True,0,0,0,1624,549,6.099166666666667,Bug
TypeScript,4,33,741.6133680555555,MERGED,1,7,2,1,2,145,False,0,1,1,1102,8,0.028888888888888888,Feature
Erlang,2054,12122,3772.9708449074074,MERGED,3,3,2,0,1,330,True,0,0,0,1276,6,0.9222222222222223,Document
TypeScript,139,827,727.2365277777777,MERGED,0,1,1,2,2,10,False,0,2,2,1146,1,1.4852777777777777,Feature
TypeScript,7,6,626.1543518518519,MERGED,96,369,6,0,24,6,False,0,0,0,6453,465,432.8202777777778,Feature
PHP,1334,2960,4186.153368055556,MERGED,65,370,19,1,6,36,False,0,1,1,8171,435,47.34638888888889,Document
Vue,0,1,224.44203703703704,CLOSED,2,4,1,0,3,152,True,0,0,0,1505,6,43.61388888888889,Bug
TypeScript,261,3765,653.8361342592592,MERGED,65,86,8,0,3,86,False,0,0,0,5422,151,0.7983333333333333,Document
C#,80,125,799.0307523148149,MERGED,156,5531,45,3,17,172,False,2,1,1,1528,5687,38.68972222222222,Document
TypeScript,261,3765,653.6405902777777,MERGED,77,241,15,0,2,815,True,0,0,0,6091,318,1.0344444444444445,Document
TypeScript,41369,87411,2918.5631944444444,MERGED,3,10,1,0,1,43,False,0,0,0,2901,13,1.8525,Document
Starlark,440,286,470.1585763888889,MERGED,0,242,5,1,3,0,False,1,0,0,1934,242,182.08027777777778,Document
TypeScript,1297,21107,394.82434027777776,MERGED,16,16,7,1,1,845,True,0,1,1,4004,32,0.04611111111111111,Document
C#,80,125,798.6953587962963,MERGED,46,417,16,0,9,165,False,0,0,0,1180,463,42.385,Document
TypeScript,7,6,623.2313310185185,MERGED,1171,159,44,1,12,241,False,0,1,1,2218,1330,209.93694444444444,Document
TypeScript,1297,21107,394.7895833333334,MERGED,9,33,20,1,4,842,True,0,1,1,5095,42,0.3275,Document
TypeScript,1297,21107,394.71876157407405,MERGED,828,4,29,2,1,840,True,0,2,2,3689,832,0.034722222222222224,Document
TypeScript,3392,2334,946.0552893518519,MERGED,1,1,1,1,1,274,False,0,1,1,1288,2,0.1825,Bug
TypeScript,4,33,740.5783680555555,MERGED,0,3,3,2,1,187,True,1,1,1,1691,3,0.04583333333333333,Bug
Vue,0,1,224.8773148148148,CLOSED,1,1,1,0,3,35,False,0,0,0,1032,2,0.05416666666666667,Bug
TypeScript,4,33,740.5422222222222,MERGED,31,121,9,1,3,360,False,0,1,1,1602,152,0.09111111111111111,Feature
TypeScript,4,33,740.3809143518519,MERGED,1,3,1,1,2,359,False,0,1,1,1161,4,0.14055555555555554,Feature
TypeScript,15,34,470.2737037037037,MERGED,62,65,5,0,2,149,False,0,0,0,3818,127,4.751666666666667,Feature
Vue,0,1,224.19893518518518,MERGED,2,3,1,0,3,1,False,0,0,0,1239,5,4.8325,Document
TypeScript,1297,21107,393.8867939814815,MERGED,58,384,10,1,3,830,True,0,1,1,3489,442,0.1988888888888889,Document
Vue,0,1,224.1697337962963,MERGED,0,8,1,0,7,0,False,0,0,0,1387,8,0.4494444444444444,Feature
C#,80,125,798.4802430555555,CLOSED,256,27289,99,0,5,21,False,0,0,0,1021,27545,4.7975,Document
TypeScript,3392,2334,945.1276157407407,MERGED,1,1,1,1,1,271,False,0,1,1,1207,2,0.19333333333333333,Bug
TypeScript,3392,2334,945.0964467592593,MERGED,0,8,1,1,3,270,False,0,1,1,1022,8,0.3913888888888889,Feature
TypeScript,41369,87411,2916.7491898148146,CLOSED,7069,7023,19,1,2,0,False,0,1,1,3130,14092,21.611666666666668,Document
TypeScript,15,34,469.6753125,MERGED,35,75,7,0,3,870,False,0,0,0,4182,110,0.5113888888888889,Feature
TypeScript,41369,87411,2916.9625810185184,MERGED,17,40,3,0,2,1558,True,0,0,0,3520,57,0.40444444444444444,Document
TypeScript,41369,87411,2916.9152314814814,MERGED,128,145,2,0,3,1557,True,0,0,0,4339,273,0.5108333333333334,Document
TypeScript,7,6,623.051099537037,MERGED,167,239,28,4,124,202,False,1,3,3,8503,406,1100.3977777777777,Document
TypeScript,307,2556,516.6969328703703,MERGED,65,102,5,5,1,7,False,2,3,1,2799,167,0.5538888888888889,Feature
Python,137,75,662.950925925926,MERGED,17,37,9,0,20,0,False,0,0,0,2357,54,168.8736111111111,Bug
JavaScript,5139,7048,1183.7484953703704,MERGED,46,58,28,2,6,48,False,1,1,1,7127,104,0.5713888888888888,Document
JavaScript,5139,7048,1182.9969791666667,MERGED,78,72,5,1,3,287,False,0,1,1,8115,150,0.22305555555555556,Document
TypeScript,2147,14722,1453.9293634259259,MERGED,301,657,23,0,5,656,False,0,0,0,8806,958,92.4975,Document
JavaScript,5139,7048,1182.9096296296295,MERGED,41,55,4,2,3,46,False,1,1,1,8282,96,0.14194444444444446,Document
TypeScript,41369,87411,2915.510740740741,MERGED,32,139,16,4,9,1552,True,0,4,3,11454,171,123.82916666666667,Document
TypeScript,184,377,1891.9546643518518,MERGED,344,850,37,5,26,199,False,3,2,2,2880,1194,355.7997222222222,Document
TypeScript,41369,87411,2914.7016435185183,CLOSED,242,164,15,1,1,2,False,0,1,1,1204,406,0.1638888888888889,Bug
TypeScript,41369,87411,2914.663217592593,CLOSED,242,164,15,2,2,1,False,0,2,2,1548,406,1.1655555555555555,Bug
TypeScript,307,2556,519.6339930555556,MERGED,16,33,5,0,4,553,True,0,0,0,767,49,123.0736111111111,Bug
Python,2407,12180,220.9292824074074,MERGED,2,2,1,2,2,13,False,1,1,1,2105,4,21.529722222222222,Document
Starlark,440,286,470.90119212962964,MERGED,7,17,2,0,2,15,False,0,0,0,2007,24,0.1313888888888889,Document
TypeScript,218,1201,2905.0603472222224,MERGED,2,2,2,0,1,17,False,0,0,0,1367,4,1.8744444444444444,Bug
Python,2407,12180,220.60189814814817,CLOSED,1,1,1,6,1,12,False,3,3,1,2022,2,4.811111111111111,Document
Go,789,5551,1019.2552083333334,MERGED,0,3,1,0,1,337,False,0,0,0,1851,3,14.853333333333333,Document
Erlang,2054,12122,3775.443935185185,MERGED,6,73,5,0,1,300,False,0,0,0,1526,79,16.53527777777778,Document
TypeScript,3392,2334,949.2440277777778,MERGED,4,13,1,1,1,85,False,0,1,1,2367,17,0.2025,Feature
Starlark,440,286,469.87459490740736,MERGED,2,5,1,0,3,59,False,0,0,0,1795,7,0.10611111111111111,Feature
Rust,433,2229,213.79587962962964,MERGED,33,1218,7,2,14,212,False,1,1,1,1835,1251,167.22972222222222,Feature
Go,789,5551,1018.1367824074074,MERGED,3,3,2,0,1,246,True,0,0,0,1851,6,22.74111111111111,Document
TypeScript,4,33,743.3569907407408,MERGED,310,507,23,2,12,577,True,1,1,1,1647,817,24.46,Document
TypeScript,7,6,624.0149421296296,MERGED,53,32,14,1,5,255,False,0,1,1,6224,85,363.3147222222222,Feature
Erlang,2054,12122,3773.415590277778,MERGED,12,106,5,0,1,296,False,0,0,0,1463,118,21.547777777777778,Document
TypeScript,178,1359,300.773125,MERGED,812,1168,162,1,1,16,True,0,1,1,10236,1980,2.1333333333333333,Feature
C++,363,552,517.1248842592593,MERGED,5,5,2,0,1,199,False,0,0,0,2114,10,1.4769444444444444,Document
Python,2407,12180,218.0387037037037,MERGED,0,84,5,0,2,118,True,0,0,0,2219,84,16.4825,Document
Python,2407,12180,217.8303935185185,MERGED,1,1,1,1,2,2,True,0,1,1,1649,2,21.51888888888889,Document
TypeScript,4,33,740.4113773148148,MERGED,59,233,15,2,7,570,True,1,1,1,2157,292,93.42527777777778,Document
C++,363,552,516.4038310185185,MERGED,17,12,2,0,4,196,False,0,0,0,2100,29,20.236944444444443,Document
TypeScript,3392,2334,946.8838888888889,MERGED,4,35,3,1,1,640,False,0,1,1,1834,39,0.09944444444444445,Bug
C#,80,125,798.7214351851852,MERGED,27,76,8,0,5,191,False,0,0,0,1675,103,68.00722222222223,Document
TypeScript,1297,21107,394.8939699074074,MERGED,4,3,1,3,2,34,False,1,2,2,2012,7,5.506944444444445,Document
TypeScript,307,2556,517.743587962963,MERGED,5,17,2,0,1,13,False,0,0,0,758,22,42.119166666666665,Bug
Vue,0,1,226.05734953703703,MERGED,1,1,1,0,1,36,False,0,0,0,1660,2,0.02,Feature
TypeScript,149,2900,357.38298611111117,MERGED,38,41,3,1,2,163,True,0,1,1,2059,79,2.2325,Bug
TypeScript,3392,2334,946.0045833333334,MERGED,0,28,3,1,3,272,False,0,1,1,1809,28,0.7586111111111111,Feature
TypeScript,3392,2334,946.0458333333332,MERGED,6,31,6,1,1,638,False,0,1,1,2159,37,0.13166666666666665,Bug
JavaScript,5139,7048,1183.8658333333333,MERGED,21,605,12,4,9,84,False,1,3,2,10244,626,206.10694444444445,Feature
Python,72,25,1615.657824074074,MERGED,30,231,3,0,1,18,False,0,0,0,5517,261,284.3697222222222,Bug
Python,14532,41181,1064.3726041666666,MERGED,1,1,1,1,2,1,True,0,1,1,2016,2,21.675,Bug
TypeScript,4,33,740.4813310185185,MERGED,3,14,1,5,1,571,True,4,1,1,1686,17,4.041388888888889,Feature
JavaScript,5139,7048,1181.887476851852,MERGED,21,558,12,4,12,83,False,1,3,2,8786,579,253.69222222222223,Feature
Go,1835,11245,1709.5987962962963,MERGED,3,2,1,0,1,492,False,0,0,0,1601,5,6.267222222222222,Document
JavaScript,5139,7048,1184.5400694444445,MERGED,18,28,10,4,6,241,False,1,3,2,10174,46,128.31555555555556,Document
TypeScript,261,3765,654.8764467592592,MERGED,112,125,5,0,5,555,True,0,0,0,9465,237,0.4988888888888889,Document
Python,137,75,665.6006597222222,MERGED,4,250,7,1,18,2,False,0,1,1,2719,254,204.07083333333333,Bug
Go,1835,11245,1708.0380787037038,MERGED,0,3,1,0,1,490,False,0,0,0,1875,3,0.09083333333333334,Document
Go,1835,11245,1707.7347453703703,MERGED,12,62,3,0,1,489,False,0,0,0,1981,74,6.789166666666667,Document
Python,137,75,665.9578240740741,MERGED,0,104,5,1,10,9,False,1,0,0,2579,104,179.1313888888889,Document
Go,1835,11245,1706.8832407407408,CLOSED,69,82,6,0,6,488,False,0,0,0,1857,151,2.720833333333333,Document
Python,14532,41181,1067.2454282407407,CLOSED,1,7,1,1,2,5,True,0,1,1,2846,8,222.26722222222222,Bug
Python,14532,41181,1066.34,CLOSED,1,7,1,1,1,4,True,0,1,1,2436,8,240.33027777777778,Document
JavaScript,5139,7048,1182.6456249999999,MERGED,66,120,6,5,5,240,False,3,2,2,9191,186,49.93888888888889,Document
Go,2,11,1125.8963773148148,MERGED,23,195,3,0,6,18,False,0,0,0,2621,218,4.4863888888888885,Document
TypeScript,2071,16638,1221.0014814814815,MERGED,55,102,4,0,2,0,False,0,0,0,6655,157,98.25,Document
JavaScript,5139,7048,1182.199224537037,MERGED,359,325,33,2,25,45,False,1,1,1,9978,684,17.225277777777777,Bug
TypeScript,15,34,469.334224537037,MERGED,43,44218,14,0,14,148,False,0,0,0,5848,44261,214.5175,Feature
TypeScript,307,2556,518.5226504629629,MERGED,182,119,17,0,1,168,True,0,0,0,7486,301,143.24277777777777,Bug
Rust,264,5382,382.8949305555555,MERGED,3,693,30,3,12,12,False,3,0,0,6935,696,27.078333333333333,Feature
Go,1295,18029,494.9168634259259,MERGED,7,442,7,0,2,436,True,0,0,0,2569,449,0.07333333333333333,Bug
Go,789,5551,1020.3865046296296,CLOSED,0,259,6,2,1,3,False,1,1,1,2539,259,11.717777777777778,Document
Rust,264,5382,381.2141898148148,MERGED,78,31369,645,0,8,295,False,0,0,0,6970,31447,67.86472222222223,Bug
Python,2407,12180,220.70901620370373,MERGED,1,7,1,2,2,0,True,1,1,1,2551,8,27.42111111111111,Document
Python,72,25,1617.282395833333,MERGED,2,787,8,2,23,27,False,2,0,0,4234,789,643.1841666666667,Document
Python,2407,12180,220.21626157407408,MERGED,9,458,2,4,7,213,True,2,2,2,2288,467,38.76722222222222,Feature
C++,2234,23694,2335.955659722222,MERGED,8,8,1,1,28,257,False,0,1,1,7532,16,23.005555555555556,Feature
C++,2234,23694,2335.9543171296295,MERGED,4,4,1,1,25,256,False,0,1,1,6112,8,18.79138888888889,Bug
Go,789,5551,1018.1054861111111,CLOSED,8,40,3,1,1,334,False,1,0,0,2854,48,70.27222222222223,Document
Java,450,746,4053.2656365740745,MERGED,36,302,6,1,6,748,False,0,1,1,5072,338,23.263055555555557,Bug
TypeScript,3392,2334,949.1869212962962,MERGED,150,41,6,1,6,283,False,0,1,1,3655,191,4.7011111111111115,Bug
Go,789,5551,1019.1030324074073,MERGED,1,1,1,0,1,336,False,0,0,0,2186,2,2.358611111111111,Document
Rust,264,5382,381.2049537037037,MERGED,30,308,18,0,1,123,False,0,0,0,6669,338,16.495277777777776,Bug
Python,2407,12180,218.90957175925925,MERGED,0,23,1,5,5,10,False,2,3,1,2237,23,27.360555555555557,Document
Go,789,5551,1019.0949999999999,MERGED,3,14,2,0,1,247,True,0,0,0,2393,17,0.4563888888888889,Document
Vue,0,1,228.09126157407408,MERGED,163,257,5,0,4,39,False,0,0,0,2648,420,0.20916666666666667,Feature
Python,2407,12180,219.2936574074074,MERGED,1,107,2,2,4,1,False,1,1,1,3544,108,18.045,Document
TypeScript,202,107,1122.5126157407408,MERGED,19,165,7,4,6,247,True,0,4,4,6470,184,81.07055555555556,Document
Python,2407,12180,219.03347222222223,MERGED,10,28,1,1,10,211,True,1,0,0,2856,38,24.059722222222224,Document
TypeScript,4,33,742.2940393518519,MERGED,10,137,7,2,4,574,True,1,1,1,2290,147,48.36277777777778,Document
Python,847,3032,2522.2096875,MERGED,7,14,3,0,5,159,True,0,0,0,2725,21,10.681666666666667,Feature
TypeScript,307,2556,518.9897453703703,CLOSED,13,12,4,1,5,15,False,1,0,0,3921,25,1.068888888888889,Bug
TypeScript,199,371,755.1398032407407,MERGED,269,775,20,1,11,398,False,0,1,1,5629,1044,15.511388888888888,Feature
TypeScript,3392,2334,948.1313773148148,MERGED,0,16,2,1,2,279,False,0,1,1,2387,16,0.37416666666666665,Feature
TypeScript,3392,2334,947.2204166666667,MERGED,6,9,2,2,2,239,False,0,2,1,2741,15,18.120555555555555,Feature
Python,2407,12180,217.85711805555556,MERGED,3,4,1,4,6,0,False,2,2,1,2344,7,20.865,Document
TypeScript,85,721,295.29260416666665,MERGED,511,914,43,0,49,145,False,0,0,0,11870,1425,135.61638888888888,Document
TypeScript,1297,21107,394.7809027777778,MERGED,20,37,12,1,1,841,True,0,1,1,5490,57,0.03638888888888889,Document
TypeScript,1297,21107,394.55824074074076,MERGED,77,231,14,3,5,836,True,0,3,3,5511,308,0.5836111111111111,Document
C++,363,552,515.5632060185185,MERGED,78,111,10,0,2,193,False,0,0,0,2707,189,17.83277777777778,Document
TypeScript,1297,21107,394.1729745370371,MERGED,11,463,16,2,5,834,True,0,2,2,6383,474,0.3233333333333333,Document
TypeScript,1297,21107,394.1014236111111,MERGED,18,118,10,1,4,832,True,0,1,1,5134,136,0.07611111111111112,Document
TypeScript,41369,87411,2916.957511574074,CLOSED,1243,1193,955,6,4,0,False,1,5,4,6646,2436,12.142777777777777,Document
TypeScript,307,2556,516.5065046296296,MERGED,15,650,17,1,3,165,True,1,0,0,4998,665,27.566111111111113,Bug
TypeScript,1297,21107,393.70722222222224,MERGED,4,294,9,1,3,829,True,0,1,1,6814,298,0.11611111111111111,Document
TypeScript,15,34,468.56074074074075,MERGED,170,262,11,0,6,459,True,0,0,0,6266,432,44.58722222222222,Feature
TypeScript,85,721,296.17265046296296,MERGED,289,85,11,0,42,146,False,0,0,0,12982,374,24.852777777777778,Document
Go,5,8,329.0332175925926,CLOSED,29,199,7,1,1,14,False,1,0,0,3489,228,34.64888888888889,Document
TypeScript,3392,2334,945.2799537037037,MERGED,1,11,4,2,3,238,False,0,2,1,3048,12,2.435,Document
Go,1835,11245,1709.1993171296297,MERGED,8,16,3,0,2,491,False,0,0,0,2904,24,15.860555555555555,Document
TypeScript,41369,87411,2914.7287152777776,MERGED,36,67,4,3,1,558,True,0,3,2,4822,103,22.380277777777778,Document
TypeScript,3392,2334,947.2395717592593,MERGED,3411,2,19,2,3,0,False,0,2,1,4897,3413,495.94555555555553,Feature
Go,1,4,195.0980787037037,CLOSED,22,64,9,2,3,2,False,2,0,0,4029,86,404.1725,Document
TypeScript,1416,21916,263.6971990740741,MERGED,353,225,6,3,8,49,False,0,3,3,3926,578,4.025277777777778,Bug
TypeScript,261,3765,654.7649537037037,MERGED,327,583,36,0,5,162,False,0,0,0,11030,910,17.893333333333334,Document
Rust,264,5382,385.04037037037034,MERGED,82,169,25,0,4,147,False,0,0,0,9240,251,44.848333333333336,Bug
C#,80,125,799.7190509259259,MERGED,1418,1919,49,0,22,192,False,0,0,0,3757,3337,361.1691666666667,Document
Python,2407,12180,218.9529398148148,CLOSED,1,99,2,1,7,0,False,1,0,0,3250,100,7.1563888888888885,Document
Rust,46,109,676.8710300925926,CLOSED,23,71,5,2,1,65,False,0,2,1,3633,94,120.51,Feature
Python,137,75,665.2758217592592,CLOSED,0,170,9,1,6,2,False,0,1,1,4914,170,191.57305555555556,Feature
Python,19248,70257,2439.5246180555555,CLOSED,286,300,4,4,5,77,False,3,1,1,6110,586,82.03138888888888,Document
Starlark,440,286,471.65839120370373,MERGED,53,22,3,0,1,42,False,0,0,0,3280,75,146.09583333333333,Bug
Rust,264,5382,382.154849537037,MERGED,1608,1804,54,3,26,248,True,1,2,1,9283,3412,64.83888888888889,Bug
TypeScript,184,377,1888.5554282407409,MERGED,9,4,3,1,2,119,True,1,0,0,3134,13,22.23027777777778,Bug
Rust,264,5382,381.92719907407405,MERGED,141,1644,48,3,10,124,False,1,2,1,8470,1785,26.61861111111111,Feature
Starlark,440,286,471.1154513888889,MERGED,22,65,1,0,1,42,False,0,0,0,3198,87,69.2325,Document
TypeScript,2147,14722,1452.937037037037,MERGED,173,162,49,0,1,30,False,0,0,0,3806,335,4.266944444444444,Feature
Starlark,440,286,470.6579166666667,MERGED,15,70,1,0,1,41,False,0,0,0,3427,85,2.3975,Bug
Starlark,440,286,470.6346875,CLOSED,15,70,1,0,1,39,False,0,0,0,3479,85,0.10861111111111112,Bug
Vue,0,1,227.11836805555558,MERGED,29,233,5,0,1,38,False,0,0,0,3945,262,0.1525,Document
TypeScript,1297,21107,393.9589467592593,MERGED,111,616,13,1,1,831,True,0,1,1,10208,727,1.8530555555555555,Document
TypeScript,3989,23860,2808.043634259259,MERGED,119,66,10,1,3,238,True,0,1,1,3892,185,26.322222222222223,Document
Python,14532,41181,1068.3206828703703,MERGED,57,102,6,0,12,1403,True,0,0,0,3833,159,0.39194444444444443,Document
Vue,0,1,228.06592592592594,MERGED,10,173,9,0,1,161,True,0,0,0,3508,183,0.45416666666666666,Feature
Vue,0,1,227.41993055555554,MERGED,49,245,23,0,9,160,True,0,0,0,4542,294,12.517222222222221,Bug
TypeScript,15,34,468.69056712962964,MERGED,186,134,24,0,6,865,False,0,0,0,9307,320,2.8938888888888887,Bug
Starlark,440,286,468.3660532407407,MERGED,0,354,4,0,10,1,False,0,0,0,4207,354,38.28111111111111,Document
Starlark,440,286,468.08238425925924,CLOSED,4,21,1,5,1110,0,False,4,1,1,3312,25,47.70861111111111,Feature
TypeScript,3392,2334,947.1539583333333,MERGED,23,62,10,1,5,276,False,0,1,1,3489,85,47.45361111111111,Bug
TypeScript,41369,87411,2914.8344791666664,MERGED,323,2263,167,1,41,559,True,0,1,1,8918,2586,40.87888888888889,Document
TypeScript,139,827,726.2737268518518,MERGED,17,125,6,5,10,9,False,1,4,3,4133,142,21.788888888888888,Bug
TypeScript,4,33,741.6848611111112,MERGED,102,185,2,0,2,147,False,0,0,0,4049,287,0.035,Document
TypeScript,3392,2334,945.2480324074073,MERGED,1,4,4,2,2,0,False,0,2,1,3577,5,3.220833333333333,Bug
TypeScript,3392,2334,946.3133912037038,MERGED,20,20,2,1,2,275,False,0,1,1,4239,40,0.4602777777777778,Feature
TypeScript,3392,2334,945.1146527777778,MERGED,55,121,5,2,5,332,False,0,2,1,4417,176,25.683333333333334,Feature
TypeScript,3392,2334,945.0151273148149,MERGED,19,18,9,1,1,635,False,0,1,1,4408,37,0.34555555555555556,Bug
TypeScript,4,33,740.3390277777777,MERGED,77,134,8,4,4,569,True,3,1,1,4925,211,7.3838888888888885,Feature
Rust,264,5382,384.36379629629624,MERGED,194,362,27,0,18,306,False,0,0,0,14328,556,158.62666666666667,Feature
Go,1835,11245,1705.961400462963,MERGED,405,414,12,0,19,487,False,0,0,0,4766,819,2.0344444444444445,Document
Vue,293,495,808.0084375,MERGED,48,76,7,8,8,286,True,0,8,4,18550,124,41.066944444444445,Bug
TypeScript,184,377,1891.2958449074074,MERGED,221,333,4,2,5,20,False,2,0,0,5217,554,209.9963888888889,Document
Go,421,1654,1490.2300810185186,MERGED,137,589,8,0,2,405,True,0,0,0,21222,726,2.395,Document
Rust,591,3260,527.1287037037038,MERGED,174,536,29,1,3,67,False,1,0,0,9116,710,6.373611111111111,Document
TypeScript,783,13212,1179.8573032407407,MERGED,0,144,5,0,26,26,False,0,0,0,5021,144,87.31666666666666,Feature
TypeScript,15,34,468.72398148148153,MERGED,17,226,3,0,11,866,False,0,0,0,12351,243,2.173611111111111,Bug
TypeScript,149,2900,361.51603009259264,MERGED,241,312,55,1,16,76,False,0,1,1,5191,553,102.92694444444444,Document
TypeScript,184,377,1890.3997569444446,MERGED,7,17,1,6,2,258,False,1,5,3,4773,24,5.201666666666667,Document
Python,72,25,1616.7682291666667,MERGED,903,2887,22,0,21,52,False,0,0,0,6544,3790,0.3983333333333333,Document
Python,2407,12180,220.05078703703703,MERGED,43,178,13,0,13,212,True,0,0,0,7019,221,1.5486111111111112,Document
TypeScript,4,33,743.9320486111111,MERGED,1607,1794,478,1,13,149,False,0,1,1,7149,3401,12.850555555555555,Document
TypeScript,3392,2334,948.0900925925926,MERGED,113,113,2,2,1,438,False,0,2,1,5551,226,0.1502777777777778,Feature
Python,14532,41181,1065.8882754629628,CLOSED,67,915,14,2,15,0,False,1,1,1,6649,982,58.124722222222225,Document
Vue,0,1,226.98827546296297,MERGED,33,327,13,0,8,37,False,0,0,0,7071,360,0.6541666666666667,Document
Go,1835,11245,1709.7395949074073,MERGED,39,196,2,0,7,493,False,0,0,0,5038,235,4.703611111111111,Document
TypeScript,199,371,757.7267824074074,MERGED,168,1126,44,2,58,34,False,0,2,2,16749,1294,120.17833333333333,Feature
Rust,264,5382,383.984537037037,MERGED,75,804,53,1,3,126,False,0,1,1,16790,879,19.045555555555556,Bug
Java,450,746,4053.000324074074,MERGED,400,786,45,1,9,405,False,0,1,1,15827,1186,122.37583333333333,Document
C++,2234,23694,2337.0270138888886,CLOSED,83,113,22,1,9,292,False,1,0,0,9313,196,38.7025,Feature
C++,2234,23694,2335.9342824074074,CLOSED,2124,99,75,1,5,291,False,1,0,0,9071,2223,8.168888888888889,Document
TypeScript,3989,23860,2807.0497569444447,CLOSED,173,320,15,2,1,235,True,0,2,2,11401,493,1.3769444444444445,Document
TypeScript,4,33,741.2912731481482,MERGED,691,682,11,5,1,572,True,4,1,1,7719,1373,72.77083333333333,Document
Go,1835,11245,1708.781701388889,MERGED,303,910,37,1,7,93,False,0,1,1,11085,1213,430.87333333333333,Document
TypeScript,3392,2334,946.0503819444444,MERGED,159,151,24,3,17,273,False,1,2,2,12180,310,25.184722222222224,Feature
TypeScript,7,6,627.2365509259259,CLOSED,54,7,1,1,3,0,False,0,1,1,945,61,2423.221666666667,Feature
V,2097,34361,1533.583726851852,MERGED,0,14,1,0,1,13,True,0,0,0,1361,14,14.946388888888889,Feature
PHP,1334,2960,4192.17025462963,CLOSED,0,21,1,4,2,7,False,0,4,3,1500,21,2088.306666666667,Document
TypeScript,7,6,628.4046412037037,CLOSED,103,39,4,0,9,1,False,0,0,0,2293,142,2395.1877777777777,Bug
PHP,883,2337,1816.803576388889,CLOSED,1,1,1,2,1,0,False,0,2,2,1678,2,21.905833333333334,Document
TypeScript,202,107,1128.87125,MERGED,38,47,2,6,6,200,True,0,6,5,1968,85,41.06027777777778,Document
TypeScript,85,721,301.04302083333334,CLOSED,38,22,5,0,4,87,False,0,0,0,2401,60,1157.293888888889,Document
HTML,11809,87634,139.21032407407407,MERGED,0,4,2,0,2,2,False,0,0,0,1088,4,22.351111111111113,Feature
Python,19248,70257,2445.6732060185186,CLOSED,2,2,1,1,1,1557,False,1,0,0,259,4,0.3586111111111111,Bug
TypeScript,261,3765,661.6294328703704,CLOSED,85,82,3,0,3,149,False,0,0,0,1132,167,8.37111111111111,Document
TypeScript,178,1359,303.77010416666667,MERGED,0,9,1,2,1,1,False,1,1,1,816,9,6.958611111111111,Feature
Erlang,2054,12122,3778.627523148148,MERGED,1,1,1,0,1,17,True,0,0,0,1129,2,1877.545,Document
TypeScript,178,1359,306.87114583333334,MERGED,3,33,4,2,7,22,True,1,1,1,712,36,41.17861111111111,Bug
TypeScript,2147,14722,1456.9797222222223,MERGED,1,0,1,0,1,156,False,0,0,0,676,1,18.938333333333333,Bug
TypeScript,178,1359,305.30458333333337,MERGED,1,1,1,1,1,19,True,0,1,1,724,2,0.03194444444444444,Feature
TypeScript,2147,14722,1455.7677777777778,MERGED,1,0,1,0,1,152,False,0,0,0,660,1,0.21083333333333334,Bug
TypeScript,2147,14722,1456.0987615740742,MERGED,2,4,1,0,1,155,False,0,0,0,917,6,3.5180555555555557,Feature
TypeScript,2147,14722,1456.0789814814816,MERGED,0,16,1,0,1,153,False,0,0,0,821,16,3.9902777777777776,Feature
TypeScript,178,1359,303.85604166666667,MERGED,0,6,3,1,1,0,False,0,1,1,914,6,4.786666666666667,Feature
Python,547,7160,2222.462361111111,MERGED,18,58,4,1,4,27,False,0,1,1,654,76,384.6508333333333,Bug
Go,421,1654,1492.227997685185,MERGED,30,184,2,0,3,53,False,0,0,0,698,214,41.72805555555556,Feature
Rust,264,5382,387.8739699074074,MERGED,347,440,11,15,4,7,False,5,10,1,709,787,55.3775,Feature
TypeScript,261,3765,661.8885532407407,MERGED,1,9,2,0,4,172,False,0,0,0,1396,10,13.486944444444445,Document
TypeScript,261,3765,661.7674537037037,MERGED,1,7,2,0,1,93,False,0,0,0,1405,8,17.4575,Document
V,2097,34361,1536.8319791666665,MERGED,1,38,2,0,1,169,True,0,0,0,448,39,42.75555555555555,Bug
TypeScript,261,3765,661.8644444444444,MERGED,7,14,5,0,2,171,False,0,0,0,1091,21,0.3466666666666667,Document
C++,2234,23694,2339.82068287037,MERGED,240,236,2,3,2,206,False,0,3,3,1152,476,290.12166666666667,Feature
Go,421,1654,1493.9023263888887,MERGED,1,1,1,0,1,75,False,0,0,0,1061,2,0.7980555555555555,Document
Go,421,1654,1493.900497685185,MERGED,1,1,1,0,1,74,False,0,0,0,1021,2,0.8388888888888889,Document
TypeScript,2147,14722,1458.2070486111113,MERGED,1,1,1,0,1,43,False,0,0,0,1105,2,0.029166666666666667,Bug
TypeScript,2147,14722,1458.1685416666667,MERGED,11,18,3,0,1,666,False,0,0,0,1789,29,0.4575,Feature
TypeScript,2147,14722,1458.1415972222221,MERGED,7,29,3,0,2,157,False,0,0,0,1761,36,0.235,Feature
Rust,264,5382,387.1283796296296,MERGED,1,3,1,0,1,205,True,0,0,0,746,4,0.1175,Feature
PHP,1334,2960,4192.244224537038,MERGED,1,1,1,1,1,0,False,0,1,1,1793,2,358.1111111111111,Document
Vue,293,495,815.9068518518519,MERGED,10,0,1,3,3,289,True,0,3,2,826,10,1.0994444444444444,Bug
TypeScript,261,3765,660.4855092592593,MERGED,3,25,3,0,3,563,True,0,0,0,1497,28,3.7975,Document
TypeScript,2147,14722,1457.2287847222224,MERGED,1,18,2,0,1,44,False,0,0,0,1247,19,14.634444444444444,Document
TypeScript,2147,14722,1457.2215393518518,MERGED,5,24,2,0,2,28,False,0,0,0,1647,29,13.075833333333334,Feature
TypeScript,85,721,300.1325810185185,MERGED,0,83,2,0,2,85,False,0,0,0,1593,83,0.34305555555555556,Document
TypeScript,261,3765,659.7674305555555,MERGED,1,1,1,0,1,169,False,0,0,0,1108,2,0.2713888888888889,Document
TypeScript,261,3765,659.7437268518519,MERGED,2,8,3,0,2,92,False,0,0,0,1424,10,0.27805555555555556,Document
TypeScript,178,1359,304.86148148148146,MERGED,356,356,4,2,1,1,True,0,2,2,1657,712,7.418055555555555,Bug
TypeScript,178,1359,304.65585648148146,MERGED,1,5,1,2,1,1,False,0,2,2,1091,6,11.578611111111112,Bug
Rust,264,5382,386.0397800925926,MERGED,5,37,6,0,1,174,False,0,0,0,742,42,3.138333333333333,Bug
TypeScript,178,1359,307.5174768518519,MERGED,24,34,3,2,2,3,True,0,2,2,2048,58,58.56,Feature
TypeScript,178,1359,304.57872685185185,MERGED,2,5,1,2,2,0,True,0,2,2,1858,7,13.73,Feature
TypeScript,85,721,299.0804513888889,MERGED,0,114,2,0,2,84,False,0,0,0,1485,114,18.959722222222222,Document
TypeScript,2147,14722,1456.103738425926,MERGED,12,14,1,0,2,665,False,0,0,0,990,26,0.5833333333333334,Bug
TypeScript,2147,14722,1456.0959722222224,CLOSED,2,20,2,0,2,154,False,0,0,0,1429,22,0.020555555555555556,Feature
Rust,264,5382,389.0332407407407,MERGED,4,33,5,2,4,310,False,0,2,2,797,37,20.93027777777778,Feature
TypeScript,85,721,297.27118055555553,MERGED,1,1,1,0,1,86,False,0,0,0,1284,2,62.65416666666667,Document
TypeScript,3392,2334,950.1249768518519,CLOSED,12,32,1,2,3,246,False,0,2,1,3203,44,2825.277777777778,Bug
V,2097,34361,1536.7779282407407,MERGED,2,13,1,0,1,0,False,0,0,0,703,15,0.6938888888888889,Document
Rust,264,5382,389.0360185185186,MERGED,1,5,1,0,1,207,True,0,0,0,1038,6,0.08416666666666667,Bug
JavaScript,8844,63474,4062.1335300925925,MERGED,0,2,2,2,4,0,False,0,2,2,1030,2,2.6438888888888887,Document
TypeScript,15,34,472.0559259259259,MERGED,9,6958,6,0,10,877,False,0,0,0,490,6967,49.60805555555555,Document
Rust,264,5382,387.9964930555555,CLOSED,1,1609,11,2,7,0,False,1,1,1,2104,1610,554.0897222222222,Feature
Vue,293,495,813.0808217592593,MERGED,1,0,1,2,1,347,False,0,2,2,551,1,20.365555555555556,Bug
TypeScript,139,827,730.0119328703704,CLOSED,0,48,1,2,1,95,False,0,2,2,1071,48,1178.5822222222223,Document
TypeScript,178,1359,306.4468634259259,MERGED,4,8,1,5,1,2,True,1,4,3,1788,12,27.206944444444446,Bug
Blade,0,0,102.11232638888889,MERGED,3,3,1,0,1,14,False,0,0,0,749,6,0.11388888888888889,Bug
TypeScript,7,6,628.9562384259259,MERGED,3,6,3,0,1,279,False,0,0,0,1006,9,0.6522222222222223,Feature
JavaScript,3618,9017,2270.87875,MERGED,21,13,2,1,3,106,False,0,1,1,1519,34,71.35222222222222,Feature
TypeScript,202,107,1128.976412037037,MERGED,4,9,3,6,3,117,True,0,6,4,1134,13,95.855,Document
TypeScript,178,1359,305.6720138888889,MERGED,3,213,6,3,6,20,True,1,2,2,1744,216,22.684722222222224,Feature
TypeScript,85,721,300.9885300925926,MERGED,5,53,2,0,2,86,False,0,0,0,2110,58,0.5686111111111111,Document
TypeScript,2147,14722,1458.0291666666665,MERGED,1,16,2,0,3,63,False,0,0,0,2399,17,0.5269444444444444,Bug
Rust,264,5382,387.0299537037037,MERGED,5,5,3,0,1,175,False,0,0,0,1097,10,0.6994444444444444,Bug
Go,421,1654,1492.9650000000001,MERGED,12,21,2,1,1,231,False,1,0,0,1285,33,46.5675,Bug
Rust,264,5382,386.8996875,MERGED,2,15,3,0,2,376,False,0,0,0,867,17,3.0411111111111113,Bug
TypeScript,261,3765,659.6905902777778,MERGED,2,167,8,0,3,248,True,0,0,0,2110,169,44.43527777777778,Document
Rust,264,5382,386.93895833333335,MERGED,1,5,1,0,1,204,True,0,0,0,783,6,0.03944444444444444,Feature
Rust,264,5382,386.91260416666665,MERGED,22,25,2,0,2,203,True,0,0,0,1124,47,0.08138888888888889,Feature
Rust,264,5382,386.8895254629629,MERGED,15,27,1,0,1,202,True,0,0,0,1011,42,0.35638888888888887,Feature
TypeScript,261,3765,660.640300925926,MERGED,4,17,4,1,2,209,True,0,1,1,1895,21,2.087222222222222,Document
JavaScript,5139,7048,1189.5950578703703,MERGED,20,77,6,2,5,87,False,0,2,2,1434,97,27.75611111111111,Bug
C++,2234,23694,2342.9530555555557,MERGED,4,4,1,3,7,14,False,0,3,3,1614,8,215.96277777777777,Feature
Vue,0,1,232.22596064814817,MERGED,0,58,1,0,1,46,False,0,0,0,75,58,0.03861111111111111,Feature
Vue,0,1,232.21552083333333,MERGED,1,23,2,0,1,45,False,0,0,0,75,24,0.04583333333333333,Feature
JavaScript,5139,7048,1188.7563888888888,MERGED,6,134,5,2,3,177,False,0,2,2,1762,140,20.023611111111112,Feature
Vue,0,1,232.08228009259258,MERGED,1,113,4,0,1,40,False,0,0,0,75,114,0.23805555555555555,Feature
Vue,0,1,232.13550925925927,MERGED,5,28,5,0,1,44,False,0,0,0,75,33,0.2336111111111111,Feature
Vue,0,1,232.09173611111112,MERGED,1,39,2,0,1,41,False,0,0,0,75,40,0.014444444444444444,Feature
Python,547,7160,2222.5252083333335,MERGED,23,39,8,0,4,251,True,0,0,0,957,62,1.1891666666666667,Document
TypeScript,2147,14722,1456.0755902777776,MERGED,9,9,2,0,1,71,False,0,0,0,2001,18,0.13527777777777777,Bug
TypeScript,261,3765,658.5040972222222,MERGED,12,116,7,0,1,841,True,0,0,0,2351,128,23.874444444444446,Document
TypeScript,261,3765,657.8884375,MERGED,4,11,3,0,4,0,False,0,0,0,2001,15,39.812222222222225,Document
TypeScript,7,6,629.1216782407407,CLOSED,6,75,2,0,8,214,False,0,0,0,2318,81,383.15194444444444,Feature
TypeScript,15,34,471.56665509259255,MERGED,0,3,1,0,2,42,False,0,0,0,684,3,0.38055555555555554,Feature
Rust,417,2801,907.2738773148149,MERGED,0,2,1,0,1,11,False,0,0,0,248,2,17.293333333333333,Document
TypeScript,15,34,471.386412037037,MERGED,1,7,1,0,3,462,True,0,0,0,863,8,1.2005555555555556,Feature
Vue,293,495,814.9752662037037,MERGED,4,5,1,4,2,150,True,0,4,4,1347,9,217.5186111111111,Document
Vue,0,1,230.0799884259259,MERGED,2,3,1,0,1,3,False,0,0,0,75,5,7.091111111111111,Feature
TypeScript,3392,2334,953.2374421296296,MERGED,0,26,2,1,1,291,False,0,1,1,226,26,0.2847222222222222,Feature
TypeScript,3392,2334,953.1596990740741,MERGED,0,16,1,1,4,290,False,0,1,1,226,16,1.8997222222222223,Feature
Vue,293,495,815.3249074074074,MERGED,2,4,2,3,4,151,True,0,3,2,1430,6,177.02555555555554,Bug
TypeScript,178,1359,307.64434027777776,MERGED,4,257,5,1,10,3,True,0,1,1,3120,261,34.44083333333333,Feature
Java,450,746,4054.2902546296295,MERGED,22,8,2,1,1,371,True,0,1,1,92,30,65.31583333333333,Feature
Blade,0,0,101.12982638888889,MERGED,3,3,3,0,1,6,False,0,0,0,1005,6,14.867777777777778,Feature
Vue,0,1,229.30027777777778,MERGED,1,10,1,0,10,2,False,0,0,0,75,11,14.777222222222223,Feature
Vue,0,1,228.4896412037037,MERGED,1,21,1,0,6,3,False,0,0,0,75,22,34.21666666666667,Feature
Blade,0,0,100.95003472222221,CLOSED,1,4,2,2,1,13,False,0,2,2,937,5,4.326388888888889,Feature
Vue,293,495,814.4649652777779,CLOSED,1,0,1,7,2,248,True,2,5,4,1457,1,171.70166666666665,Bug
TypeScript,3392,2334,952.0911689814815,MERGED,1,1,1,1,1,654,False,0,1,1,226,2,0.22166666666666668,Feature
TypeScript,3392,2334,952.0453125,MERGED,0,16,1,1,1,285,False,0,1,1,226,16,0.3863888888888889,Feature
TypeScript,3392,2334,952.0223032407407,MERGED,0,9,1,1,1,652,False,0,1,1,226,9,0.21472222222222223,Feature
Rust,433,2229,221.66180555555556,MERGED,3,5,1,1,1,699,False,0,1,1,212,8,2.443611111111111,Bug
Go,395,660,1250.1682175925926,MERGED,26,30,8,0,1,69,False,0,0,0,371,56,262.43611111111113,Feature
Rust,264,5382,389.1395370370371,MERGED,1,26,6,1,9,131,False,0,1,1,1246,27,2.7769444444444447,Document
Go,395,660,1250.1433217592592,CLOSED,18,29,1,3,1,67,False,1,2,1,269,47,212.81083333333333,Feature
TypeScript,2147,14722,1458.1947916666668,MERGED,12,53,6,0,9,68,False,0,0,0,3187,65,16.121944444444445,Feature
TypeScript,178,1359,306.2854861111111,MERGED,31,32,2,4,2,21,True,1,3,2,2448,63,6.423611111111111,Document
Rust,264,5382,388.0126157407407,MERGED,18,41,5,0,3,8,False,0,0,0,1227,59,24.662777777777777,Bug
Python,547,7160,2220.1011574074073,MERGED,5,16,4,0,12,104,False,0,0,0,437,21,345.15222222222224,Feature
Rust,264,5382,388.1741898148148,MERGED,24,81,3,0,3,206,True,0,0,0,1729,105,14.681944444444444,Feature
Rust,264,5382,388.2056018518519,MERGED,21,46,3,0,1,254,True,0,0,0,1251,67,13.395833333333334,Feature
Rust,417,2801,907.2628356481482,MERGED,10,7,3,1,3,203,False,0,1,1,1457,17,26.039166666666667,Document
Python,547,7160,2219.7189351851853,CLOSED,246,542,35,0,28,101,False,0,0,0,523,788,354.4836111111111,Bug
TypeScript,261,3765,661.7274537037036,MERGED,4,20,6,0,1,846,True,0,0,0,2821,24,0.5305555555555556,Document
Go,182,37,1692.1155555555554,MERGED,120,5635,45,3,13,434,False,2,1,1,4908,5755,693.9325,Document
TypeScript,7,6,628.9841550925926,MERGED,7,29,1,1,4,280,False,0,1,1,1731,36,0.4027777777777778,Bug
Python,19248,70257,2443.474247685185,CLOSED,4,7,4,1,1,125,False,1,0,0,1754,11,37.2325,Bug
Rust,264,5382,387.9884606481482,MERGED,14,36,3,0,1,253,True,0,0,0,1627,50,0.3005555555555556,Feature
Python,19248,70257,2442.8792939814816,CLOSED,2,552,6,2,11,123,False,2,0,0,1629,554,61.76694444444445,Bug
TypeScript,15,34,471.73634259259256,MERGED,4,0,1,0,1,875,False,0,0,0,824,4,0.93,Feature
F#,153,337,2902.904270833333,MERGED,0,410,4,1,9,12,False,0,1,1,2861,410,188.97583333333333,Document
Rust,433,2229,219.49480324074077,MERGED,0,7,1,1,1,687,False,0,1,1,186,7,5.771388888888889,Bug
Go,395,660,1251.100162037037,MERGED,2,2,1,1,2,42,False,1,0,0,245,4,2.1705555555555556,Bug
C#,80,125,804.6898842592592,MERGED,883,2661,22,0,2,7,False,0,0,0,256,3544,0.04416666666666667,Bug
C#,80,125,804.6099537037038,MERGED,0,1,1,0,1,6,False,0,0,0,284,1,0.16944444444444445,Feature
TypeScript,2147,14722,1457.124837962963,MERGED,3699,114,11,0,1,657,False,0,0,0,3159,3813,5.192777777777778,Document
Go,395,660,1248.979513888889,MERGED,9,14,2,0,2,66,False,0,0,0,252,23,81.26083333333334,Feature
TypeScript,261,3765,660.5613194444444,MERGED,3,189,6,0,2,842,True,0,0,0,2794,192,1.6969444444444444,Document
Rust,264,5382,386.8467361111111,MERGED,0,6,2,0,2,128,False,0,0,0,1066,6,0.3625,Feature
Vue,293,495,814.4827546296297,MERGED,2,10,2,5,4,249,True,0,5,3,1581,12,33.25,Bug
Go,395,660,1250.2207291666666,MERGED,1,1,1,0,1,70,False,0,0,0,203,2,2.193888888888889,Feature
Vue,293,495,815.0625231481481,MERGED,0,8,1,2,1,348,False,0,2,2,1570,8,0.45694444444444443,Bug
TypeScript,202,107,1129.6015162037036,MERGED,10,10,1,4,3,250,True,0,4,4,1959,20,30.38888888888889,Document
JavaScript,3618,9017,2269.4813310185186,MERGED,6,72,5,0,4,337,False,0,0,0,2368,78,18.95722222222222,Document
TypeScript,41369,87411,2921.581215277778,MERGED,1,1,1,0,7,3,False,0,0,0,2028,2,0.4419444444444444,Document
Rust,417,2801,908.458599537037,MERGED,5,13,2,0,1,257,False,0,0,0,387,18,0.1463888888888889,Bug
TypeScript,15,34,474.3244560185185,MERGED,43,259,8,0,11,151,False,0,0,0,2418,302,333.6741666666667,Bug
Rust,433,2229,221.63003472222223,MERGED,1,11,3,1,1,696,False,0,1,1,334,12,0.6416666666666667,Bug
TypeScript,202,107,1128.1703935185185,MERGED,3,3,1,4,1,144,True,0,4,4,1381,6,54.4025,Document
Rust,433,2229,221.4252199074074,MERGED,11,15,3,1,1,692,False,0,1,1,312,26,0.9441666666666667,Feature
Java,450,746,4057.0852314814815,MERGED,78,131,7,2,6,22,False,0,2,1,1963,209,21.162777777777777,Document
Go,395,660,1247.3497800925927,MERGED,1,0,1,0,1,65,False,0,0,0,205,1,61.40777777777778,Feature
Vue,293,495,812.0035069444444,MERGED,29,59,5,11,5,23,True,3,8,5,1318,88,70.45444444444445,Bug
Go,421,1654,1495.3115277777779,MERGED,23,22,4,0,1,9,False,0,0,0,3062,45,13.2925,Bug
Go,54,353,717.0459027777778,MERGED,0,8,3,0,1,70,True,0,0,0,1568,8,15.089166666666667,Feature
JavaScript,5139,7048,1185.8008217592594,MERGED,21,195,8,2,2,0,False,0,2,2,212,216,90.68416666666667,Feature
Vue,293,495,812.1252893518518,MERGED,1,12,1,2,1,345,False,0,2,2,1439,13,43.34111111111111,Bug
Vue,293,495,812.1196180555556,MERGED,37,43,3,4,1,344,False,0,4,4,1472,80,43.46611111111111,Bug
TypeScript,15,34,475.46413194444443,MERGED,21,24,2,0,2,465,True,0,0,0,1196,45,3.6008333333333336,Feature
TypeScript,1297,21107,398.7410648148148,MERGED,1,1,1,1,2,36,False,0,1,1,1810,2,7.820277777777778,Document
TypeScript,307,2556,521.4837962962963,CLOSED,307,272,28,1,14,17,False,0,1,1,959,579,71.04416666666667,Bug
TypeScript,307,2556,522.7145833333333,MERGED,30,33,3,6,2,172,True,2,4,1,1136,63,21.036666666666665,Bug
Blade,0,0,102.15668981481481,MERGED,2,17,4,0,1,8,False,0,0,0,1552,19,0.3738888888888889,Feature
TypeScript,1297,21107,398.70445601851856,MERGED,0,1,1,1,1,1,True,0,1,1,1550,1,0.020555555555555556,Document
Go,395,660,1250.0044560185186,MERGED,33,37,4,1,3,41,False,1,0,0,354,70,45.329166666666666,Bug
TypeScript,15,34,474.40924768518516,MERGED,15,23,1,0,1,464,True,0,0,0,2026,38,28.92,Feature
Go,395,660,1247.3145254629628,MERGED,2,9,1,0,1,63,False,0,0,0,241,11,0.22916666666666666,Feature
Vue,293,495,812.0278472222222,MERGED,12,14,2,4,1,343,False,0,4,3,1439,26,2.7936111111111113,Bug
Rust,264,5382,389.04017361111113,MERGED,53,91,4,0,2,149,False,0,0,0,2086,144,0.345,Bug
PHP,1334,2960,4192.021458333334,MERGED,1,21,2,0,1,39,False,0,0,0,2762,22,0.96,Document
Vue,293,495,812.9209606481481,MERGED,59,1125,27,35,58,47,False,15,20,8,2945,1184,431.50638888888886,Bug
Rust,433,2229,218.42057870370368,MERGED,2,46,4,1,1,686,False,0,1,1,265,48,31.549444444444443,Feature
Go,395,660,1247.338576388889,MERGED,8,32,5,0,2,64,False,0,0,0,321,40,120.69055555555556,Feature
JavaScript,3618,9017,2270.6517592592595,MERGED,25,376,16,6,6,301,False,3,3,3,4438,401,100.38,Bug
Go,395,660,1250.1558333333335,MERGED,5,1,1,0,1,68,False,0,0,0,280,6,0.2275,Bug
PHP,1334,2960,4189.3223148148145,MERGED,2,15,2,0,1,81,False,0,0,0,2485,17,88.18222222222222,Document
TypeScript,15,34,473.51598379629627,MERGED,2,7,1,0,1,463,True,0,0,0,1252,9,20.664722222222224,Feature
Vue,293,495,815.1265856481482,MERGED,90,134,8,10,5,349,False,4,6,6,1859,224,66.57416666666667,Bug
Vue,293,495,814.9654166666666,MERGED,8,16,3,2,3,149,True,0,2,2,1588,24,70.4088888888889,Bug
JavaScript,8844,63474,4060.816770833333,MERGED,3,74,2,0,2,95,True,0,0,0,2030,77,34.06666666666667,Document
JavaScript,8844,63474,4061.1761574074076,MERGED,307,312,3,0,2,73,True,0,0,0,2087,619,9.490555555555556,Bug
F#,153,337,2902.0549305555555,MERGED,478,430,9,1,5,184,False,1,0,0,2228,908,18.17888888888889,Bug
Rust,264,5382,389.1403935185185,MERGED,59,412,19,14,19,0,False,6,8,1,2639,471,259.77472222222224,Feature
TypeScript,7046,76149,2610.7649652777777,MERGED,52609,24790,21,5,1,96,False,0,5,2,1173,77399,0.20194444444444445,Document
TypeScript,1297,21107,401.99774305555553,MERGED,7,268,8,1,2,873,True,0,1,1,1789,275,0.04583333333333333,Document
Java,547,304,209.04090277777777,MERGED,0,13,1,0,2,0,False,0,0,0,1464,13,0.7866666666666666,Feature
Rust,264,5382,386.80131944444446,MERGED,46,47,2,0,3,201,True,0,0,0,1754,93,0.9130555555555555,Bug
JavaScript,3618,9017,2270.7809722222223,MERGED,2,5,1,2,1,12,False,1,1,1,2065,7,0.6263888888888889,Document
V,2097,34361,1536.4494791666666,MERGED,29,214,9,0,8,168,True,0,0,0,2085,243,54.09166666666667,Bug
PHP,0,0,88.10475694444445,MERGED,30,43,5,0,1,41,True,0,0,0,2069,73,0.06972222222222223,Document
TypeScript,1416,21916,265.49053240740744,MERGED,37,47,5,3,1,51,False,0,3,3,521,84,0.18611111111111112,Feature
TypeScript,3392,2334,950.0578587962963,CLOSED,11,35,2,2,1,245,False,0,2,1,4313,46,2227.0686111111113,Feature
V,2097,34361,1535.4957523148148,MERGED,0,17,3,0,2,208,True,0,0,0,1747,17,31.3175,Document
Python,19248,70257,2444.918472222222,CLOSED,6,2,2,1,2,1556,False,1,0,0,456,8,17.764166666666668,Bug
Vue,293,495,813.0614699074075,MERGED,8,30,6,5,3,346,False,0,5,5,1865,38,20.932222222222222,Bug
TypeScript,261,3765,661.7079629629629,MERGED,13,785,23,0,6,150,False,0,0,0,4401,798,18.05611111111111,Document
TypeScript,41369,87411,2922.8093981481484,MERGED,7,6,1,0,1,0,False,0,0,0,2087,13,3.5241666666666664,Document
TypeScript,178,1359,304.8022222222222,MERGED,102,198,6,1,9,12,True,0,1,1,4303,300,44.1025,Bug
TypeScript,307,2556,521.8954861111112,MERGED,5,8,1,3,2,18,False,1,2,1,1289,13,37.369166666666665,Bug
TypeScript,1297,21107,398.74,MERGED,3,9,1,1,1,859,True,0,1,1,1920,12,0.009444444444444445,Document
TypeScript,41369,87411,2922.1224421296297,MERGED,2,2,2,0,1,6,False,0,0,0,2183,4,4.548055555555556,Document
TypeScript,15,34,474.57762731481483,MERGED,25,231,3,0,2,300,False,0,0,0,2472,256,11.979166666666666,Feature
TypeScript,17,33,701.0223148148148,MERGED,36,155,6,1,3,27,False,0,1,1,410,191,69.70388888888888,Feature
Vue,293,495,813.1474189814816,MERGED,1054,1532,39,6,56,329,True,1,5,3,659,2586,42.115,Bug
TypeScript,2071,16638,1225.289699074074,MERGED,4,6,1,0,1,2,False,0,0,0,2848,10,225.83416666666668,Bug
TypeScript,41369,87411,2919.643368055555,CLOSED,0,75,1,5,4,68,True,2,3,3,4567,75,1596.9025,Document
TypeScript,41369,87411,2920.7583449074077,MERGED,0,3,1,0,2,1559,True,0,0,0,2042,3,3.0308333333333333,Document
TypeScript,41369,87411,2921.6647337962963,MERGED,1,1,1,0,1,540,True,0,0,0,2012,2,1.0238888888888888,Document
C#,80,125,804.6306828703704,MERGED,2,6,2,0,2,194,False,0,0,0,684,8,1.4066666666666667,Document
TypeScript,261,3765,660.6671296296296,MERGED,12,22,5,0,1,564,True,0,0,0,4103,34,0.5011111111111111,Document
TypeScript,261,3765,660.5219097222222,MERGED,87,17,8,0,2,137,True,0,0,0,3369,104,0.5044444444444445,Document
TypeScript,41369,87411,2921.1364467592593,MERGED,4,20,2,0,1,1,False,0,0,0,2126,24,7.373888888888889,Document
TypeScript,85,721,297.4100578703704,MERGED,1173,615,42,0,20,93,False,0,0,0,5198,1788,70.41777777777777,Document
TypeScript,307,2556,521.5009027777778,MERGED,1,58,2,0,1,15,False,0,0,0,1320,59,0.33555555555555555,Feature
Erlang,2054,12122,3780.9670949074075,MERGED,4,5,2,0,2,346,True,0,0,0,1176,9,579.3666666666667,Document
TypeScript,15,34,474.5591782407407,MERGED,7008,152,17,0,29,879,False,0,0,0,531,7160,28.745833333333334,Document
TypeScript,41369,87411,2920.9516898148145,MERGED,6,5,1,0,1,1,False,0,0,0,2107,11,1.183888888888889,Document
TypeScript,261,3765,659.6552083333333,MERGED,21,342,14,0,2,146,False,0,0,0,3544,363,0.385,Document
TypeScript,41369,87411,2920.446608796296,MERGED,399,385,3,0,2,388,True,0,0,0,2214,784,1.0438888888888889,Document
PHP,1334,2960,4193.177951388889,MERGED,1,60,7,0,7,70,False,0,0,0,3255,61,22.4,Document
Python,547,7160,2219.6613425925925,MERGED,174,570,38,0,12,11,False,0,0,0,617,744,7.618611111111111,Feature
TypeScript,7,6,629.2055555555555,CLOSED,861,1949,42,0,41,243,False,0,0,0,14216,2810,2375.9661111111113,Document
Python,72,25,1620.677037037037,MERGED,0,397,10,5,3,23,False,3,2,1,3094,397,68.47027777777778,Bug
Go,421,1654,1492.1776736111112,MERGED,99,192,3,0,3,410,True,0,0,0,3682,291,65.29611111111112,Bug
Rust,264,5382,387.91024305555555,MERGED,66,95,7,0,3,252,True,0,0,0,2440,161,0.59,Feature
Erlang,2054,12122,3777.183680555556,MERGED,60,10,9,1,1,976,True,1,0,0,1088,70,605.8305555555555,Document
Erlang,2054,12122,3781.1567129629634,MERGED,1,1,1,0,1,305,False,0,0,0,912,2,3.352222222222222,Document
Java,547,304,211.29042824074074,MERGED,0,18,1,0,1,0,False,0,0,0,1980,18,51.954166666666666,Document
Java,547,304,212.84537037037038,MERGED,0,3,1,0,6,504,False,0,0,0,1909,3,45.43083333333333,Document
Java,547,304,212.75841435185183,MERGED,0,58,1,1,1,1,False,1,0,0,1975,58,16.5475,Document
JavaScript,8844,63474,4060.6925347222223,MERGED,15,144,3,0,1,94,True,0,0,0,3464,159,14.097222222222221,Document
Java,547,304,209.70028935185186,MERGED,0,10,1,0,1,0,False,0,0,0,1917,10,10.861666666666666,Document
C#,80,125,804.5635300925925,MERGED,1042,4662,132,0,12,63,False,0,0,0,795,5704,95.00555555555556,Document
Java,547,304,209.23976851851853,MERGED,0,21,1,0,2,0,False,0,0,0,1741,21,13.119166666666667,Document
Python,24585,55554,4633.208356481481,MERGED,12,24,2,0,1,331,True,0,0,0,799,36,71.07833333333333,Bug
TypeScript,149,2900,364.96010416666667,MERGED,7,7,3,1,1,81,False,0,1,1,951,14,0.016944444444444446,Bug
TypeScript,202,107,1128.9443055555555,MERGED,102,12,2,5,3,116,True,1,4,4,3320,114,45.57888888888889,Document
TypeScript,149,2900,364.8950347222222,MERGED,1,1,1,1,1,79,False,0,1,1,896,2,0.059722222222222225,Bug
JavaScript,5139,7048,1188.5951041666667,MERGED,21,785,15,2,3,51,False,0,2,2,5304,806,19.865833333333335,Feature
TypeScript,202,107,1128.4520949074074,MERGED,21,24,2,4,2,249,True,0,4,4,3620,45,58.25972222222222,Document
TypeScript,202,107,1129.7539351851851,CLOSED,3,64,3,4,1,251,True,0,4,4,3156,67,4.383611111111111,Document
Starlark,440,286,472.8863773148148,MERGED,131,538,1,0,5,6,False,0,0,0,1367,669,26.72388888888889,Feature
TypeScript,202,107,1128.2261458333335,MERGED,75,161,2,5,4,145,True,1,4,4,3478,236,53.0575,Document
TypeScript,1297,21107,399.9761458333333,MERGED,17,49,2,1,1,869,True,0,1,1,2654,66,0.01,Document
Python,547,7160,2219.8655902777778,MERGED,6,23,1,0,6,103,False,0,0,0,879,29,114.46583333333334,Feature
TypeScript,4,33,747.4817361111112,MERGED,4,8,3,2,2,584,True,1,1,1,967,12,1.363888888888889,Bug
Python,547,7160,2221.4811689814815,MERGED,23,13,3,0,9,219,False,0,0,0,835,36,46.096111111111114,Bug
TypeScript,1297,21107,399.6995601851852,MERGED,1,3,1,2,1,37,False,1,1,1,2509,4,0.5294444444444445,Document
TypeScript,41369,87411,2922.955972222222,MERGED,0,322,2,0,1,1560,True,0,0,0,2447,322,12.01,Document
F#,153,337,2900.800416666667,MERGED,168,214,3,1,1,11,False,0,1,1,4460,382,0.6819444444444445,Document
Python,547,7160,2220.9831481481483,MERGED,17,14,9,0,3,110,False,0,0,0,1012,31,37.92944444444444,Bug
TypeScript,41369,87411,2922.9489236111112,MERGED,5,3,2,0,1,1890,True,0,0,0,2797,8,0.49,Document
TypeScript,3392,2334,950.1362037037037,MERGED,1,0,1,2,1,0,False,0,2,1,1037,1,43.83,Feature
TypeScript,1297,21107,398.4363425925926,MERGED,59,55,3,1,1,856,True,0,1,1,2953,114,0.15138888888888888,Document
TypeScript,41369,87411,2921.4312037037034,MERGED,0,1,1,0,1,0,False,0,0,0,2237,1,24.576944444444443,Document
TypeScript,307,2556,521.459363425926,MERGED,3,1,1,0,1,16,False,0,0,0,1754,4,33.3725,Bug
Rust,264,5382,387.37611111111113,CLOSED,125,1116,25,0,1,251,True,0,0,0,6890,1241,740.9591666666666,Bug
TypeScript,41369,87411,2921.44306712963,MERGED,5,160,6,8,1,2,False,1,7,2,3010,165,0.22277777777777777,Document
TypeScript,41369,87411,2920.860277777778,CLOSED,0,16,1,0,1,0,False,0,0,0,2339,16,20.9325,Document
TypeScript,41369,87411,2920.707395833333,MERGED,1,23,3,1,4,565,True,0,1,1,2946,24,5.945277777777778,Document
Starlark,440,286,474.60475694444443,MERGED,0,75,2,2,2,0,False,1,1,1,1554,75,244.89777777777778,Feature
TypeScript,4,33,744.2866898148148,MERGED,1,1,1,2,2,579,True,1,1,1,889,2,0.45055555555555554,Feature
JavaScript,9664,43889,3639.1282870370374,MERGED,7,12,3,0,1,50,True,0,0,0,704,19,0.058055555555555555,Feature
JavaScript,9664,43889,3639.085162037037,MERGED,75,66,10,0,2,615,False,0,0,0,802,141,1.2630555555555556,Feature
TypeScript,41369,87411,2919.9447453703706,MERGED,2,1,1,0,1,69,True,0,0,0,2410,3,10.789444444444445,Document
TypeScript,41369,87411,2918.9343750000003,MERGED,0,2,1,0,1,44,False,0,0,0,2398,2,35.05388888888889,Document
TypeScript,41369,87411,2919.6735532407406,MERGED,4,4,1,0,1,387,True,0,0,0,2309,8,1.1783333333333332,Document
TypeScript,2071,16638,1227.3662731481481,MERGED,1,24,2,3,5,0,False,2,1,1,3250,25,175.94861111111112,Bug
TypeScript,2071,16638,1228.100162037037,MERGED,1,26,2,0,2,0,False,0,0,0,3042,27,158.0888888888889,Bug
Vue,293,495,813.8910069444445,MERGED,66,71,11,14,18,24,True,4,10,5,3237,137,286.5422222222222,Bug
Python,547,7160,2220.7009953703705,MERGED,50,35,6,0,29,107,False,0,0,0,1352,85,320.9483333333333,Bug
Python,547,7160,2220.622013888889,MERGED,198,271,20,0,51,106,False,0,0,0,1371,469,322.4888888888889,Bug
TypeScript,178,1359,307.37385416666666,MERGED,7,64,6,2,15,2,True,0,2,2,7596,71,33.400555555555556,Bug
Rust,264,5382,389.0355324074074,MERGED,1578,51,8,1,1,67,True,1,0,0,3343,1629,45.234722222222224,Bug
TypeScript,2147,14722,1458.1673726851852,MERGED,12,89,6,0,1,64,False,0,0,0,6366,101,0.07472222222222222,Document
TypeScript,2071,16638,1228.1128356481481,CLOSED,103,156,1,0,1,0,False,0,0,0,3412,259,41.363055555555555,Bug
TypeScript,7,6,629.1093287037037,MERGED,54,127,6,0,14,213,False,0,0,0,5422,181,48.65777777777778,Feature
Python,142,422,2390.8898842592594,MERGED,0,83,8,2,7,107,False,0,2,1,5109,83,26.685833333333335,Feature
Erlang,2054,12122,3781.06880787037,MERGED,145,382,11,0,6,977,True,0,0,0,1344,527,29.295555555555556,Document
Starlark,440,286,472.142037037037,MERGED,36,111,1,0,2,3,False,0,0,0,1595,147,134.59722222222223,Bug
Starlark,440,286,472.045162037037,MERGED,0,141,2,2,1,0,False,2,0,0,1693,141,136.90527777777777,Feature
Erlang,2054,12122,3781.0011921296295,MERGED,3,6,4,0,1,343,True,0,0,0,1131,9,19.84027777777778,Document
Rust,264,5382,388.95337962962964,MERGED,29,64,7,0,1,380,False,0,0,0,3414,93,0.6794444444444444,Feature
Erlang,2054,12122,3780.325115740741,CLOSED,0,1,1,1,1,302,False,1,0,0,1035,1,42.54638888888889,Document
Erlang,2054,12122,3781.1124999999997,MERGED,0,116,1,0,1,76,False,0,0,0,1177,116,4.114444444444445,Document
Erlang,2054,12122,3780.1525231481482,MERGED,2,2,2,0,2,479,True,0,0,0,1056,4,41.15222222222222,Document
Erlang,2054,12122,3781.085590277778,MERGED,4,7,2,0,1,304,False,0,0,0,1065,11,1.568888888888889,Document
TypeScript,2147,14722,1456.8478472222223,MERGED,73,44,7,0,1,43,False,0,0,0,5116,117,3.171111111111111,Feature
Erlang,2054,12122,3780.9303935185185,MERGED,46,63,2,0,1,345,True,0,0,0,1605,109,1.9722222222222223,Document
Erlang,2054,12122,3780.307986111111,MERGED,2,2,2,0,1,301,False,0,0,0,1071,4,25.071944444444444,Document
JavaScript,8844,63474,4061.357905092593,MERGED,44,110,3,0,1,74,True,0,0,0,5055,154,49.93527777777778,Bug
Starlark,440,286,474.75497685185184,MERGED,1,1,1,0,2,64,False,0,0,0,1219,2,0.1675,Feature
Erlang,2054,12122,3780.3469328703704,MERGED,1,4,1,0,1,303,False,0,0,0,1146,5,18.11111111111111,Document
Java,547,304,212.5348263888889,MERGED,0,6,1,0,3,0,False,0,0,0,2435,6,21.86638888888889,Document
Rust,264,5382,388.17922453703704,MERGED,113,149,99,0,2,0,False,0,0,0,4969,262,0.6919444444444445,Feature
Erlang,2054,12122,3778.723553240741,MERGED,0,8,4,0,1,478,True,0,0,0,1245,8,75.88111111111111,Document
Starlark,440,286,474.0779166666667,MERGED,4,35,1,0,1,2,False,0,0,0,1579,39,16.530277777777776,Bug
Java,547,304,211.6867939814815,MERGED,0,10,1,0,4,503,False,0,0,0,2171,10,73.20472222222222,Document
PHP,0,0,90.16695601851852,MERGED,75,152,5,0,5,43,True,0,0,0,3303,227,0.43944444444444447,Document
Starlark,440,286,473.69674768518513,MERGED,2,24,1,2,4,14,False,1,1,1,1423,26,26.219444444444445,Document
Erlang,2054,12122,3780.314537037037,MERGED,3,15,4,0,1,13,False,0,0,0,1428,18,2.0855555555555556,Document
Erlang,2054,12122,3779.858263888889,MERGED,2,4,3,0,2,340,True,0,0,0,1250,6,20.091944444444444,Document
Erlang,2054,12122,3779.9212268518518,MERGED,2,0,1,0,1,341,True,0,0,0,1114,2,17.52027777777778,Document
TypeScript,2071,16638,1226.0953703703703,CLOSED,0,249,4,1,1,0,False,0,1,1,3747,249,26.940277777777776,Document
Java,547,304,210.6537847222222,MERGED,0,14,1,0,1,1,False,0,0,0,2463,14,11.32611111111111,Document
Java,547,304,210.9037037037037,MERGED,0,15,1,0,3,0,False,0,0,0,2082,15,61.24638888888889,Document
Java,547,304,210.54386574074076,MERGED,12,17,1,0,1,2,False,0,0,0,2812,29,0.0661111111111111,Document
Java,547,304,210.5358449074074,MERGED,0,18,1,0,2,0,False,0,0,0,2567,18,2.2125,Document
HTML,11809,87634,138.82342592592593,CLOSED,0,4,2,1,2,1,False,1,0,0,1077,4,9.251944444444444,Feature
Java,547,304,212.90596064814815,MERGED,0,15,1,0,6,505,False,0,0,0,2603,15,44.06805555555555,Document
Erlang,2054,12122,3779.835833333333,MERGED,17,13,2,0,2,341,True,0,0,0,1167,30,7.886111111111111,Document
Erlang,2054,12122,3780.0039814814813,MERGED,1,3,3,0,2,343,True,0,0,0,1083,4,0.6205555555555555,Document
Erlang,2054,12122,3779.974849537037,MERGED,3,9,2,1,1,342,True,1,0,0,1175,12,1.373888888888889,Document
Rust,264,5382,387.2297222222223,MERGED,3272,3368,115,0,2,377,False,0,0,0,4448,6640,12.974722222222223,Bug
Java,547,304,210.0305439814815,MERGED,0,16,1,0,1,1,False,0,0,0,2092,16,3.1591666666666667,Document
Java,547,304,212.11527777777778,MERGED,0,33,1,0,5,8,False,0,0,0,2234,33,62.93194444444445,Document
Java,547,304,211.40961805555557,MERGED,0,19,1,0,1,0,False,0,0,0,2284,19,4.828888888888889,Document
HTML,11809,87634,138.4399189814815,CLOSED,0,4,2,0,2,0,False,0,0,0,1067,4,9.01,Feature
Java,547,304,209.00677083333335,MERGED,0,5,1,1,4,0,False,1,0,0,2234,5,106.79,Document
Erlang,2054,12122,3778.8992013888887,MERGED,5,1,1,0,1,339,True,0,0,0,1237,6,28.5575,Document
TypeScript,261,3765,660.7040509259259,MERGED,22,63,5,0,3,147,False,0,0,0,5826,85,0.48277777777777775,Document
TypeScript,202,107,1129.7750810185184,MERGED,47,119,9,8,12,252,True,0,8,5,4189,166,26.474444444444444,Document
Java,547,304,211.1559953703704,MERGED,0,7,1,0,7,502,False,0,0,0,2920,7,85.93083333333334,Document
TypeScript,3392,2334,953.2951504629629,CLOSED,1,1,1,3,1,250,False,0,3,2,1337,2,0.5769444444444445,Feature
Erlang,2054,12122,3778.910671296296,MERGED,12,20,4,0,2,225,True,0,0,0,1252,32,2.3513888888888888,Document
Erlang,2054,12122,3778.884085648148,MERGED,2,8,1,0,1,338,True,0,0,0,1126,10,2.8294444444444444,Document
TypeScript,3392,2334,950.1429398148148,MERGED,3,3,3,2,1,0,False,0,2,1,1834,6,41.640277777777776,Document
Vue,0,1,232.11503472222225,MERGED,1,99,2,0,1,43,False,0,0,0,1135,100,0.06833333333333333,Bug
Vue,0,1,232.1006134259259,MERGED,12,38,2,0,1,42,False,0,0,0,1431,50,0.39694444444444443,Bug
Starlark,440,286,472.85475694444443,MERGED,2,2,1,0,1,63,False,0,0,0,1132,4,0.0125,Feature
Starlark,440,286,472.8489583333333,MERGED,2,2,1,0,1,62,False,0,0,0,1044,4,0.06472222222222222,Bug
Python,137,75,666.9820949074074,MERGED,0,96,5,0,3,10,False,0,0,0,1724,96,8.551111111111112,Document
TypeScript,3392,2334,952.0899305555555,MERGED,1,21,1,1,1,653,False,0,1,1,1793,22,0.24638888888888888,Feature
C#,80,125,801.6878587962964,MERGED,176,3344,35,0,16,166,False,0,0,0,1166,3520,144.54083333333332,Document
Python,547,7160,2219.701365740741,MERGED,61,63,17,1,17,100,False,0,1,1,1314,124,117.94388888888889,Bug
Erlang,2054,12122,3779.762476851852,MERGED,0,37,2,0,1,339,True,0,0,0,1537,37,290.0541666666667,Document
C,5529,39701,42.7347337962963,MERGED,156,808,8,15,8,4,False,7,8,6,4196,964,160.9777777777778,Feature
C#,80,125,801.991574074074,MERGED,49,1455,45,0,16,192,True,0,0,0,2050,1504,117.21527777777777,Document
JavaScript,34,25,182.16731481481483,MERGED,1,1,1,0,1,31,False,0,0,0,1353,2,0.12694444444444444,Bug
Go,54,353,717.0547916666666,MERGED,1,2,2,1,1,71,True,0,1,1,3266,3,13.800555555555556,Document
TypeScript,3392,2334,950.9090046296296,MERGED,827,285,8,1,1,649,False,0,1,1,1901,1112,23.99361111111111,Feature
TypeScript,3392,2334,950.9088657407407,MERGED,2,0,1,1,1,648,False,0,1,1,1424,2,23.25111111111111,Feature
JavaScript,34,25,181.71546296296296,MERGED,1,118,4,1,6,30,False,0,1,1,1357,119,10.701944444444445,Document
TypeScript,3392,2334,950.2837268518518,MERGED,1,1,1,2,1,247,False,0,2,1,1500,2,40.300555555555555,Feature
V,2097,34361,1536.5673032407406,MERGED,18,51,4,1,6,25,True,1,0,0,3517,69,5.754166666666666,Document
Starlark,440,286,471.8124421296296,MERGED,2,2,1,0,3,61,False,0,0,0,1179,4,2.5194444444444444,Feature
HTML,118,8,55.05896990740741,MERGED,0,2,1,0,1,15,True,0,0,0,1083,2,0.03,Feature
HTML,118,8,55.05293981481481,MERGED,0,1134,5,0,4,14,True,0,0,0,1425,1134,0.03138888888888889,Bug
TypeScript,1297,21107,398.3570833333333,CLOSED,1,1,1,2,1,0,False,0,2,2,1351,2,38.234722222222224,Document
TypeScript,1297,21107,399.8988541666667,MERGED,37,28,5,1,1,868,True,0,1,1,4097,65,0.18388888888888888,Document
TypeScript,261,3765,659.5003125,MERGED,7,20,6,0,2,168,False,0,0,0,2400,27,0.31833333333333336,Document
TypeScript,4,33,744.4221643518518,MERGED,0,8,1,2,3,581,True,1,1,1,1200,8,76.25583333333333,Document
TypeScript,4,33,744.4110185185185,MERGED,1,5,1,2,3,580,True,1,1,1,1198,6,76.39166666666667,Feature
TypeScript,1297,21107,399.8032407407407,MERGED,55,72,4,2,2,867,True,0,2,2,4426,127,0.04527777777777778,Document
V,2097,34361,1535.2773263888887,MERGED,114,131,3,3,2,24,True,3,0,0,3334,245,23.079166666666666,Document
C#,80,125,801.7149189814814,MERGED,3334,29976,276,0,34,167,False,0,0,0,1094,33310,72.98805555555556,Document
TypeScript,41369,87411,2921.6791435185187,MERGED,0,34,4,5,4,4,False,3,2,2,3135,34,18.220555555555556,Document
TypeScript,139,827,731.2986226851853,MERGED,0,11,1,2,1,96,False,0,2,2,1581,11,17.579444444444444,Document
C#,80,125,801.6265509259259,CLOSED,0,5,1,1,1,208,False,1,0,0,960,5,66.95305555555555,Document
TypeScript,1297,21107,398.9502430555556,MERGED,20,100,2,1,1,861,True,0,1,1,3456,120,0.0675,Document
TypeScript,41369,87411,2922.0754398148147,MERGED,0,13,2,2,5,5,False,1,1,1,3609,13,14.016111111111112,Document
TypeScript,41369,87411,2921.9523148148146,MERGED,19,65,4,4,1,64,True,2,2,1,3186,84,11.50388888888889,Document
TypeScript,4,33,744.6622916666666,MERGED,0,4,1,2,1,582,True,1,1,1,1189,4,0.04805555555555555,Document
TypeScript,85,721,297.2632986111111,CLOSED,98,341,11,0,39,92,False,0,0,0,11693,439,71.95833333333333,Document
JavaScript,34,25,179.3375,MERGED,2,5,1,1,2,0,False,0,1,1,1704,7,11.099722222222223,Bug
Python,547,7160,2219.8552662037036,CLOSED,1,32,8,0,3,102,False,0,0,0,1615,33,329.3905555555556,Bug
Vue,0,1,228.48328703703703,MERGED,0,5,1,0,3,2,False,0,0,0,1112,5,0.11666666666666667,Feature
Vue,0,1,228.40958333333333,MERGED,1,134,5,0,2,163,True,0,0,0,1567,135,0.4822222222222222,Feature
JavaScript,34,25,179.14578703703705,MERGED,61,1,2,0,1,29,False,0,0,0,1080,62,0.06055555555555556,Bug
Python,547,7160,2220.5349768518518,MERGED,5,184,3,0,25,105,False,0,0,0,1842,189,246.9225,Bug
TypeScript,41369,87411,2919.652083333333,MERGED,3,51,2,0,1,45,False,0,0,0,3014,54,28.718055555555555,Document
Starlark,440,286,475.6486574074074,MERGED,2,5,2,0,2,44,False,0,0,0,1801,7,50.73916666666667,Document
Starlark,440,286,474.862650462963,MERGED,5,5,2,0,2,6,False,0,0,0,1624,10,69.60916666666667,Bug
Erlang,2054,12122,3780.2324421296294,MERGED,14,1495,32,0,2,2,False,0,0,0,1511,1509,75.3825,Document
Starlark,440,286,471.74703703703705,MERGED,0,246,2,1,5,0,False,1,0,0,2085,246,144.0011111111111,Feature
Python,137,75,669.9621180555556,MERGED,0,15,6,0,1,211,False,0,0,0,2223,15,0.25583333333333336,Document
Starlark,440,286,473.6771527777778,MERGED,0,11,1,3,1,0,False,1,2,2,1733,11,26.155833333333334,Feature
Go,789,5551,1024.7936921296296,MERGED,4,1,2,1,1,22,False,1,0,0,2353,5,0.6838888888888889,Document
Erlang,2054,12122,3779.005625,MERGED,109,159,7,0,2,340,True,0,0,0,1835,268,39.45388888888889,Document
TypeScript,3392,2334,952.3012268518519,CLOSED,4127,1290,138,3,3,248,False,0,3,2,2877,5417,527.8025,Bug
Starlark,440,286,472.6510416666667,MERGED,1,1,1,3,1,0,False,1,2,2,1494,2,51.25666666666667,Feature
Starlark,440,286,474.07193287037035,CLOSED,5,39,1,0,1,1,False,0,0,0,2031,44,0.02722222222222222,Bug
Erlang,2054,12122,3778.901527777778,MERGED,3,19,3,1,4,337,True,1,0,0,1652,22,25.336666666666666,Document
TypeScript,85,721,301.14640046296296,MERGED,105,157,7,0,3,87,False,0,0,0,9150,262,0.8447222222222223,Document
C++,2234,23694,2341.908229166667,CLOSED,138,382,48,2,93,1,False,1,1,1,2507,520,429.41277777777776,Document
TypeScript,3392,2334,953.0992361111112,MERGED,1,33,3,1,3,288,False,0,1,1,1862,34,3.155,Feature
Vue,0,1,232.05706018518518,MERGED,1,77,3,0,4,28,False,0,0,0,2204,78,0.48388888888888887,Feature
Vue,293,495,814.8952430555555,CLOSED,3445,6197,249,4,616,337,True,0,4,3,1574,9642,0.1288888888888889,Feature
Starlark,440,286,472.4480324074074,CLOSED,0,109,3,2,5,0,False,2,0,0,1898,109,0.8222222222222222,Document
Vue,0,1,231.1691435185185,MERGED,2,137,8,0,1,171,True,0,0,0,2192,139,4.022777777777778,Bug
TypeScript,4,33,746.2775347222222,MERGED,169,672,28,1,5,373,True,0,1,1,2138,841,28.966944444444444,Bug
TypeScript,3392,2334,951.9227662037038,MERGED,10,52,5,1,2,651,False,0,1,1,1951,62,1.1075,Feature
HTML,118,8,55.35471064814815,MERGED,2,122,1,0,3,18,True,0,0,0,1577,124,0.04472222222222222,Feature
Python,14532,41181,1070.459212962963,MERGED,1,1,1,1,1,4,False,0,1,1,1802,2,1.2972222222222223,Bug
TypeScript,4,33,744.1984027777777,MERGED,3028,2112,68,2,4,578,True,1,1,1,2194,5140,81.39083333333333,Bug
Java,450,746,4054.1673726851855,MERGED,6,3,4,1,2,370,True,0,1,1,1965,9,0.9655555555555555,Feature
Java,547,304,210.2263425925926,MERGED,5,69,5,0,6,0,False,0,0,0,3565,74,108.175,Document
Java,547,304,212.09413194444446,MERGED,0,26,1,0,2,7,False,0,0,0,2944,26,32.65361111111111,Document
Rust,264,5382,387.0236458333333,MERGED,116,337,16,2,23,6,False,0,2,1,5610,453,95.35694444444445,Bug
Starlark,440,286,474.04583333333335,MERGED,0,458,4,0,3,2,False,0,0,0,2795,458,88.97555555555556,Document
Java,547,304,212.13357638888888,MERGED,0,74,2,0,5,0,True,0,0,0,2668,74,62.75833333333333,Document
Rust,264,5382,387.77024305555557,MERGED,1,868,12,0,2,308,False,0,0,0,7248,869,0.10805555555555556,Feature
Rust,264,5382,387.16938657407405,MERGED,85,277,25,0,5,148,False,0,0,0,7794,362,22.620277777777776,Bug
TypeScript,3989,23860,2812.529849537037,MERGED,4,82,5,1,2,168,False,0,1,1,2629,86,62.763888888888886,Feature
PHP,0,0,89.30185185185185,MERGED,322,1039,40,0,6,24,False,0,0,0,6164,1361,0.034166666666666665,Document
Python,137,75,669.7588194444444,MERGED,8,23,9,1,1,230,False,1,0,0,2416,31,1.153888888888889,Document
Rust,264,5382,385.41806712962966,MERGED,117,261,16,0,9,250,True,0,0,0,6453,378,42.82,Bug
Python,2407,12180,224.4449537037037,MERGED,13,17,2,3,4,63,True,1,2,1,2574,30,10.199444444444444,Feature
TypeScript,3392,2334,953.2901273148149,MERGED,4,12,2,2,3,249,False,0,2,1,2644,16,19.009722222222223,Bug
TypeScript,149,2900,364.9427430555556,MERGED,7,25,3,1,1,80,False,0,1,1,2789,32,0.4125,Feature
TypeScript,3392,2334,953.1161689814816,MERGED,47,46,2,1,3,662,False,0,1,1,3003,93,1.0061111111111112,Document
Vue,0,1,232.00828703703704,MERGED,3,60,9,0,1,173,True,0,0,0,2982,63,1.6697222222222223,Feature
TypeScript,4,33,747.4383217592593,MERGED,4,41,2,0,1,70,False,0,0,0,2339,45,0.010555555555555556,Document
Python,2407,12180,223.25189814814814,MERGED,80,132,8,0,13,217,True,0,0,0,2601,212,2.785833333333333,Document
Python,2407,12180,223.29641203703704,MERGED,16,62,2,0,3,218,True,0,0,0,2585,78,0.06944444444444445,Document
TypeScript,149,2900,363.9801273148148,MERGED,51,79,2,1,1,78,False,0,1,1,2426,130,0.0225,Bug
Python,137,75,666.9616319444444,MERGED,12,26,18,0,3,210,False,0,0,0,2350,38,0.1922222222222222,Document
TypeScript,139,827,733.0347222222222,MERGED,6,172,3,2,7,14,False,0,2,2,2618,178,4.006111111111111,Document
TypeScript,41369,87411,2922.774537037037,MERGED,18,12,2,0,2,1889,True,0,0,0,5161,30,5.076944444444444,Document
Vue,0,1,230.9995023148148,MERGED,22,20,4,0,2,170,True,0,0,0,2556,42,0.15805555555555556,Feature
TypeScript,42,46,752.0178125000001,MERGED,4,90,3,1,5,10,False,0,1,1,2987,94,103.38027777777778,Bug
Python,14532,41181,1070.5145717592593,MERGED,2,18,2,0,3,1406,True,0,0,0,2493,20,0.5375,Document
TypeScript,139,827,730.2322222222223,MERGED,5,151,4,2,5,13,False,0,2,2,2300,156,53.51972222222222,Document
TypeScript,202,107,1125.814699074074,MERGED,411,501,8,6,4,248,True,1,5,4,7168,912,1.8386111111111112,Document
Go,1835,11245,1710.866412037037,MERGED,342,319,17,0,2,494,False,0,0,0,3128,661,19.630555555555556,Document
Rust,264,5382,388.05511574074075,MERGED,34,1543,16,0,6,379,False,0,0,0,8110,1577,22.016111111111112,Bug
TypeScript,149,2900,364.4782523148148,CLOSED,208,306,22,2,4,169,True,1,1,1,7562,514,1224.4541666666667,Bug
Rust,264,5382,386.7545601851852,MERGED,146,308,20,1,17,307,False,1,0,0,9557,454,4.614166666666667,Bug
Rust,591,3260,533.2506481481481,MERGED,328,1884,33,1,8,180,True,1,0,0,4129,2212,19.10638888888889,Feature
Python,137,75,669.4223148148147,CLOSED,5,11,5,1,6,0,False,0,1,1,4403,16,96.97583333333333,Bug
Python,142,422,2391.0739699074074,MERGED,2,92,10,0,17,108,False,0,0,0,3346,94,42.92027777777778,Document
Rust,591,3260,533.2192939814814,MERGED,20,93,4,1,6,29,True,0,1,1,4697,113,0.5236111111111111,Document
C++,2234,23694,2342.9627199074075,CLOSED,10,99,6,1,1,296,False,1,0,0,4259,109,42.385555555555555,Feature
Go,2,11,1129.0060648148149,MERGED,25,578,11,1,4,19,False,1,0,0,4570,603,21.686666666666667,Document
Python,19248,70257,2442.8792361111114,CLOSED,235,209,100,8,4,122,False,4,4,2,6150,444,14.186388888888889,Document
Blade,0,0,102.11158564814815,MERGED,477,228,28,0,16,7,False,0,0,0,8692,705,1.0519444444444443,Bug
Go,789,5551,1024.781226851852,CLOSED,11,137,3,0,2,21,False,0,0,0,4011,148,0.02638888888888889,Document
TypeScript,3392,2334,952.1570717592593,MERGED,10,27,8,1,1,655,False,0,1,1,3563,37,0.2452777777777778,Bug
Vue,0,1,230.36876157407406,MERGED,20,234,11,0,2,169,True,0,0,0,3270,254,13.07638888888889,Feature
Python,2407,12180,221.85037037037037,MERGED,82,796,34,0,8,215,True,0,0,0,4510,878,0.3536111111111111,Document
Vue,0,1,229.21070601851852,MERGED,8,217,9,0,3,165,True,0,0,0,3403,225,16.934722222222224,Feature
Go,1835,11245,1713.5995486111112,MERGED,98,71,5,0,1,50,False,0,0,0,4059,169,54.18055555555556,Document
TypeScript,4,33,744.6327546296296,MERGED,819,819,450,1,5,150,False,0,1,1,4932,1638,0.2722222222222222,Document
Rust,433,2229,217.79596064814814,MERGED,19,16,6,1,4,80,False,0,1,1,4416,35,0.7347222222222223,Bug
Go,30,295,332.1100347222222,MERGED,153,4,17,3,2,86,True,0,3,2,16216,157,49.31361111111111,Bug
TypeScript,3392,2334,953.0628819444445,MERGED,61,173,7,1,10,287,False,0,1,1,7174,234,505.1047222222222,Bug
Python,19248,70257,2445.573599537037,CLOSED,269,50,7,0,1,64,False,0,0,0,10297,319,1.8175,Document
C++,2234,23694,2342.962777777778,MERGED,146,280,15,1,28,297,False,1,0,0,7343,426,258.56388888888887,Document
TypeScript,1297,21107,398.46118055555553,MERGED,178,854,28,2,13,857,True,0,2,2,12366,1032,5.751944444444445,Document
TypeScript,3392,2334,951.1110532407407,MERGED,301,1005,25,2,30,439,False,0,2,1,7210,1306,212.10083333333333,Feature
Rust,591,3260,532.6211111111111,MERGED,49,817,14,1,3,69,False,1,0,0,7823,866,17.872222222222224,Document
Python,2407,12180,224.66718749999998,MERGED,180,214,13,5,33,64,True,3,2,2,6883,394,85.5411111111111,Document
C++,2234,23694,2340.957673611111,CLOSED,151,253,16,1,9,295,False,0,1,1,5586,404,48.543055555555554,Bug
Starlark,440,286,475.6971296296296,MERGED,164,181,1,0,1,6,False,0,0,0,5672,345,1.6219444444444444,Bug
Vue,0,1,232.1206597222222,MERGED,73,258,14,0,4,174,True,0,0,0,6611,331,50.825,Bug
Go,1835,11245,1712.8397916666665,MERGED,346,341,14,3,5,71,False,0,3,1,5698,687,47.9275,Document
Python,2407,12180,223.994224537037,MERGED,56,150,14,1,14,220,True,1,0,0,5841,206,21.55388888888889,Document
Python,2407,12180,223.84512731481482,MERGED,26,52,10,0,13,219,True,0,0,0,5862,78,0.5272222222222223,Document
Starlark,440,286,474.02125,CLOSED,0,957,8,1,4,1,False,1,0,0,4557,957,0.1661111111111111,Document
TypeScript,3392,2334,951.0752314814814,MERGED,106,297,6,1,4,650,False,0,1,1,7996,403,19.25583333333333,Bug
Python,2407,12180,222.2144097222222,MERGED,46,46,15,0,1,216,True,0,0,0,5739,92,20.185555555555556,Document
Rust,433,2229,219.58258101851854,MERGED,88,69,18,1,1,81,False,0,1,1,6172,157,2.423611111111111,Feature
Python,2407,12180,221.81415509259259,MERGED,60,306,26,0,16,214,True,0,0,0,5356,366,0.27555555555555555,Document
Vue,0,1,229.34333333333333,MERGED,10,484,18,0,4,166,True,0,0,0,4350,494,13.7575,Bug
Python,14532,41181,1068.749050925926,MERGED,32,36,10,0,2,1405,True,0,0,0,5787,68,0.06111111111111111,Document
Vue,0,1,228.35775462962962,MERGED,30,109,13,0,1,162,True,0,0,0,4961,139,0.11222222222222222,Bug
JavaScript,8844,63474,4063.1610416666667,MERGED,172,1984,32,2,30,75,True,1,1,1,14975,2156,21.24388888888889,Bug
TypeScript,3392,2334,953.0242592592593,MERGED,1877,1306,180,1,15,659,False,0,1,1,9226,3183,167.65583333333333,Bug
Python,2407,12180,225.6711689814815,MERGED,109,2496,27,16,60,121,True,3,13,2,8320,2605,61.5175,Feature
Rust,591,3260,529.2437037037038,MERGED,34,834,8,0,3,68,False,0,0,0,9064,868,97.70333333333333,Document
Vue,0,1,231.43600694444444,MERGED,102,216,16,0,2,172,True,0,0,0,8640,318,13.042777777777777,Bug
Go,2,11,1127.9676273148148,MERGED,244,353342,24,1,29,30,False,0,1,1,13716,353586,3.2688888888888887,Bug
TypeScript,4,33,748.2732638888889,MERGED,257,276,28,0,10,190,True,0,0,0,12928,533,0.3244444444444444,Bug
Python,19248,70257,2445.725162037037,CLOSED,209,341,10,2,2,65,False,2,0,0,15329,550,49.57805555555556,Document
V,2097,34361,1539.2783680555556,MERGED,1,10,2,0,1,7,True,0,0,0,486,11,12.880833333333333,Bug
TypeScript,85,721,307.30421296296294,MERGED,4,4,2,1,6,3,False,1,0,0,1265,8,185.55916666666667,Document
JavaScript,5139,7048,1194.0023726851853,CLOSED,1,1,1,9,1,0,False,0,9,5,843,2,2078.302777777778,Bug
Python,547,7160,2226.7147685185187,CLOSED,0,2,1,0,2,118,False,0,0,0,675,2,2757.648888888889,Bug
Vue,293,495,818.7817708333333,MERGED,66,414,12,20,41,48,False,9,11,5,1776,480,658.2077777777778,Bug
C#,80,125,809.6209375,CLOSED,23,41,2,1,2,155,True,0,1,1,583,64,2639.7991666666667,Document
TypeScript,41369,87411,2923.6188425925925,MERGED,5,8,1,0,1,3,False,0,0,0,2130,13,0.39694444444444443,Document
Rust,3808,5430,434.03828703703704,CLOSED,50,169,3,2,4,461,False,1,1,1,458,219,2052.3380555555555,Feature
F#,153,337,2910.7672916666666,MERGED,19,4203,81,7,8,185,False,3,4,1,5293,4222,2620.06,Document
C#,80,125,808.4311226851852,CLOSED,36,86,2,1,3,34,False,1,0,0,880,122,769.0066666666667,Document
Python,547,7160,2226.718263888889,MERGED,20,437,9,9,26,254,True,4,5,2,1450,457,824.9283333333333,Bug
TypeScript,4705,54043,1216.5765972222223,CLOSED,14,572,3,9,5,0,False,2,7,2,342,586,1865.5091666666667,Feature
TypeScript,202,107,1131.9478935185186,MERGED,49,486,17,5,7,237,True,1,4,4,3940,535,2875.4555555555557,Bug
TypeScript,2147,14722,1460.1016782407407,MERGED,2,262,13,2,3,667,False,1,1,1,1413,264,165.92444444444445,Bug
TypeScript,85,721,302.29438657407405,MERGED,0,6,1,3,1,89,False,1,2,2,1466,6,1127.2552777777778,Document
Rust,3808,5430,432.6065972222222,CLOSED,180,4041,54,0,3,179,False,0,0,0,1066,4221,1005.5469444444444,Document
TypeScript,3392,2334,961.0950810185185,CLOSED,5055,3929,29,1,17,299,False,0,1,1,3417,8984,45.46083333333333,Bug
TypeScript,58,78,812.9820833333333,MERGED,57,158,5,4,3,114,False,2,2,2,822,215,493.5391666666667,Feature
Erlang,2054,12122,3781.3430902777777,CLOSED,43,226,11,0,1,306,False,0,0,0,1380,269,2017.0408333333332,Document
Go,182,37,1694.297175925926,MERGED,2,5,1,3,6,436,False,3,0,0,969,7,184.51333333333332,Document
TypeScript,178,1359,315.826724537037,MERGED,1,14,4,2,2,1,False,0,2,2,1024,15,23.435833333333335,Feature
JavaScript,5139,7048,1197.1839814814814,MERGED,3,6,1,2,6,52,False,1,1,1,2020,9,729.3938888888889,Document
Python,19248,70257,2447.4195717592593,CLOSED,0,51,2,2,4,99,False,1,1,1,392,51,176.07416666666666,Bug
TypeScript,85,721,304.2921180555556,MERGED,0,10,1,1,7,1,False,1,0,0,1176,10,274.1697222222222,Document
Python,19248,70257,2448.471701388889,CLOSED,2,2,2,5,1,1559,False,4,1,1,333,4,2.0372222222222223,Feature
TypeScript,178,1359,315.34938657407406,MERGED,1,1,1,2,1,3,False,0,2,2,961,2,7.855833333333333,Feature
TypeScript,2147,14722,1461.124513888889,MERGED,8,9,1,0,1,157,False,0,0,0,737,17,135.47583333333333,Feature
Go,395,660,1258.1033680555556,MERGED,235,323,10,1,6,71,False,1,0,0,572,558,308.41027777777776,Feature
Go,421,1654,1496.8911805555556,MERGED,73,104,13,1,1,10,False,1,0,0,7992,177,28.445833333333333,Bug
Python,19248,70257,2452.760300925926,CLOSED,17,23,2,1,2,1562,False,1,0,0,467,40,0.7572222222222222,Feature
C++,2234,23694,2344.9311458333336,MERGED,4,17,1,1,2,51,False,0,1,1,488,21,310.7975,Bug
Python,19248,70257,2448.0524189814814,CLOSED,0,118,4,11,14,100,False,8,3,3,487,118,691.2711111111112,Feature
Vue,293,495,823.8972916666667,MERGED,72,85,10,27,26,371,True,8,19,7,1173,157,623.9058333333334,Feature
TypeScript,85,721,307.00474537037036,MERGED,1,3,1,0,1,98,False,0,0,0,1143,4,0.18861111111111112,Document
TypeScript,178,1359,315.8209027777778,MERGED,19,32,2,4,3,7,True,1,3,2,1623,51,55.7,Feature
JavaScript,5139,7048,1190.5105439814815,MERGED,1,58,3,6,21,242,False,2,4,3,718,59,293.8255555555556,Feature
TypeScript,178,1359,311.66554398148145,MERGED,1,1,1,1,1,6,True,0,1,1,953,2,3.8944444444444444,Bug
JavaScript,5139,7048,1197.5941319444444,MERGED,1,74,2,3,4,179,False,1,2,2,920,75,118.6275,Feature
TypeScript,178,1359,310.83060185185184,MERGED,1,1,1,1,1,5,True,0,1,1,805,2,6.8575,Bug
TypeScript,178,1359,310.79877314814814,MERGED,0,2,1,2,1,4,True,0,2,2,873,2,7.591944444444445,Bug
TypeScript,7,6,636.8366087962963,CLOSED,2569,2689,106,0,28,204,False,0,0,0,835,5258,239.29833333333335,Feature
TypeScript,261,3765,669.9250925925926,MERGED,10,15,3,0,2,95,False,0,0,0,1552,25,38.00666666666667,Document
Erlang,2054,12122,3784.3861921296298,MERGED,3,41,3,2,3,131,False,0,2,1,828,44,258.08944444444444,Document
TypeScript,178,1359,310.5329976851852,MERGED,0,4,1,3,1,1,False,1,2,2,1018,4,12.10138888888889,Feature
Python,19248,70257,2453.4585069444443,CLOSED,0,4,2,5,5,1563,False,4,1,1,549,4,5.688055555555556,Document
Rust,3808,5430,428.1469328703704,MERGED,0,6,1,1,1,178,False,0,1,1,711,6,8.567777777777778,Feature
TypeScript,178,1359,310.2547800925926,MERGED,1,1,1,1,1,0,False,0,1,1,935,2,0.05583333333333333,Bug
Rust,3808,5430,430.9904513888889,MERGED,0,287,3,1,1,211,False,1,0,0,1644,287,446.61833333333334,Feature
TypeScript,2147,14722,1458.9603819444444,MERGED,1,0,1,0,1,36,False,0,0,0,646,1,0.6919444444444445,Bug
TypeScript,7,6,637.0868634259259,MERGED,18,145,2,0,18,3,True,0,0,0,935,163,193.09944444444446,Feature
TypeScript,261,3765,669.5268287037037,CLOSED,4,8,1,1,1,1,False,0,1,1,1474,12,10.263333333333334,Document
TypeScript,178,1359,309.59870370370373,MERGED,1,1,1,1,1,25,True,0,1,1,895,2,8.3075,Bug
TypeScript,7,6,637.0989351851852,MERGED,1,1,1,0,1,259,False,0,0,0,585,2,0.13472222222222222,Feature
TypeScript,178,1359,314.49724537037036,MERGED,1,12,3,3,1,0,False,0,3,3,1447,13,13.426388888888889,Bug
Go,182,37,1696.0054861111112,MERGED,0,100,1,1,5,438,False,1,0,0,1158,100,262.58694444444444,Document
TypeScript,85,721,307.0620601851852,MERGED,0,172,7,0,7,99,False,0,0,0,2428,172,266.2597222222222,Document
TypeScript,7,6,636.1785185185184,MERGED,1,1,1,0,3,2,True,0,0,0,721,2,18.22861111111111,Bug
V,2097,34361,1544.3784259259257,MERGED,3,18,5,2,2,178,True,1,1,1,445,21,7.7775,Bug
TypeScript,85,721,302.98623842592593,CLOSED,41,54,4,0,12,96,False,0,0,0,1193,95,23.495277777777776,Document
Rust,3808,5430,431.620787037037,CLOSED,86,262,13,0,4,45,False,0,0,0,6426,348,2061.231388888889,Document
JavaScript,8844,63474,4067.1642708333334,CLOSED,3,0,1,9,1,0,False,5,4,2,1858,3,5.261666666666667,Bug
TypeScript,85,721,301.38721064814814,CLOSED,7,97,5,2,9,0,False,2,0,0,3021,104,1144.8330555555556,Document
TypeScript,2147,14722,1459.986087962963,MERGED,1,2,2,0,1,66,False,0,0,0,885,3,0.39111111111111113,Feature
TypeScript,2147,14722,1459.8494675925924,MERGED,0,2,1,0,1,46,False,0,0,0,813,2,2.351111111111111,Bug
TypeScript,85,721,308.04328703703703,MERGED,2,2,1,0,1,9,False,0,0,0,1388,4,0.22583333333333333,Document
Rust,3808,5430,432.54501157407407,CLOSED,39,1,1,0,1,42,False,0,0,0,851,40,0.2086111111111111,Feature
Rust,3808,5430,432.52276620370367,MERGED,15,2,1,0,1,46,False,0,0,0,1135,17,0.6544444444444445,Feature
Go,421,1654,1496.210659722222,MERGED,5,36,2,0,1,233,False,0,0,0,1101,41,168.40555555555557,Bug
TypeScript,2147,14722,1459.2144444444446,MERGED,1,3,2,0,1,13,False,0,0,0,928,4,0.15222222222222223,Feature
TypeScript,2147,14722,1461.0811226851854,MERGED,2,2,2,1,1,156,False,1,0,0,1157,4,1.0216666666666667,Bug
TypeScript,7,6,632.9163773148148,CLOSED,596,1519,66,0,16,1,True,0,0,0,1000,2115,241.3486111111111,Feature
TypeScript,2147,14722,1458.9797337962964,MERGED,1,2,1,0,1,65,False,0,0,0,739,3,0.07361111111111111,Feature
TypeScript,261,3765,664.7617476851852,MERGED,3,9,2,6,7,0,False,2,4,1,1395,12,88.06138888888889,Document
Go,421,1654,1503.0949305555557,CLOSED,7,9,2,0,1,54,False,0,0,0,1786,16,43.92805555555555,Bug
V,2097,34361,1541.5050115740742,MERGED,0,41,2,0,1,175,True,0,0,0,508,41,22.240555555555556,Bug
TypeScript,218,1201,2920.9572800925926,MERGED,3,41,8,3,4,30,False,3,0,0,488,44,841.2466666666667,Bug
Python,547,7160,2228.8054166666666,MERGED,894,576,41,0,17,225,False,0,0,0,731,1470,43.736111111111114,Bug
JavaScript,8844,63474,4063.690474537037,MERGED,2,2,2,0,1,76,True,0,0,0,561,4,0.7072222222222222,Bug
JavaScript,5139,7048,1192.682962962963,MERGED,2,125,3,1,7,103,False,0,1,1,1199,127,312.2625,Document
PHP,1334,2960,4200.870219907408,MERGED,2,1,1,1,2,72,False,0,1,1,1427,3,5.633055555555556,Document
TypeScript,3989,23860,2821.3893981481483,MERGED,11,52,3,1,7,150,True,0,1,1,1555,63,1654.006388888889,Feature
TypeScript,261,3765,662.6250347222223,MERGED,81,91,9,0,1,48,False,0,0,0,826,172,0.2727777777777778,Document
JavaScript,5139,7048,1192.8306134259258,MERGED,22,174,7,3,5,87,False,1,2,2,1640,196,289.29055555555556,Feature
TypeScript,178,1359,310.40828703703704,MERGED,1,0,1,3,1,0,False,1,2,2,1125,1,14.443055555555556,Bug
TypeScript,178,1359,313.93310185185186,MERGED,1,5,1,4,4,7,True,1,3,2,2158,6,41.85916666666667,Feature
Python,2407,12180,227.8374537037037,CLOSED,5,12,2,29,6,1,False,3,26,7,2721,17,2240.343611111111,Document
TypeScript,58,78,813.0345486111111,MERGED,6,67,2,2,2,175,True,0,2,2,155,73,55.409166666666664,Feature
TypeScript,261,3765,662.4498263888889,MERGED,82,77,5,0,3,847,True,0,0,0,2253,159,289.2688888888889,Document
Kotlin,164,4296,396.8757986111111,MERGED,1,2,1,0,1,49,False,0,0,0,229,3,166.62444444444444,Bug
Rust,264,5382,390.9968865740741,MERGED,1,1,1,0,1,312,False,0,0,0,747,2,0.3322222222222222,Feature
Rust,264,5382,390.80586805555555,MERGED,5,10,4,0,2,61,False,0,0,0,696,15,2.1755555555555555,Bug
Rust,3808,5430,428.6923842592593,MERGED,3,19,2,0,1,399,False,0,0,0,923,22,25.046944444444446,Document
TypeScript,178,1359,309.62936342592593,CLOSED,2,6,2,3,3,1,False,1,2,2,1091,8,1.66,Bug
TypeScript,178,1359,312.85681712962963,CLOSED,2,6,2,6,4,29,True,3,3,2,2028,8,44.36972222222222,Feature
TypeScript,7,6,636.1071643518518,MERGED,0,6,2,0,1,217,False,0,0,0,947,6,0.21888888888888888,Feature
TypeScript,85,721,304.10309027777777,MERGED,4,4,2,0,1,149,False,0,0,0,1863,8,0.12555555555555556,Document
TypeScript,85,721,302.21583333333336,MERGED,6,33,2,0,1,88,False,0,0,0,1845,39,49.08777777777778,Document
V,2097,34361,1539.7105324074073,MERGED,2,26,2,1,2,172,True,0,1,1,486,28,18.10333333333333,Bug
JavaScript,8844,63474,4068.416701388889,MERGED,0,6,3,0,2,81,True,0,0,0,1009,6,15.444444444444445,Feature
Rust,264,5382,390.14098379629627,MERGED,7,8,2,0,2,132,False,0,0,0,804,15,0.30833333333333335,Feature
PHP,1334,2960,4194.380104166667,MERGED,1,2,2,0,3,63,False,0,0,0,874,3,15.705277777777777,Feature
Vue,293,495,819.8296527777778,MERGED,32,43,6,10,9,5,False,3,7,6,1475,75,225.16166666666666,Bug
JavaScript,5139,7048,1196.5782291666667,MERGED,1,101,5,2,5,88,False,0,2,2,1353,102,71.02916666666667,Feature
TypeScript,261,3765,663.9687268518518,MERGED,2,8,3,0,6,138,True,0,0,0,1647,10,186.9561111111111,Document
C++,2234,23694,2344.9128125,MERGED,21,75,4,1,6,109,False,0,1,1,712,96,8.239722222222222,Feature
TypeScript,85,721,303.19923611111113,MERGED,0,2,1,0,1,148,False,0,0,0,1321,2,17.36916666666667,Document
TypeScript,7,6,638.2269212962963,MERGED,1,84,8,0,12,5,True,0,0,0,1251,85,183.87944444444443,Feature
TypeScript,3392,2334,954.9843171296296,CLOSED,36,38,1,4,3,251,False,0,4,2,226,74,342.6122222222222,Feature
TypeScript,178,1359,313.1289699074074,MERGED,7,15,1,2,4,0,False,0,2,2,1775,22,2.3316666666666666,Bug
TypeScript,178,1359,310.32283564814816,MERGED,7,30,2,6,2,1,False,2,4,2,2136,37,93.2311111111111,Feature
TypeScript,85,721,303.1351041666667,MERGED,1,0,1,0,1,90,False,0,0,0,1564,1,0.18777777777777777,Document
TypeScript,178,1359,308.3216898148148,MERGED,3,27,1,1,1,4,True,0,1,1,1134,30,7.393611111111111,Feature
V,2097,34361,1538.4672222222223,MERGED,8,31,2,1,5,5,True,1,0,0,500,39,13.551944444444445,Bug
Rust,3808,5430,433.50223379629625,MERGED,668,475,3,0,3,458,False,0,0,0,2088,1143,299.66055555555556,Bug
TypeScript,202,107,1136.554675925926,MERGED,56,92,11,4,4,203,True,0,4,4,6532,148,5.374722222222222,Document
TypeScript,149,2900,369.55258101851854,MERGED,7,7,1,1,1,85,False,0,1,1,75,14,96.97611111111111,Feature
V,2097,34361,1540.8146527777778,MERGED,1,1,1,0,1,174,True,0,0,0,683,2,15.62,Bug
JavaScript,5139,7048,1195.8291203703704,MERGED,81,171,4,2,17,51,False,1,1,1,1156,252,50.44861111111111,Feature
C++,2234,23694,2343.8342708333334,MERGED,2,30,2,1,1,525,False,0,1,1,700,32,1.4552777777777777,Bug
TypeScript,2147,14722,1458.7770949074074,CLOSED,8,8,1,0,1,158,False,0,0,0,1806,16,29.4125,Feature
JavaScript,5139,7048,1196.922349537037,MERGED,3,3,1,2,1,1,False,1,1,1,1708,6,0.5830555555555555,Document
TypeScript,261,3765,662.4962268518518,MERGED,2,18,3,0,8,173,False,0,0,0,1562,20,1.3508333333333333,Document
Go,421,1654,1496.2467476851853,MERGED,22,12,2,0,1,234,False,0,0,0,1214,34,167.53472222222223,Bug
TypeScript,2147,14722,1459.2338425925927,CLOSED,5,22,3,1,1,72,False,0,1,1,1472,27,0.09777777777777778,Feature
Python,547,7160,2230.498032407407,MERGED,8,52,5,0,3,256,True,0,0,0,786,60,0.0275,Bug
Rust,3808,5430,433.95458333333335,CLOSED,1,167,2,1,1,117,False,1,0,0,415,168,146.28083333333333,Feature
TypeScript,85,721,301.9727662037037,MERGED,0,9,1,0,2,95,False,0,0,0,1445,9,0.3475,Document
Rust,3808,5430,433.29155092592595,MERGED,77,84,1,0,3,15,False,0,0,0,1892,161,269.20972222222224,Feature
JavaScript,5139,7048,1190.979247685185,MERGED,0,50,2,1,5,288,False,0,1,1,1001,50,0.2013888888888889,Document
Vue,293,495,822.8734027777778,MERGED,4150,4030,4,9,16,152,True,0,9,5,1363,8180,238.3075,Bug
JavaScript,5139,7048,1195.8922337962963,MERGED,147,104,48,4,3,0,False,0,4,3,1598,251,19.66722222222222,Feature
TypeScript,178,1359,311.2551388888889,MERGED,25,1,3,1,1,27,True,0,1,1,1905,26,0.02361111111111111,Feature
Rust,3808,5430,433.80850694444445,CLOSED,3,65,2,1,1,85,False,1,0,0,367,68,6.222777777777778,Feature
V,2097,34361,1543.4042939814815,MERGED,3,46,3,0,1,176,True,0,0,0,945,49,24.223055555555554,Bug
TypeScript,2147,14722,1458.8286689814815,MERGED,24,24,1,0,1,2,False,0,0,0,1354,48,1.2238888888888888,Feature
Rust,3808,5430,433.6496296296296,CLOSED,0,14,1,1,1,116,False,0,1,1,373,14,2.2894444444444444,Bug
Rust,3808,5430,433.52482638888887,MERGED,0,3,3,0,1,180,False,0,0,0,256,3,0.09416666666666666,Feature
Vue,0,1,238.3025810185185,MERGED,16,115,3,0,7,181,True,0,0,0,75,131,1.7958333333333334,Feature
Python,547,7160,2224.6051967592593,MERGED,9,85,4,0,11,252,True,0,0,0,786,94,1.6233333333333333,Feature
V,2097,34361,1538.8900231481482,MERGED,12,79,4,0,2,170,True,0,0,0,788,91,14.312777777777777,Bug
JavaScript,5139,7048,1192.4728125,MERGED,2,20,2,1,3,243,False,0,1,1,1467,22,123.49361111111111,Feature
Rust,3808,5430,434.13023148148153,MERGED,2,2,1,0,1,16,False,0,0,0,507,4,83.66027777777778,Document
TypeScript,202,107,1133.8750578703705,MERGED,1,1,1,4,1,202,True,0,4,4,1059,2,66.99,Document
TypeScript,7,6,632.0196412037037,MERGED,2,2,1,0,2,0,True,0,0,0,945,4,2.674166666666667,Feature
V,2097,34361,1542.851087962963,MERGED,1,9,1,0,2,4,False,0,0,0,947,10,7.803333333333334,Bug
TypeScript,15,34,475.5802777777778,MERGED,0,20,1,0,1,466,True,0,0,0,589,20,1.1869444444444444,Feature
Kotlin,164,4296,396.5459490740741,MERGED,2,2,1,0,1,48,False,0,0,0,247,4,0.18055555555555555,Document
TypeScript,7,6,636.2528356481481,MERGED,395,1700,48,0,30,258,False,0,0,0,2064,2095,356.6644444444444,Feature
Kotlin,164,4296,396.51381944444444,MERGED,1,2,1,0,2,47,False,0,0,0,210,3,0.6333333333333333,Feature
Erlang,2054,12122,3788.2761921296296,MERGED,1,7,1,0,1,129,False,0,0,0,225,8,0.07277777777777777,Bug
Go,30,295,340.34489583333334,MERGED,0,3,1,3,1,96,True,0,3,1,1624,3,25.52638888888889,Bug
JavaScript,5139,7048,1191.6648611111111,MERGED,2,6,4,2,3,0,False,0,2,2,116,8,262.3377777777778,Feature
TypeScript,261,3765,662.9045023148147,MERGED,8,16,5,1,6,0,False,0,1,1,1734,24,14.387222222222222,Document
Vue,0,1,237.03112268518518,MERGED,1,7,1,0,3,4,False,0,0,0,75,8,5.284722222222222,Feature
TypeScript,261,3765,664.5066666666667,MERGED,4,11,4,0,1,177,False,0,0,0,1933,15,0.7022222222222222,Document
TypeScript,41369,87411,2923.106875,MERGED,48,127,3,1,7,566,True,0,1,1,2818,175,19.744722222222222,Document
TypeScript,3392,2334,960.0257060185186,MERGED,0,9,1,1,1,298,False,0,1,1,226,9,0.40555555555555556,Feature
Erlang,2054,12122,3782.872175925926,CLOSED,3,1,2,0,2,129,False,0,0,0,670,4,631.2286111111111,Bug
JavaScript,8844,63474,4064.574884259259,MERGED,27,17,1,5,1,1,False,1,4,2,1035,44,2.473333333333333,Bug
JavaScript,5139,7048,1197.017800925926,MERGED,78,137,10,9,22,3,False,2,7,3,1785,215,63.519444444444446,Document
TypeScript,85,721,303.9656018518519,MERGED,41,54,4,0,12,97,False,0,0,0,2510,95,0.21472222222222223,Document
TypeScript,1297,21107,406.7352199074074,MERGED,0,1,1,2,3,0,False,0,2,2,1364,1,226.4297222222222,Document
Vue,0,1,234.43431712962965,CLOSED,1,2,1,0,1,31,False,0,0,0,75,3,16.315555555555555,Feature
TypeScript,178,1359,311.83872685185185,MERGED,122,191,4,10,4,2,False,4,6,2,2818,313,122.24,Feature
Java,450,746,4059.0788773148147,MERGED,0,21,4,1,14,371,False,0,1,1,393,21,455.95222222222225,Feature
Rust,264,5382,390.1368981481482,CLOSED,0,6,1,0,1,0,False,0,0,0,766,6,0.44,Feature
TypeScript,7,6,638.2170138888889,CLOSED,4,11,2,0,7,4,True,0,0,0,1370,15,0.05361111111111111,Feature
Vue,293,495,818.9077430555554,MERGED,1,16,1,5,2,4,False,0,5,3,1430,17,288.47527777777776,Bug
Vue,293,495,818.7741319444444,MERGED,14,13,1,6,4,370,True,1,5,4,1158,27,291.08416666666665,Bug
Rust,264,5382,389.83068287037037,MERGED,7,26,4,0,2,9,False,0,0,0,812,33,1.906111111111111,Bug
TypeScript,58,78,808.0301967592592,MERGED,7,0,1,1,1,172,True,0,1,1,146,7,0.7661111111111111,Feature
TypeScript,41369,87411,2924.0480324074074,MERGED,0,521,2,2,15,71,True,0,2,2,2535,521,997.7161111111111,Document
Starlark,440,286,482.65446759259254,MERGED,0,439,3,0,2,48,False,0,0,0,417,439,53.75611111111111,Feature
Rust,3808,5430,429.7285416666667,MERGED,4,4,3,0,1,7,False,0,0,0,1179,8,30.456666666666667,Document
TypeScript,3392,2334,955.9761226851851,MERGED,2,11,1,1,1,672,False,0,1,1,226,13,94.5886111111111,Feature
JavaScript,5139,7048,1197.0059027777777,CLOSED,8,9,1,4,2,2,False,0,4,3,1579,17,0.10055555555555555,Feature
Vue,293,495,822.0701851851851,MERGED,2,3,1,4,1,353,False,0,4,4,1389,5,119.16055555555556,Bug
TypeScript,15,34,475.761886574074,MERGED,1,3,1,0,1,881,False,0,0,0,646,4,16.619444444444444,Bug
TypeScript,202,107,1132.8828703703705,MERGED,2,2,1,4,1,1,True,1,3,3,981,4,0.125,Document
Go,421,1654,1496.1900694444446,MERGED,5,35,2,0,1,232,False,0,0,0,1793,40,168.9025,Bug
PHP,1334,2960,4194.1594444444445,MERGED,2,2,2,0,4,71,False,0,0,0,1379,4,0.3913888888888889,Document
PHP,1334,2960,4196.075682870371,MERGED,2,3,1,0,1,82,False,0,0,0,1578,5,95.43166666666667,Document
JavaScript,8844,63474,4068.8099305555556,MERGED,9,73,6,3,8,0,True,1,2,1,1299,82,39.38472222222222,Feature
Rust,264,5382,392.010162037037,MERGED,2,29,2,0,1,71,True,0,0,0,1293,31,138.5025,Feature
TypeScript,85,722,307.99813657407407,MERGED,9,28,2,0,5,100,False,0,0,0,3341,37,0.4211111111111111,Document
TypeScript,17,33,710.7528935185186,MERGED,25,11,4,1,1,59,True,0,1,1,122,36,0.2125,Feature
TypeScript,202,107,1131.8548958333333,MERGED,311,221,2,4,2,201,True,0,4,4,991,532,15.233611111111111,Document
Vue,293,495,823.9595717592592,CLOSED,2,32,3,3,2,0,False,0,3,3,1526,34,1.4316666666666666,Bug
Vue,0,1,235.01379629629628,MERGED,40,4,5,0,1,53,False,0,0,0,75,44,0.050277777777777775,Feature
Vue,0,1,234.64627314814814,MERGED,0,0,1,0,2,32,False,0,0,0,75,0,11.533888888888889,Feature
JavaScript,5139,7048,1191.7291898148148,MERGED,1,20,2,1,2,93,False,0,1,1,1348,21,0.1225,Document
JavaScript,5139,7048,1196.0027314814815,MERGED,8,13,2,1,4,289,False,0,1,1,1969,21,0.2125,Document
TypeScript,178,1359,312.74950231481483,MERGED,32,20,5,4,3,2,False,0,4,4,2970,52,11.25611111111111,Feature
Rust,3808,5430,433.5019907407407,MERGED,8,8,3,0,1,8,False,0,0,0,2134,16,51.151944444444446,Document
Go,4154,13945,1907.2578125,MERGED,50,67,14,1,5,306,False,1,0,0,406,117,6.593333333333334,Bug
Vue,293,495,823.0768865740741,MERGED,1,11,3,4,3,354,False,1,3,3,1441,12,14.111666666666666,Bug
Python,547,7160,2224.8568055555556,MERGED,75,92,10,1,17,223,False,1,0,0,948,167,854.8866666666667,Bug
Python,547,7160,2224.8502430555554,MERGED,27,187,3,0,5,253,True,0,0,0,787,214,0.6,Feature
V,2097,34361,1538.9117245370371,MERGED,0,16,3,0,1,171,True,0,0,0,797,16,13.002777777777778,Bug
Go,395,660,1257.8683680555555,MERGED,2,12,1,0,1,70,False,0,0,0,332,14,0.20333333333333334,Feature
Vue,0,1,234.00792824074074,MERGED,0,0,1,0,1,29,False,0,0,0,75,0,5.760277777777778,Feature
TypeScript,17,33,710.9250694444445,MERGED,1,1,1,1,1,31,False,0,1,1,172,2,2.8141666666666665,Feature
TypeScript,15,34,478.35001157407413,MERGED,4,6,5,0,2,469,True,0,0,0,935,10,1.0708333333333333,Feature
TypeScript,1297,21107,408.8665740740741,MERGED,37,70,24,1,2,904,True,0,1,1,1549,107,0.11305555555555556,Document
TypeScript,42,46,763.3535995370371,MERGED,1,10,2,1,1,15,False,0,1,1,284,11,41.62138888888889,Feature
Rust,417,2801,910.1299768518519,MERGED,0,141585,1522,0,1,3,False,0,0,0,229,141585,0.4063888888888889,Feature
Python,72,25,1623.6676967592593,MERGED,0,422,2,1,5,24,False,1,0,0,1146,422,91.95472222222222,Feature
Vue,293,495,820.0669675925925,MERGED,9,3,2,4,1,352,False,0,4,4,1450,12,95.30805555555555,Bug
TypeScript,85,722,302.10265046296297,MERGED,136,225,5,0,1,88,False,0,0,0,3369,361,163.03861111111112,Document
JavaScript,5139,7048,1189.6498958333334,MERGED,6,62,3,2,3,77,False,0,2,2,1802,68,20.344166666666666,Feature
Go,395,660,1253.1632060185186,MERGED,3,3,2,0,1,69,False,0,0,0,234,6,20.676944444444445,Feature
Go,395,660,1257.1164467592591,MERGED,1,1,1,0,2,75,False,0,0,0,173,2,0.01888888888888889,Bug
TypeScript,1297,21107,407.783275462963,MERGED,1,1,1,1,1,1,False,0,1,1,1313,2,18.342222222222222,Document
PHP,0,0,99.1426736111111,MERGED,3,17,2,0,1,47,True,0,0,0,469,20,0.026111111111111113,Document
Vue,293,495,823.8202777777778,MERGED,57,152,20,13,16,355,False,3,10,6,2027,209,154.0275,Bug
Vue,293,495,822.5310185185185,MERGED,2,69,5,10,9,251,True,3,7,5,1671,71,201.03083333333333,Bug
TypeScript,178,1359,310.3071875,MERGED,31,28,1,1,1,0,False,0,1,1,2711,59,16.58972222222222,Feature
Rust,433,2229,223.5979166666667,MERGED,1,6,1,1,1,711,False,0,1,1,175,7,0.4425,Bug
JavaScript,8844,63474,4066.1536805555556,MERGED,2,73,8,0,2,78,True,0,0,0,1856,75,31.11,Feature
PHP,1334,2960,4201.1215740740745,MERGED,1,5,1,0,1,40,False,0,0,0,2581,6,18.29111111111111,Document
TypeScript,15,34,482.77105324074074,MERGED,2,0,1,0,1,44,False,0,0,0,366,2,66.26,Document
V,2097,34361,1543.4890972222222,MERGED,7,76,6,0,7,177,True,0,0,0,1396,83,38.84027777777778,Bug
PHP,1334,2960,4201.185798611111,MERGED,3,9,2,0,1,73,False,0,0,0,2308,12,0.7302777777777778,Document
Rust,433,2229,224.6335648148148,MERGED,3,7,2,1,1,724,False,0,1,1,232,10,4.0633333333333335,Feature
TypeScript,15,34,476.4698726851852,MERGED,3,3,1,0,1,467,True,0,0,0,776,6,0.4438888888888889,Bug
PHP,883,2337,1821.0086342592592,CLOSED,0,2,1,1,1,5,True,0,1,1,1478,2,23.52,Document
PHP,1334,2960,4200.239791666667,MERGED,6,1,3,0,2,151,False,0,0,0,2280,7,21.164166666666667,Document
TypeScript,1297,21107,406.9265740740741,MERGED,13,71,14,1,7,895,True,0,1,1,1388,84,1.3047222222222221,Document
Rust,264,5382,391.97233796296297,MERGED,25,21,2,0,3,213,True,0,0,0,1595,46,3.149722222222222,Bug
TypeScript,3392,2334,954.1232870370371,MERGED,0,8,1,1,2,292,False,0,1,1,226,8,0.07083333333333333,Feature
TypeScript,42,46,756.7899074074074,MERGED,1,1,1,1,1,78,False,0,1,1,149,2,0.6591666666666667,Feature
TypeScript,3392,2334,956.0451157407407,MERGED,0,8,1,2,1,443,False,0,2,1,313,8,0.3477777777777778,Feature
TypeScript,15,34,475.7944212962963,MERGED,0,2,1,0,2,883,False,0,0,0,1120,2,4.433611111111111,Feature
TypeScript,15,34,475.7861342592593,MERGED,1,2,1,1,1,882,False,1,0,0,1018,3,4.655833333333334,Document
TypeScript,3392,2334,954.028900462963,MERGED,1,1,1,2,1,440,False,0,2,1,226,2,0.49472222222222223,Feature
Python,547,7160,2223.4247800925928,CLOSED,2,2,1,4,6,67,False,1,3,2,255,4,222.89833333333334,Feature
Vue,293,495,818.0292708333333,MERGED,3,4,1,11,4,350,False,3,8,4,1596,7,88.73,Bug
Rust,433,2229,227.4960763888889,MERGED,0,6,1,1,1,738,False,0,1,1,329,6,5.4558333333333335,Feature
C#,80,125,808.6038888888888,MERGED,0,1295,11,0,9,158,True,0,0,0,673,1295,431.79527777777776,Document
Rust,264,5382,391.14197916666666,MERGED,46,30,2,0,2,313,False,0,0,0,1429,76,21.92111111111111,Feature
Java,450,746,4059.958090277778,MERGED,3,189,2,1,1,372,False,0,1,1,218,192,28.607777777777777,Feature
V,2097,34361,1541.6685648148148,MERGED,0,20,3,0,4,209,True,0,0,0,1398,20,61.68,Document
Go,395,660,1251.8513425925926,MERGED,8,28,1,0,1,72,False,0,0,0,131,36,0.5333333333333333,Document
Go,182,37,1696.2304861111113,MERGED,0,6,2,0,1,439,False,0,0,0,708,6,0.8486111111111111,Document
TypeScript,261,3765,664.5628819444445,MERGED,29,24,5,0,1,210,True,0,0,0,2330,53,2.326111111111111,Document
Go,395,660,1252.9046180555556,MERGED,0,4,1,0,1,68,False,0,0,0,167,4,0.6016666666666667,Feature
Java,450,746,4060.0783101851853,MERGED,3,12,5,1,7,24,False,0,1,1,1774,15,143.05388888888888,Bug
JavaScript,5139,7048,1196.7288194444443,MERGED,68,382,13,2,3,0,False,1,1,1,357,450,54.275,Feature
JavaScript,5139,7048,1190.9554976851853,MERGED,11,207,19,3,15,50,False,1,2,2,2203,218,39.88361111111111,Document
TypeScript,1297,21107,405.89916666666664,MERGED,43,47,2,1,1,888,True,0,1,1,1789,90,0.21083333333333334,Document
TypeScript,178,1359,308.6876736111111,MERGED,108,141,7,5,5,24,True,3,2,2,2747,249,1.8355555555555556,Feature
JavaScript,8844,63474,4064.4747569444444,MERGED,0,64,1,0,1,99,True,0,0,0,1431,64,0.6869444444444445,Document
Vue,293,495,823.5024305555556,MERGED,35,248,16,18,15,49,False,6,12,5,1652,283,80.5663888888889,Bug
TypeScript,3392,2334,955.9422800925926,MERGED,21,3,4,1,2,671,False,0,1,1,506,24,97.6475,Bug
Rust,433,2229,226.41965277777777,MERGED,9,10,6,1,1,733,False,0,1,1,310,19,0.5077777777777778,Feature
JavaScript,8844,63474,4064.382962962963,MERGED,0,51,1,0,2,98,True,0,0,0,1364,51,0.7447222222222222,Document
TypeScript,41369,87411,2929.909641203704,CLOSED,4,9,1,2,1,0,False,1,1,1,2012,13,64.17888888888889,Document
TypeScript,261,3765,662.7839120370371,MERGED,26,37,2,0,3,94,False,0,0,0,2236,63,43.755,Document
Python,547,7160,2229.69775462963,MERGED,103,29,5,0,8,72,False,0,0,0,444,132,48.57555555555555,Feature
Rust,433,2229,222.61459490740742,MERGED,5,5,1,0,1,230,False,0,0,0,204,10,1.781388888888889,Bug
Vue,293,495,816.9056018518519,CLOSED,6,25,1,9,3,0,False,2,7,4,1456,31,101.93583333333333,Bug
Go,30,295,336.05182870370373,MERGED,3,59,2,3,2,87,True,0,3,2,2104,62,128.76638888888888,Bug
Rust,433,2229,222.47547453703703,MERGED,52,84,1,1,1,703,False,0,1,1,237,136,1.8272222222222223,Feature
Python,547,7160,2227.5539351851853,MERGED,26,22,1,0,2,224,False,0,0,0,451,48,4.980555555555555,Bug
C++,2234,23694,2344.7466435185183,MERGED,4,7,5,1,2,526,False,0,1,1,1628,11,4.092222222222222,Feature
PHP,0,0,98.28445601851853,MERGED,5,204,7,0,2,29,False,0,0,0,2201,209,0.05472222222222222,Document
TypeScript,41369,87411,2930.603761574074,MERGED,3,1,1,2,2,7,False,1,1,1,2724,4,71.71277777777777,Document
Vue,293,495,818.1531597222223,MERGED,75,182,15,2,2,351,False,0,2,2,1671,257,15.427777777777777,Bug
TypeScript,261,3765,662.6946296296296,MERGED,18,22,4,0,1,256,True,0,0,0,3285,40,0.6005555555555555,Document
C#,80,125,812.5495833333333,MERGED,4,6,1,0,1,170,False,0,0,0,501,10,0.8036111111111112,Document
JavaScript,5139,7048,1192.771226851852,MERGED,23,490,12,1,15,0,False,0,1,1,495,513,260.6111111111111,Feature
TypeScript,1297,21107,404.0317013888889,MERGED,2,6,3,1,1,881,True,0,1,1,1655,8,0.07833333333333334,Document
Rust,3808,5430,430.35987268518517,MERGED,5,5,1,0,1,5,False,0,0,0,575,10,15.62861111111111,Document
Python,19248,70257,2448.402326388889,CLOSED,541,307,3,1,2,83,False,1,0,0,3726,848,6.436388888888889,Bug
TypeScript,15,34,483.48552083333334,MERGED,28,720,3,0,2,305,False,0,0,0,509,748,0.4572222222222222,Bug
PHP,0,0,99.17412037037037,MERGED,54,138,12,0,8,48,True,0,0,0,677,192,0.5636111111111111,Document
Go,395,660,1252.0882870370372,MERGED,1,5,1,1,2,66,False,1,0,0,209,6,22.041944444444443,Feature
Rust,433,2229,224.94994212962965,MERGED,6,7,1,1,1,727,False,0,1,1,274,13,0.6236111111111111,Feature
Rust,433,2229,227.7417824074074,MERGED,15,69,3,0,1,740,False,0,0,0,506,84,2.4766666666666666,Feature
Rust,433,2229,224.85304398148148,MERGED,2,50,2,1,1,725,False,0,1,1,321,52,1.78,Bug
Go,395,660,1256.0101157407407,MERGED,1,66,1,0,1,74,False,0,0,0,290,67,0.43277777777777776,Feature
Go,395,660,1251.950625,CLOSED,1,6,1,0,1,65,False,0,0,0,223,7,3.9133333333333336,Feature
TypeScript,17,33,704.8625347222222,MERGED,3,11,1,1,1,28,False,0,1,1,170,14,0.5202777777777777,Feature
TypeScript,1297,21107,408.96527777777777,MERGED,4,11,5,1,1,907,True,0,1,1,1995,15,0.18388888888888888,Document
Rust,433,2229,226.7042361111111,MERGED,6,38,4,1,1,737,False,0,1,1,431,44,22.730833333333333,Feature
TypeScript,1297,21107,408.8920023148148,MERGED,2,9,1,1,1,905,True,0,1,1,2144,11,0.11194444444444444,Document
JavaScript,9664,43889,3644.540752314815,MERGED,176,513,16,0,2,616,False,0,0,0,464,689,162.41027777777776,Feature
Rust,417,2801,910.4089004629631,MERGED,14,14,7,1,2,259,False,0,1,1,500,28,14.466666666666667,Bug
TypeScript,15,34,478.7737268518519,MERGED,17,14,4,0,1,303,False,0,0,0,1627,31,18.61861111111111,Bug
PHP,0,0,96.17733796296297,MERGED,18,19,2,0,2,27,False,0,0,0,2493,37,0.04611111111111111,Document
TypeScript,7046,76150,2617.0616087962962,MERGED,19,58,3,4,1,100,False,0,4,2,1430,77,0.16722222222222222,Document
PHP,0,0,96.14125,MERGED,30,165,4,0,1,26,False,0,0,0,1983,195,0.019444444444444445,Document
TypeScript,7046,76150,2617.002928240741,MERGED,1,100,1,5,1,99,False,0,5,2,1294,101,1.1455555555555557,Feature
Rust,433,2229,223.85318287037038,MERGED,70,54,6,1,1,715,False,0,1,1,364,124,1.2202777777777778,Feature
TypeScript,1297,21107,407.7397569444445,MERGED,0,49,3,11,10,39,False,4,7,2,2392,49,19.824444444444445,Document
TypeScript,3989,23860,2821.247175925926,MERGED,1,0,1,1,1,170,False,0,1,1,666,1,0.2525,Document
TypeScript,0,0,73.88469907407408,MERGED,7,2068,5,0,2,5,True,0,0,0,1559,2075,0.15305555555555556,Document
TypeScript,0,0,73.88144675925926,MERGED,9,103,9,0,3,4,True,0,0,0,1574,112,0.05305555555555556,Feature
JavaScript,5139,7048,1195.7277083333333,MERGED,21,292,12,1,4,0,False,0,1,1,393,313,71.93555555555555,Feature
V,2097,34361,1544.5216319444444,MERGED,5,17,3,0,3,30,True,0,0,0,1507,22,13.578888888888889,Document
TypeScript,41369,87411,2929.026631944444,MERGED,1799,9,6,0,7,1566,True,0,0,0,2047,1808,57.971111111111114,Document
TypeScript,15,34,478.5941203703704,MERGED,8,36,3,0,2,154,False,0,0,0,1820,44,0.11333333333333333,Feature
TypeScript,15,34,478.3884722222222,MERGED,7,5,5,0,1,470,True,0,0,0,1799,12,0.8933333333333333,Bug
TypeScript,15,34,478.74644675925924,MERGED,134,270,11,0,8,888,False,0,0,0,438,404,115.43166666666667,Document
Python,547,7160,2224.6578472222222,CLOSED,0,49,2,0,3,114,False,0,0,0,453,49,5.5472222222222225,Bug
Python,547,7160,2224.5582754629627,MERGED,72,72,5,0,9,69,False,0,0,0,496,144,120.70416666666667,Bug
Vue,293,495,816.5796759259259,MERGED,14,11,2,10,10,250,True,3,7,5,1708,25,178.99055555555555,Bug
Go,421,1654,1497.1539351851852,MERGED,29,41,4,0,2,412,True,0,0,0,2759,70,2.2816666666666667,Bug
TypeScript,42,46,757.0349768518519,MERGED,3,4,1,2,1,127,False,0,2,1,321,7,0.07138888888888889,Bug
JavaScript,8844,63474,4066.3328935185186,MERGED,4,43,4,0,2,79,True,0,0,0,2658,47,1.335,Document
C#,80,125,812.430949074074,MERGED,12,55,3,0,5,161,True,0,0,0,583,67,71.29277777777777,Document
TypeScript,202,107,1130.0667939814814,MERGED,18,26,1,4,5,146,True,0,4,4,1791,44,18.934722222222224,Document
TypeScript,2071,16638,1236.2875694444444,MERGED,1,1,1,0,1,0,False,0,0,0,2538,2,140.125,Bug
TypeScript,199,371,762.6904398148148,MERGED,8,7,2,1,2,38,False,0,1,1,341,15,0.7913888888888889,Feature
TypeScript,17,33,708.039074074074,MERGED,14,47,5,1,2,30,False,0,1,1,425,61,143.6861111111111,Document
TypeScript,1297,21107,406.9263888888889,MERGED,2,8,1,1,1,38,False,0,1,1,2339,10,1.1558333333333333,Document
Python,547,7160,2230.6988194444443,MERGED,21,80,8,0,12,226,False,0,0,0,595,101,4.635277777777778,Document
Rust,433,2229,224.58122685185185,MERGED,9,16,5,1,1,721,False,0,1,1,418,25,5.846388888888889,Bug
JavaScript,9664,43889,3650.000300925926,MERGED,4,32,5,1,4,51,True,1,0,0,522,36,20.181944444444444,Bug
Rust,264,5382,391.80675925925925,MERGED,47,46,5,1,6,315,False,1,0,0,2387,93,1.6436111111111111,Feature
Rust,433,2229,224.38466435185185,MERGED,51,42,12,1,1,716,False,0,1,1,507,93,9.752222222222223,Bug
Java,450,746,4058.2329629629626,MERGED,5,51,2,0,1,407,False,0,0,0,1548,56,0.5477777777777778,Bug
JavaScript,5139,7048,1192.5953472222222,MERGED,22,521,24,11,15,86,False,3,8,5,5031,543,408.1736111111111,Bug
Java,450,746,4061.1361921296298,MERGED,5,15,3,2,5,21,False,0,2,1,462,20,2.83,Feature
Python,19248,70257,2452.3693287037036,CLOSED,749,1478,85,6,32,9,False,4,2,2,2928,2227,30.380277777777778,Feature
TypeScript,1297,21107,406.11006944444443,MERGED,5,67,2,1,1,892,True,0,1,1,2070,72,0.011111111111111112,Document
Go,395,660,1252.0987731481482,MERGED,4,4,2,0,4,67,False,0,0,0,280,8,18.816666666666666,Feature
Go,395,660,1251.902152777778,MERGED,45,89,5,0,7,64,False,0,0,0,362,134,26.350555555555555,Feature
Erlang,2054,12122,3782.331516203704,MERGED,0,5,1,3,1,310,False,2,1,1,1074,5,866.2255555555555,Document
Rust,433,2229,227.71962962962962,MERGED,7,62,5,1,5,739,False,0,1,1,588,69,18.746388888888887,Document
Rust,3808,5430,433.09800925925924,MERGED,14,16,2,0,1,114,False,0,0,0,1186,30,9.895277777777778,Bug
C#,80,125,812.7221064814815,MERGED,31,18,10,0,2,67,False,0,0,0,716,49,0.7052777777777778,Document
C#,80,125,808.6810069444444,MERGED,17,15,2,0,2,65,False,0,0,0,613,32,163.86888888888888,Document
Rust,264,5382,390.9582291666666,CLOSED,3,156,3,3,1,0,False,2,1,1,2338,159,0.6677777777777778,Feature
Python,137,75,672.2592708333333,CLOSED,0,256,9,1,26,3,False,0,1,1,3676,256,2037.4894444444444,Document
Java,547,304,220.09574074074075,MERGED,0,22,1,1,1,2,False,1,0,0,1550,22,21.560833333333335,Document
TypeScript,1297,21107,405.6049884259259,CLOSED,704,1503,5,2,2,885,True,0,2,2,2242,2207,4.538333333333333,Document
TypeScript,41369,87411,2924.679849537037,MERGED,23,680,10,2,13,11,False,0,2,1,2494,703,523.2522222222223,Document
Java,547,304,220.0162037037037,MERGED,0,15,1,0,3,0,False,0,0,0,1466,15,93.5363888888889,Feature
TypeScript,3989,23860,2818.1920254629626,MERGED,6,38,5,1,11,11,False,0,1,1,632,44,21.226111111111113,Feature
TypeScript,149,2900,366.623287037037,MERGED,21,318,5,2,1,84,False,1,1,1,530,339,167.265,Feature
TypeScript,2147,14722,1460.1373495370372,MERGED,3710,207,39,0,5,660,False,0,0,0,4447,3917,166.6,Document
Python,547,7160,2224.7539930555554,CLOSED,46,106,2,0,22,115,False,0,0,0,555,152,16.135,Bug
Java,547,304,219.1198263888889,MERGED,0,19,1,0,1,9,False,0,0,0,1540,19,0.3825,Document
Python,547,7160,2224.533576388889,MERGED,60,30,38,0,4,112,False,0,0,0,707,90,0.6958333333333333,Bug
TypeScript,178,1359,310.46769675925924,MERGED,98,118,11,2,1,26,True,0,2,2,4819,216,13.097777777777777,Feature
TypeScript,41369,87411,2924.6912037037036,CLOSED,542,1825,36,7,16,12,False,3,4,2,2473,2367,481.85833333333335,Document
JavaScript,8844,63474,4063.443090277778,MERGED,9,23,3,0,1,97,True,0,0,0,1951,32,2.066388888888889,Document
Java,547,304,217.0312037037037,MERGED,0,12,1,0,3,0,False,0,0,0,1454,12,45.11972222222222,Document
JavaScript,8844,63474,4063.4084259259257,MERGED,0,49,1,0,2,96,True,0,0,0,2287,49,1.1536111111111111,Document
V,2097,34361,1540.724826388889,MERGED,23,121,7,0,2,28,True,0,0,0,1936,144,12.258333333333333,Document
TypeScript,178,1359,312.67309027777776,CLOSED,103,516,13,7,3,28,True,4,3,2,8307,619,999.0772222222222,Document
Python,72,25,1629.7403356481482,MERGED,299,609,2,0,8,25,False,0,0,0,2835,908,47.29416666666667,Feature
Python,547,7160,2225.6365393518518,MERGED,13,34,7,0,9,26,False,0,0,0,666,47,97.23611111111111,Bug
Python,547,7160,2225.6163078703703,MERGED,12,1,1,0,4,25,False,0,0,0,837,13,98.00222222222222,Bug
Java,547,304,215.34372685185187,MERGED,0,8,1,0,2,348,False,0,0,0,1547,8,81.78166666666667,Document
Go,30,295,339.0572916666667,MERGED,129,48,3,2,7,88,True,0,2,1,2505,177,55.02583333333333,Bug
Java,547,304,215.34957175925925,MERGED,0,8,1,0,2,354,False,0,0,0,1356,8,85.06166666666667,Document
V,2097,34361,1540.462083333333,MERGED,0,7,1,0,1,27,True,0,0,0,1736,7,5.264722222222222,Document
C#,80,125,812.9227777777778,MERGED,753,1534,11,0,8,194,True,0,0,0,887,2287,187.02027777777778,Document
TypeScript,149,2900,369.5527314814815,MERGED,1,59,1,3,1,86,False,1,2,2,1500,60,701.3113888888889,Document
Java,547,304,214.0167013888889,MERGED,0,23,1,0,1,2,False,0,0,0,1468,23,2.178611111111111,Document
Java,547,304,215.34508101851853,MERGED,0,8,1,0,1,349,False,0,0,0,1409,8,15.739444444444445,Document
Java,547,304,215.3522685185185,MERGED,0,8,1,0,2,357,False,0,0,0,1385,8,85.01861111111111,Document
Java,547,304,215.34605324074073,MERGED,0,8,1,0,2,350,False,0,0,0,1381,8,84.99638888888889,Document
C#,80,125,813.4994212962962,MERGED,82,242,15,1,32,162,True,0,1,1,857,324,140.97944444444445,Document
PHP,1334,2960,4200.231909722222,MERGED,4,4,3,0,3,150,False,0,0,0,2994,8,19.72138888888889,Document
JavaScript,8844,63474,4069.5118865740737,MERGED,54,134,20,0,3,84,True,0,0,0,2648,188,41.996944444444445,Document
Java,547,304,215.34827546296296,MERGED,0,8,1,0,2,352,False,0,0,0,1317,8,84.96333333333334,Document
TypeScript,178,1359,309.39917824074075,MERGED,81,168,5,4,4,3,False,0,4,3,3729,249,13.535277777777777,Document
TypeScript,202,107,1130.0396759259258,MERGED,0,4,1,4,1,126,False,0,4,4,874,4,159.0636111111111,Document
Java,547,304,215.20622685185185,MERGED,2,2,1,0,1,4,False,0,0,0,1498,4,8.927777777777777,Document
Java,547,304,215.3563888888889,MERGED,0,8,1,0,1,361,False,0,0,0,1384,8,15.49638888888889,Document
Erlang,2054,12122,3783.9697337962966,MERGED,17,130,3,1,2,71,True,1,0,0,923,147,242.32111111111112,Bug
TypeScript,139,827,735.3256944444444,MERGED,1,1,1,2,1,17,False,0,2,2,695,2,5.668055555555555,Document
C#,80,125,812.4121990740741,MERGED,30,112,13,0,3,210,False,0,0,0,966,142,172.24555555555557,Document
Java,547,304,215.0338078703704,MERGED,0,6,1,0,8,509,False,0,0,0,1426,6,12.140277777777778,Document
Java,547,304,214.9151851851852,MERGED,0,6,1,0,5,507,False,0,0,0,1154,6,26.03638888888889,Document
Java,450,746,4060.1850810185188,MERGED,0,22,2,0,2,409,False,0,0,0,2229,22,1.9986111111111111,Feature
Python,547,7160,2223.5878703703706,CLOSED,6,115,3,0,4,68,False,0,0,0,540,121,144.5613888888889,Bug
Python,2407,12180,233.1392361111111,MERGED,0,14,1,0,5,231,True,0,0,0,1641,14,495.3211111111111,Document
Rust,3808,5430,429.652175925926,MERGED,58,3,4,0,1,400,False,0,0,0,3215,61,0.058888888888888886,Document
Erlang,2054,12122,3782.0193287037036,MERGED,14,19,5,0,5,128,False,0,0,0,831,33,285.0288888888889,Document
TypeScript,41369,87411,2924.7468750000003,MERGED,26,244,9,8,26,8,False,4,4,1,4868,270,862.2569444444445,Document
TypeScript,41369,87411,2924.7201041666667,MERGED,2,24,2,3,16,7,False,1,2,2,3410,26,860.8661111111111,Document
Erlang,2054,12122,3788.427789351852,MERGED,7,18,2,0,1,132,False,0,0,0,799,25,14.996666666666666,Document
TypeScript,2071,16638,1234.180162037037,MERGED,2,2,1,0,1,1,False,0,0,0,2748,4,10.591388888888888,Bug
Rust,264,5382,391.2580787037037,MERGED,312,227,8,1,5,314,False,0,1,1,2607,539,156.5525,Feature
TypeScript,41369,87411,2925.6700694444444,MERGED,44,707,9,0,8,106,False,0,0,0,3560,751,815.5780555555556,Document
TypeScript,41369,87411,2925.6330902777777,MERGED,7,49,3,0,1,391,True,0,0,0,2129,56,0.6183333333333333,Document
Erlang,2054,12122,3788.1150925925926,MERGED,2,19,4,0,1,128,False,0,0,0,902,21,17.849166666666665,Document
Rust,3808,5430,428.785625,MERGED,16,335,3,3,5,0,False,2,1,1,1084,351,21.68638888888889,Feature
Python,547,7160,2231.2527314814815,MERGED,481,95,5,1,22,5,False,0,1,1,760,576,56.687222222222225,Feature
TypeScript,17,33,705.9798726851851,MERGED,47,96,8,1,1,29,False,0,1,1,510,143,2.216666666666667,Bug
TypeScript,261,3765,664.6107638888889,MERGED,10,76,8,1,4,568,True,1,0,0,4484,86,1.948611111111111,Document
TypeScript,4,33,751.6073611111111,CLOSED,5,2291,35,1,49,381,True,0,1,1,2137,2296,1459.066388888889,Document
TypeScript,41369,87411,2929.323935185185,MERGED,1,8,1,3,7,7,False,1,2,1,2596,9,170.7577777777778,Document
TypeScript,1297,21107,409.6383449074074,MERGED,53,42,9,1,12,910,True,0,1,1,3131,95,0.9188888888888889,Document
Rust,3808,5430,428.6080324074074,MERGED,3,4,1,0,2,52,False,0,0,0,789,7,2.6680555555555556,Feature
Java,450,746,4060.13181712963,MERGED,2,14,2,1,1,20,False,0,1,1,541,16,1.175,Bug
Rust,3808,5430,428.4971296296296,MERGED,1,1,1,0,1,3,False,0,0,0,956,2,5.089722222222222,Document
JavaScript,9664,43889,3644.9916550925923,MERGED,51,179,13,0,2,308,True,0,0,0,652,230,1.073611111111111,Feature
TypeScript,41369,87411,2928.9652430555557,CLOSED,3,9,1,3,2,6,False,0,3,2,2360,12,156.39055555555555,Document
Python,547,7160,2229.4711689814817,MERGED,88,292,9,0,23,70,False,0,0,0,773,380,95.32861111111112,Feature
TypeScript,2071,16638,1231.0101851851853,MERGED,0,2,1,0,1,1,False,0,0,0,2339,2,86.74361111111111,Bug
TypeScript,307,2556,524.4508449074074,MERGED,1,1,1,1,1,19,False,0,1,1,1068,2,3.7205555555555554,Bug
TypeScript,1297,21107,408.56752314814815,MERGED,43,4,5,1,1,903,True,0,1,1,3121,47,0.009444444444444445,Document
TypeScript,41369,87411,2923.646747685185,CLOSED,1,1,1,2,1,5,False,1,1,1,2154,2,0.9236111111111112,Document
TypeScript,41369,87411,2923.6451736111107,CLOSED,1,1,1,0,1,4,False,0,0,0,2117,2,0.008055555555555555,Document
TypeScript,1297,21107,408.0454282407407,MERGED,20,83,5,1,3,900,True,0,1,1,3193,103,2.613611111111111,Document
TypeScript,4,33,755.2208333333333,MERGED,117,146,5,2,1,591,True,1,1,1,778,263,0.2511111111111111,Feature
TypeScript,261,3765,662.6802893518519,MERGED,27,37,8,0,12,174,False,0,0,0,3225,64,0.9130555555555555,Document
TypeScript,261,3765,662.6938657407408,MERGED,300,569,8,0,3,848,True,0,0,0,3581,869,0.3433333333333333,Document
TypeScript,15,34,483.4308564814815,MERGED,63,369,12,0,9,126,False,0,0,0,800,432,44.85527777777778,Feature
TypeScript,4,33,754.5026157407407,MERGED,2,37,5,2,4,588,True,1,1,1,928,39,22.611944444444443,Document
TypeScript,139,827,740.5360648148148,MERGED,25,32,1,2,2,21,False,0,2,2,956,57,11.305555555555555,Bug
JavaScript,8844,63474,4066.328449074074,MERGED,5,152,3,3,2,100,True,2,1,1,3493,157,0.7352777777777778,Document
C#,80,125,811.4496759259259,MERGED,4042,14458,367,0,21,38,False,0,0,0,953,18500,52.37027777777778,Document
C#,80,125,808.4006365740742,MERGED,5,4,2,1,2,209,False,1,0,0,1014,9,171.48888888888888,Document
Python,547,7160,2225.5792939814814,MERGED,3,194,5,1,8,13,False,0,1,1,963,197,146.3813888888889,Document
TypeScript,4,33,751.1705208333333,MERGED,0,3,1,2,4,192,True,1,1,1,929,3,116.75777777777778,Bug
TypeScript,3392,2334,958.3556365740741,MERGED,0,8,1,2,1,257,False,0,2,1,1356,8,37.26444444444444,Feature
TypeScript,41369,87411,2925.6893055555556,MERGED,60,548,9,0,16,107,False,0,0,0,3674,608,673.8205555555555,Document
Java,450,746,4064.059548611111,MERGED,54,75,4,1,4,27,False,0,1,1,3439,129,3.428611111111111,Bug
Rust,433,2229,225.37739583333334,MERGED,10,38,5,1,1,728,False,0,1,1,782,48,58.98861111111111,Bug
C#,80,125,807.7786574074074,MERGED,143,2984,36,0,32,168,False,0,0,0,1008,3127,164.91194444444446,Document
TypeScript,1297,21107,406.0385763888889,MERGED,31,33,8,1,1,890,True,0,1,1,3203,64,0.0125,Document
Rust,3808,5430,432.9599768518519,MERGED,168,164,11,0,1,233,False,0,0,0,3405,332,168.73638888888888,Feature
TypeScript,1297,21107,405.83947916666665,MERGED,172,210,12,1,4,887,True,0,1,1,2913,382,0.29138888888888886,Document
C#,80,125,808.6045601851852,MERGED,3,4436,36,0,10,159,True,0,0,0,742,4439,118.71194444444444,Document
TypeScript,41369,87411,2926.4460069444444,MERGED,24,46,3,0,8,65,True,0,0,0,2984,70,125.22722222222222,Document
C#,80,125,806.9270717592593,MERGED,119,2245,58,0,14,193,True,0,0,0,848,2364,184.20472222222222,Document
V,2097,34361,1541.8567939814814,MERGED,4,27,2,0,1,8,True,0,0,0,2328,31,13.825555555555555,Document
Rust,264,5382,390.8934953703704,MERGED,7,118,6,1,3,209,True,0,1,1,3242,125,2.0555555555555554,Bug
Java,450,746,4061.2232060185183,MERGED,18,29,5,2,6,139,False,0,2,1,2497,47,89.44111111111111,Bug
C++,2234,23694,2344.0269560185184,MERGED,65,293,3,1,7,261,False,0,1,1,3033,358,43.91361111111111,Feature
TypeScript,3989,23860,2817.079594907407,MERGED,2,3,1,1,1,239,True,0,1,1,821,5,2.9058333333333333,Document
TypeScript,41369,87411,2923.9411805555555,MERGED,0,244,2,0,1,1562,True,0,0,0,2477,244,0.5222222222222223,Document
Java,547,304,220.57825231481482,MERGED,0,19,1,0,4,1,False,0,0,0,1707,19,80.25527777777778,Document
TypeScript,15,34,481.54847222222224,MERGED,104,281,11,0,3,304,False,0,0,0,3460,385,2.187222222222222,Feature
Java,547,304,220.17369212962964,MERGED,0,11,1,0,1,0,False,0,0,0,1797,11,8.170833333333333,Document
Java,547,304,220.1630324074074,MERGED,0,28,1,0,5,0,False,0,0,0,1736,28,90.0425,Feature
Java,547,304,219.98761574074072,MERGED,0,14,1,0,2,2,False,0,0,0,1756,14,69.68055555555556,Document
TypeScript,3392,2334,956.2175000000001,CLOSED,75,80,6,1,2,297,False,0,1,1,6491,155,2415.0427777777777,Document
TypeScript,2071,16638,1229.3556944444445,MERGED,1,1,1,0,1,0,False,0,0,0,2284,2,0.7338888888888889,Document
Java,547,304,219.0159837962963,MERGED,0,17,1,1,7,1,False,1,0,0,1792,17,1.8566666666666667,Document
Java,547,304,219.1148726851852,MERGED,0,6,1,0,8,515,False,0,0,0,1648,6,87.45861111111111,Document
Java,547,304,219.12362268518518,MERGED,0,6,1,0,21,516,False,0,0,0,1807,6,87.28583333333333,Document
Java,547,304,218.76828703703703,MERGED,0,20,1,0,3,0,False,0,0,0,1642,20,4.098611111111111,Document
Java,547,304,220.17057870370368,MERGED,0,4,1,0,10,520,False,0,0,0,1945,4,89.92444444444445,Document
TypeScript,41369,87411,2926.0631828703704,MERGED,24,19,5,0,2,401,True,0,0,0,3104,43,9.578611111111112,Document
Java,547,304,220.85321759259259,MERGED,0,5,1,0,2,3,False,0,0,0,1717,5,73.6775,Document
Python,547,7160,2226.6866435185184,CLOSED,109,82,3,0,1,117,False,0,0,0,903,191,2.1141666666666667,Bug
TypeScript,85,722,306.8417361111111,MERGED,14,25,12,2,5,0,False,1,1,1,6816,39,242.54555555555555,Document
TypeScript,15,34,479.20754629629624,MERGED,16,60,3,0,4,155,False,0,0,0,3418,76,59.105,Bug
TypeScript,41369,87411,2925.474837962963,MERGED,36,375,9,1,30,105,False,0,1,1,3391,411,598.7419444444445,Document
Java,547,304,217.55318287037036,MERGED,0,17,2,2,5,0,False,2,0,0,1760,17,32.44444444444444,Document
Java,547,304,219.1300810185185,MERGED,0,4,1,0,9,519,False,0,0,0,1938,4,114.76861111111111,Document
TypeScript,2147,14722,1458.7929861111113,MERGED,2,3,2,0,2,35,False,0,0,0,807,5,1.8519444444444444,Feature
Java,547,304,218.80569444444447,MERGED,0,27,1,0,3,1,False,0,0,0,1858,27,3.3955555555555557,Document
Java,547,304,217.13412037037037,MERGED,0,7,1,4,2,0,False,2,2,1,1669,7,42.62722222222222,Document
TypeScript,15,34,478.802337962963,MERGED,15,211,9,0,10,889,False,0,0,0,3052,226,66.28277777777778,Document
TypeScript,1297,21107,404.04364583333336,MERGED,15,22,7,1,1,882,True,0,1,1,2822,37,0.14222222222222222,Document
Erlang,2054,12122,3783.3877662037034,MERGED,41,1069,10,0,13,130,False,0,0,0,1233,1110,307.90555555555557,Document
Erlang,2054,12122,3781.452488425926,MERGED,11,49,3,0,2,307,False,0,0,0,989,60,39.5725,Document
JavaScript,5139,7048,1190.8664583333332,MERGED,22,814,11,2,3,85,False,0,2,2,3509,836,37.97472222222222,Feature
Java,547,304,215.94587962962964,MERGED,0,25,1,0,3,2,False,0,0,0,1846,25,70.87166666666667,Document
Rust,3808,5430,433.85023148148144,MERGED,6,71,3,0,2,460,False,0,0,0,2016,77,17.546944444444446,Bug
TypeScript,41369,87411,2924.6650694444447,MERGED,26,1518,9,2,14,10,False,1,1,1,3483,1544,594.7588888888889,Document
Vue,0,1,235.10288194444445,MERGED,1,2,1,0,1,54,False,0,0,0,865,3,0.26361111111111113,Feature
Java,547,304,215.79446759259258,MERGED,0,32,1,0,2,5,False,0,0,0,1741,32,43.32388888888889,Document
TypeScript,1297,21107,403.07769675925925,MERGED,11,3,3,1,1,877,True,0,1,1,3080,14,0.17444444444444446,Document
Java,547,304,215.35162037037037,MERGED,0,8,1,0,2,356,False,0,0,0,1613,8,85.02416666666667,Document
Java,547,304,215.3508101851852,MERGED,0,8,1,0,1,355,False,0,0,0,1728,8,15.619166666666667,Document
Java,547,304,215.34886574074073,MERGED,0,8,1,0,2,353,False,0,0,0,1754,8,85.06222222222222,Document
Java,547,304,215.35444444444445,MERGED,0,8,1,0,2,359,False,0,0,0,1676,8,84.98722222222223,Document
Java,547,304,215.34670138888887,MERGED,0,8,1,0,2,351,False,0,0,0,1902,8,84.99138888888889,Document
Java,547,304,215.78957175925927,MERGED,0,12,1,0,6,511,False,0,0,0,1766,12,74.59,Document
Java,547,304,215.35534722222224,MERGED,0,8,1,0,1,360,False,0,0,0,1904,8,35.312777777777775,Document
Java,547,304,215.35380787037036,MERGED,0,8,1,0,2,358,False,0,0,0,1585,8,84.99222222222222,Document
Java,547,304,215.35716435185188,MERGED,0,8,1,0,2,362,False,0,0,0,1578,8,84.93972222222222,Document
TypeScript,41369,87411,2928.726134259259,MERGED,2,26,3,3,10,18,False,1,2,1,3686,28,413.07055555555553,Document
Java,547,304,216.02027777777778,MERGED,0,4,1,0,15,512,False,0,0,0,1771,4,11.6425,Document
Java,547,304,215.03180555555556,MERGED,0,12,1,0,13,508,False,0,0,0,1822,12,92.52805555555555,Document
Rust,3808,5430,433.57858796296296,MERGED,38,117,3,1,3,25,False,1,0,0,4160,155,8.640555555555556,Bug
JavaScript,9664,43889,3644.9850462962963,MERGED,38,132,12,0,1,75,False,0,0,0,704,170,1.875,Bug
TypeScript,307,2556,526.6989699074074,MERGED,1,2,1,1,1,19,True,0,1,1,643,3,0.8163888888888889,Bug
TypeScript,41369,87411,2925.854652777778,MERGED,14,17,2,2,3,397,True,1,1,1,3058,31,1.6972222222222222,Document
Python,547,7160,2224.7672916666666,CLOSED,11,10,2,0,4,116,False,0,0,0,1017,21,2.9163888888888887,Bug
TypeScript,41369,87411,2925.8733680555556,MERGED,13,14,2,0,1,398,True,0,0,0,2890,27,0.4452777777777778,Document
Rust,3808,5430,432.6637152777778,MERGED,8,90,2,0,1,43,False,0,0,0,1361,98,0.1661111111111111,Bug
TypeScript,41369,87411,2925.743287037037,MERGED,29,20,2,0,2,396,True,0,0,0,2951,49,1.9469444444444444,Document
TypeScript,7,6,636.2103703703704,MERGED,83,180,6,0,10,218,False,0,0,0,5375,263,162.78194444444443,Feature
TypeScript,261,3765,668.5945717592592,MERGED,8,87,10,0,11,2,False,0,0,0,3495,95,8.103055555555555,Document
TypeScript,41369,87411,2925.696736111111,MERGED,10,10,2,0,1,395,True,0,0,0,2938,20,0.545,Document
TypeScript,41369,87411,2925.6764004629626,MERGED,19,1,3,0,3,394,True,0,0,0,2942,20,1.023611111111111,Document
TypeScript,41369,87411,2925.6451851851853,MERGED,15,15,2,0,3,392,True,0,0,0,2841,30,1.0366666666666666,Document
TypeScript,41369,87411,2925.5261689814815,MERGED,1,1,1,0,1,390,True,0,0,0,2160,2,3.9027777777777777,Document
Erlang,2054,12122,3787.4934953703705,MERGED,3,52,4,0,1,3,False,0,0,0,1291,55,164.15833333333333,Document
C#,80,125,806.417488425926,MERGED,6,263,12,1,4,156,True,1,0,0,976,269,23.595,Document
C#,80,125,806.3876388888889,MERGED,2,2,1,0,1,155,True,0,0,0,800,4,23.58,Document
TypeScript,41369,87411,2923.7560532407406,MERGED,12941,12704,25,1,8,567,True,0,1,1,2692,25645,65.46305555555556,Document
TypeScript,1297,21107,407.1028125,CLOSED,26,54,7,2,8,0,False,0,2,2,1524,80,217.68555555555557,Document
TypeScript,85,722,309.1115740740741,MERGED,520,589,18,0,2,89,False,0,0,0,6740,1109,4.766944444444444,Document
TypeScript,41369,87411,2924.464872685185,MERGED,12,52,3,0,3,1564,True,0,0,0,2560,64,1.0358333333333334,Document
TypeScript,41369,87411,2924.416331018518,MERGED,1,4,1,0,1,1563,True,0,0,0,2225,5,0.4930555555555556,Document
TypeScript,69,2214,304.72283564814813,MERGED,38,1333,20,3,5,12,False,0,3,2,4083,1371,51.49111111111111,Document
Rust,3808,5430,429.40531250000004,CLOSED,238,490,5,0,1,5,False,0,0,0,3717,728,98.3575,Feature
TypeScript,41369,87411,2924.2174884259257,MERGED,4,40,4,18,7,5,False,6,12,5,3206,44,367.0547222222222,Document
TypeScript,178,1359,313.7096759259259,MERGED,0,55,8,4,1,0,False,1,3,2,5133,55,31.396944444444443,Feature
TypeScript,41369,87411,2924.6252083333334,MERGED,59,965,10,1,8,9,False,1,0,0,3706,1024,479.75166666666667,Document
Erlang,2054,12122,3784.182835648148,MERGED,5,1552,25,0,2,72,True,0,0,0,1127,1557,243.9336111111111,Document
C#,80,125,812.7493171296296,CLOSED,1045,1065,5,0,6,68,False,0,0,0,1017,2110,162.78083333333333,Document
Erlang,2054,12122,3782.285636574074,MERGED,12,1671,23,2,1,35,False,2,0,0,1193,1683,309.55861111111113,Document
TypeScript,41369,87411,2923.7995254629627,MERGED,3,4,1,0,1,1,False,0,0,0,2384,7,1.1713888888888888,Document
Erlang,2054,12122,3789.186400462963,CLOSED,1,2,1,1,1,133,False,1,0,0,1136,3,25.656666666666666,Document
C#,80,125,811.6588657407407,CLOSED,122,170,212,0,9,66,False,0,0,0,1214,292,198.92583333333334,Document
Go,1835,11245,1716.654675925926,MERGED,1,1,1,0,3,73,False,0,0,0,821,2,0.0925,Feature
Python,137,75,676.9572569444445,MERGED,2,8,3,1,8,1,False,1,0,0,1230,10,56.49916666666667,Bug
Erlang,2054,12122,3788.8634837962964,MERGED,134,58,15,0,3,987,True,0,0,0,1151,192,31.694444444444443,Document
Starlark,440,286,482.4882523148148,MERGED,1,3,1,2,1,2,False,1,1,1,1452,4,57.42777777777778,Bug
Rust,264,5382,397.0743518518518,MERGED,0,66,8,0,1,382,False,0,0,0,4271,66,2.4922222222222223,Feature
TypeScript,139,827,739.2955902777777,MERGED,0,33,1,2,3,19,False,0,2,2,1439,33,15.150833333333333,Feature
TypeScript,7,6,637.382673611111,MERGED,26,22,9,0,13,7,False,0,0,0,4575,48,16.901944444444446,Bug
PHP,0,0,99.14780092592594,MERGED,2,45,3,0,3,30,False,0,0,0,4061,47,0.025555555555555557,Document
TypeScript,3989,23860,2821.834664351852,MERGED,3,3,1,1,1,151,True,0,1,1,992,6,0.9075,Feature
TypeScript,261,3765,669.9484606481482,MERGED,536,902,27,0,8,178,False,0,0,0,5722,1438,18.71361111111111,Document
Python,137,75,673.4730787037037,MERGED,0,689,8,4,20,1,False,0,4,2,1477,689,159.66,Feature
Python,2407,12180,232.75247685185184,MERGED,35,82,15,0,15,229,True,0,0,0,1622,117,36.72805555555556,Document
TypeScript,41369,87411,2926.7536805555555,CLOSED,2,252,3,0,1,70,True,0,0,0,3661,254,1.98,Document
Erlang,2054,12122,3788.2566550925926,MERGED,13,37,5,0,2,49,False,0,0,0,1215,50,16.438333333333333,Document
Erlang,2054,12122,3788.1391898148145,MERGED,377,927,62,0,55,986,True,0,0,0,1331,1304,17.557222222222222,Document
Rust,264,5382,390.9228472222222,MERGED,13,128,19,1,4,210,True,1,0,0,4485,141,196.11666666666667,Bug
Erlang,2054,12122,3782.9783680555556,MERGED,15,20,5,1,4,348,True,1,0,0,1297,35,195.24583333333334,Document
Starlark,440,286,481.4437037037037,MERGED,1,1,1,0,2,1,False,0,0,0,1415,2,13.490277777777777,Bug
Erlang,2054,12122,3781.9251851851855,MERGED,29,32,6,0,7,126,False,0,0,0,967,61,216.03583333333333,Document
Starlark,440,286,480.90057870370373,MERGED,1,1,1,0,2,1,False,0,0,0,1262,2,26.5475,Document
JavaScript,9664,43889,3651.0534375,MERGED,6,304,7,0,1,620,False,0,0,0,1217,310,0.2861111111111111,Feature
TypeScript,3392,2334,960.077337962963,MERGED,9,23,5,2,4,447,False,0,2,1,1683,32,22.776944444444446,Document
C#,80,125,811.3623611111111,MERGED,15,2778,28,1,20,160,True,1,0,0,1010,2793,101.98777777777778,Document
JavaScript,34,25,191.05800925925925,MERGED,2,7,2,0,1,70,False,0,0,0,1523,9,0.5638888888888889,Bug
TypeScript,15,34,479.5602546296296,MERGED,14,30,8,0,9,471,True,0,0,0,4489,44,245.1175,Bug
Python,2407,12180,230.86313657407405,MERGED,3,12,3,2,6,66,True,0,2,2,1172,15,23.235555555555557,Document
Starlark,440,286,479.39770833333336,MERGED,1,6,1,0,2,22,False,0,0,0,1408,7,62.63111111111111,Feature
Starlark,440,286,479.24834490740744,MERGED,16,16,2,0,2,46,False,0,0,0,1304,32,66.22194444444445,Feature
Erlang,2054,12122,3784.3182060185186,MERGED,2,24,1,0,1,317,False,0,0,0,1482,26,91.3725,Document
Erlang,2054,12122,3784.1452546296296,MERGED,17,235,4,0,1,316,False,0,0,0,1258,252,95.65638888888888,Document
C#,80,125,812.8881712962963,MERGED,5,56,5,0,1,177,False,0,0,0,1278,61,16.39638888888889,Document
TypeScript,41369,87411,2926.9373032407407,CLOSED,2,174,4,4,1,0,False,1,3,2,3489,176,235.49972222222223,Document
JavaScript,5139,7048,1196.7615856481482,MERGED,76,193,7,2,3,88,False,0,2,2,5016,269,139.62222222222223,Document
TypeScript,85,722,308.08040509259257,MERGED,5,876,33,0,22,2,False,0,0,0,8868,881,333.6438888888889,Document
JavaScript,34,25,190.3310300925926,MERGED,0,36,3,0,1,32,False,0,0,0,1573,36,0.08361111111111111,Bug
TypeScript,178,1359,310.1131712962963,MERGED,67,110,6,1,2,14,True,0,1,1,5243,177,0.6163888888888889,Bug
Erlang,2054,12122,3783.013298611111,MERGED,291,718,47,0,28,981,True,0,0,0,1443,1009,122.61583333333333,Document
JavaScript,5139,7048,1195.621284722222,MERGED,58,54,7,1,1,244,False,0,1,1,8828,112,165.07666666666665,Bug
TypeScript,2071,16638,1229.498298611111,MERGED,9,25,2,0,5,24,True,0,0,0,3574,34,124.63194444444444,Bug
TypeScript,3392,2334,959.2069444444445,MERGED,0,6,2,1,2,678,False,0,1,1,1300,6,15.438055555555556,Feature
TypeScript,139,827,740.085798611111,MERGED,2,5,3,2,2,99,False,0,2,2,1691,7,5.3341666666666665,Document
Go,421,1654,1497.958726851852,MERGED,15,83,14,1,5,80,False,0,1,1,4947,98,169.78666666666666,Document
Go,421,1654,1498.2564351851852,MERGED,63,48,2,0,1,235,False,0,0,0,5907,111,146.1838888888889,Bug
TypeScript,202,107,1135.7992476851853,MERGED,36,72,3,4,2,238,True,0,4,4,4303,108,23.51861111111111,Bug
V,2097,34361,1543.8005092592593,MERGED,5,83,2,1,3,29,True,1,0,0,3711,88,10.081388888888888,Document
JavaScript,8844,63474,4066.3850925925926,MERGED,28,193,4,0,1,101,True,0,0,0,4762,221,0.5927777777777777,Document
TypeScript,4,33,753.6869212962962,MERGED,1,1,1,1,1,157,False,0,1,1,1096,2,0.0575,Feature
TypeScript,3392,2334,957.4334375,MERGED,16,26,4,1,3,677,False,0,1,1,1816,42,58.00833333333333,Bug
TypeScript,3392,2334,957.2546874999999,MERGED,11,13,1,2,2,256,False,0,2,1,1679,24,63.709722222222226,Feature
TypeScript,3392,2334,957.0135879629629,MERGED,2,102,3,2,5,255,False,0,2,1,1931,104,69.51388888888889,Feature
Go,1835,11245,1714.8540740740739,CLOSED,0,0,0,2,0,0,False,0,2,1,2240,0,677.4266666666666,Bug
TypeScript,3392,2334,956.9630787037037,MERGED,1,1,1,2,1,254,False,0,2,1,1352,2,70.75527777777778,Feature
TypeScript,139,827,739.1830324074075,MERGED,0,60,2,2,1,98,False,0,2,2,1142,60,5.818611111111111,Document
Python,2407,12180,228.6610648148148,MERGED,11,51,5,1,13,65,True,0,1,1,1366,62,30.28638888888889,Bug
TypeScript,4,33,751.2145949074074,CLOSED,133,655,12,1,15,378,True,0,1,1,1318,788,83.94555555555556,Document
TypeScript,2147,14722,1460.0242824074076,MERGED,39,70,4,0,2,658,False,0,0,0,4869,109,22.044444444444444,Document
Starlark,440,286,481.17381944444446,MERGED,0,224,2,3,12,0,False,3,0,0,2065,224,261.49,Document
JavaScript,5139,7048,1197.5406597222222,MERGED,5,18,2,4,4,21,False,0,4,3,1589,23,29.67527777777778,Feature
TypeScript,41369,87411,2929.0619907407404,MERGED,8,46,4,0,5,72,True,0,0,0,4100,54,63.94,Document
Rust,264,5382,391.94268518518516,MERGED,71,122,11,0,2,212,True,0,0,0,4578,193,2.2266666666666666,Bug
TypeScript,139,827,737.165625,MERGED,10,34,1,3,2,97,False,1,2,2,1294,44,19.684722222222224,Document
Python,137,75,672.9702430555556,MERGED,17,27,4,0,3,13,False,0,0,0,1463,44,11.073611111111111,Document
Rust,264,5382,391.75024305555553,MERGED,375,517,16,0,1,69,True,0,0,0,3584,892,0.7802777777777777,Bug
Go,1835,11245,1719.9878472222224,MERGED,1,10,1,0,1,76,False,0,0,0,1248,11,0.07777777777777778,Document
Rust,433,2229,225.54998842592593,MERGED,24,66,6,1,1,732,False,0,1,1,1038,90,16.545833333333334,Feature
Python,2407,12180,227.89943287037036,MERGED,1,1,1,7,2,14,False,3,4,1,1605,2,7.9061111111111115,Document
Python,137,75,672.7797106481481,MERGED,17,19,4,0,1,232,False,0,0,0,1519,36,0.15916666666666668,Document
TypeScript,7,6,631.9115972222222,CLOSED,126,54,6,0,1,215,False,0,0,0,5356,180,0.04722222222222222,Feature
Python,14532,41181,1076.6268634259259,MERGED,5,5,5,0,2,1409,True,0,0,0,1732,10,0.05277777777777778,Document
Java,547,304,221.04627314814817,CLOSED,0,0,0,1,3,3,False,0,1,1,2139,0,69.06222222222222,Document
Java,547,304,220.2732175925926,MERGED,0,14,1,0,10,0,False,0,0,0,2456,14,87.50083333333333,Document
TypeScript,41369,87411,2926.556875,MERGED,9,33,3,0,1,69,True,0,0,0,3666,42,122.64722222222223,Document
TypeScript,41369,87411,2926.4713425925925,MERGED,12,33,3,0,1,67,True,0,0,0,4463,45,125.56194444444445,Document
TypeScript,41369,87411,2926.4576851851853,MERGED,8,23,3,0,1,66,True,0,0,0,3205,31,124.95583333333333,Document
C#,80,125,808.3730671296297,MERGED,31,99,9,0,7,157,True,0,0,0,1414,130,71.96083333333333,Document
TypeScript,41369,87411,2924.4942939814814,MERGED,38,46,1,2,3,389,True,1,1,1,4386,84,6.039444444444444,Document
Erlang,2054,12122,3782.6633217592594,MERGED,0,25,1,1,1,226,True,1,0,0,1093,25,28.58222222222222,Document
TypeScript,17,33,707.0736921296296,MERGED,167,269,30,1,29,160,False,0,1,1,1154,436,20.984444444444446,Feature
Erlang,2054,12122,3783.189317129629,MERGED,7,117,3,0,1,314,False,0,0,0,1210,124,5.706388888888889,Document
Erlang,2054,12122,3783.096898148148,MERGED,2,4,3,0,1,312,False,0,0,0,1392,6,8.050555555555556,Document
TypeScript,41369,87411,2924.9463310185183,MERGED,136,869,9,4,4,46,False,2,2,2,4667,1005,929.9433333333334,Document
TypeScript,307,2556,524.6519328703704,MERGED,19,117,11,1,7,174,True,1,0,0,4038,136,191.68666666666667,Bug
Java,450,746,4061.0056597222224,MERGED,144,262,6,2,8,25,False,0,2,2,4588,406,76.52194444444444,Bug
Erlang,2054,12122,3783.114710648148,MERGED,2,11,3,1,3,313,False,1,0,0,1015,13,4.326944444444444,Document
TypeScript,3392,2334,957.0007754629629,MERGED,76,22,16,1,5,675,False,0,1,1,1745,98,0.3975,Bug
TypeScript,2147,14722,1458.9622800925927,MERGED,23,63,6,0,1,45,False,0,0,0,5740,86,4.522777777777778,Document
Python,2407,12180,227.13350694444443,MERGED,1,1,1,0,2,3,True,0,0,0,1116,2,26.299166666666668,Bug
Java,547,304,218.93805555555556,MERGED,0,36,2,0,9,5,False,0,0,0,2496,36,0.5438888888888889,Document
Java,547,304,219.12627314814813,MERGED,0,4,1,0,9,517,False,0,0,0,2228,4,87.23138888888889,Document
Starlark,440,286,476.02043981481484,MERGED,4,4,1,0,1,2,False,0,0,0,1209,8,42.011944444444445,Bug
Starlark,440,286,475.9865972222222,MERGED,1,1,1,0,1,3,False,0,0,0,1128,2,42.62444444444444,Feature
C#,80,125,806.9279629629629,MERGED,31,378,20,0,11,175,False,0,0,0,1302,409,111.92277777777778,Document
Java,547,304,219.12826388888888,MERGED,0,6,1,0,14,518,False,0,0,0,2775,6,87.19277777777778,Document
Erlang,2054,12122,3782.9114351851854,MERGED,1,1,1,0,1,347,True,0,0,0,1081,2,0.19361111111111112,Document
Erlang,2054,12122,3782.1015740740745,MERGED,9,22,3,0,2,978,True,0,0,0,1335,31,32.341944444444444,Document
TypeScript,41369,87411,2925.7208796296295,MERGED,33,92,3,0,1,108,False,0,0,0,4408,125,129.24138888888888,Document
Erlang,2054,12122,3782.1054050925927,MERGED,1,16,1,0,1,308,False,0,0,0,1159,17,26.334444444444443,Document
Erlang,2054,12122,3782.6810532407403,MERGED,6,5,5,0,2,349,True,0,0,0,1148,11,0.20472222222222222,Document
Go,1835,11245,1716.6800462962963,MERGED,1,1,1,0,5,75,False,0,0,0,997,2,0.026111111111111113,Bug
TypeScript,3392,2334,956.367175925926,MERGED,4,37,2,4,4,444,False,0,4,3,1470,41,1.4502777777777778,Feature
Vue,0,1,235.41508101851852,MERGED,1,1,1,0,1,55,False,0,0,0,998,2,0.042777777777777776,Bug
Java,547,304,217.6134722222222,MERGED,0,12,1,0,31,513,False,0,0,0,2635,12,30.885277777777777,Document
Python,137,75,671.3694097222223,MERGED,3,7,2,0,3,18,False,0,0,0,1100,10,0.7591666666666667,Document
C++,363,552,525.1303240740741,MERGED,12,11,2,0,1,213,False,0,0,0,1463,23,4.904166666666667,Document
Erlang,2054,12122,3781.9209953703703,MERGED,6,7,1,0,1,348,True,0,0,0,1144,13,18.03527777777778,Document
Python,968,6759,47.09238425925926,CLOSED,1,225,2,3,1,4,False,0,3,2,1880,226,114.98833333333333,Bug
Erlang,2054,12122,3781.9959722222225,MERGED,3,138,2,0,2,148,False,0,0,0,1178,141,5.150555555555556,Document
TypeScript,3392,2334,955.3652893518519,MERGED,7,7,1,2,1,0,False,0,2,1,1559,14,15.349166666666667,Document
Erlang,2054,12122,3782.008287037037,MERGED,26,60,3,0,1,127,False,0,0,0,1278,86,1.3325,Document
Erlang,2054,12122,3781.8605324074074,MERGED,33,12,3,0,2,347,True,0,0,0,1387,45,4.636666666666667,Document
Java,547,304,215.74232638888887,MERGED,0,6,1,0,7,510,False,0,0,0,2970,6,75.71194444444444,Document
TypeScript,3392,2334,955.2150231481481,MERGED,2,5,1,1,1,668,False,0,1,1,2035,7,18.5725,Feature
TypeScript,4,33,749.1996180555556,MERGED,1,5,1,1,3,55,False,0,1,1,1216,6,48.82,Feature
Erlang,2054,12122,3781.6798263888886,MERGED,214,369,19,0,52,345,True,0,0,0,1343,583,4.019722222222223,Document
Starlark,440,286,475.8378125,CLOSED,0,0,0,0,0,2,False,0,0,0,1366,0,2.245,Document
Erlang,2054,12122,3781.417210648148,MERGED,3,9,4,0,1,14,False,0,0,0,1234,12,11.914722222222222,Document
PHP,0,0,91.45101851851852,MERGED,161,337,8,0,2,45,True,0,0,0,4007,498,0.021388888888888888,Document
PHP,0,0,91.2193287037037,MERGED,35,70,7,0,2,44,True,0,0,0,3707,105,0.023333333333333334,Document
TypeScript,149,2900,366.49223379629626,MERGED,1,1,1,1,1,83,False,0,1,1,1402,2,0.10305555555555555,Bug
JavaScript,34,25,184.14726851851853,CLOSED,0,0,0,0,0,0,False,0,0,0,1316,0,41.93666666666667,Feature
C#,80,125,806.5600694444444,MERGED,484,748,42,0,8,64,False,0,0,0,1113,1232,48.541666666666664,Document
TypeScript,15,34,479.5285532407408,MERGED,53,78,13,0,1,890,False,0,0,0,4343,131,1.1736111111111112,Feature
TypeScript,3989,23860,2821.2507060185185,MERGED,0,16,1,1,9,241,True,0,1,1,2069,16,52.3575,Document
Python,137,75,676.1883680555555,MERGED,0,35,3,2,3,2,False,0,2,2,1761,35,90.3411111111111,Feature
Python,2407,12180,233.8325925925926,MERGED,1,1,1,4,3,0,False,1,3,1,2029,2,6.2619444444444445,Document
Vue,0,1,233.40357638888887,MERGED,1,1,1,0,1,175,True,0,0,0,1245,2,1.7280555555555555,Feature
Python,2407,12180,233.8480787037037,MERGED,4,10,1,2,2,0,False,1,1,1,1971,14,4.138888888888889,Document
Python,547,7160,2223.88130787037,MERGED,21,35,6,0,10,222,False,0,0,0,981,56,16.116666666666667,Bug
TypeScript,41369,87411,2926.536145833333,MERGED,13,16,2,0,1,402,True,0,0,0,3532,29,0.3913888888888889,Document
Go,1835,11245,1716.6615277777776,MERGED,255,737,17,2,5,74,False,1,1,1,1467,992,79.20777777777778,Feature
Python,137,75,677.5609953703704,MERGED,12,487,20,2,18,19,False,2,0,0,3452,499,490.87444444444446,Document
TypeScript,4,33,748.6234259259259,MERGED,30,46,2,1,3,375,True,0,1,1,1445,76,0.2772222222222222,Bug
TypeScript,1297,21107,402.5187384259259,MERGED,187,198,12,2,2,875,True,0,2,2,3558,385,0.1597222222222222,Document
TypeScript,41369,87411,2925.6628009259257,MERGED,17,15,2,1,1,393,True,1,0,0,3645,32,1.426388888888889,Document
Java,547,304,213.69511574074076,MERGED,1,1,1,0,1,3,False,0,0,0,2083,2,10.516111111111112,Document
TypeScript,3989,23860,2821.347175925926,MERGED,1,1,1,1,1,172,False,0,1,1,1777,2,0.24694444444444444,Document
JavaScript,5139,7048,1197.5532060185185,MERGED,71,253,9,2,8,89,False,0,2,2,10517,324,222.50194444444443,Feature
JavaScript,34,25,183.79591435185185,MERGED,0,30,3,0,1,67,False,0,0,0,1284,30,0.07111111111111111,Feature
TypeScript,15,34,476.7274884259259,MERGED,13,162,6,0,4,885,False,0,0,0,1323,175,17.110277777777778,Feature
Python,2407,12180,232.52644675925924,MERGED,1,1,1,1,2,15,False,0,1,1,1790,2,5.239722222222222,Document
TypeScript,178,1359,314.006875,MERGED,112,100,2,1,1,15,True,0,1,1,9694,212,4.833611111111111,Bug
Java,450,746,4058.110821759259,MERGED,82,74,2,1,3,23,False,0,1,1,3718,156,0.21694444444444444,Document
JavaScript,34,25,191.1161574074074,CLOSED,23334,155,2,0,9,1,False,0,0,0,1954,23489,1.1641666666666666,Bug
C#,80,125,811.5993634259258,MERGED,73,54,4,0,8,195,False,0,0,0,1701,127,69.85472222222222,Document
JavaScript,34,25,190.64097222222222,CLOSED,1,55,3,0,2,1,False,0,0,0,1922,56,0.10388888888888889,Bug
C++,363,552,528.1887962962963,MERGED,0,122,2,0,1,215,False,0,0,0,2065,122,2.6886111111111113,Document
Python,14532,41181,1078.2012268518517,MERGED,3,3,2,0,1,1410,True,0,0,0,1915,6,0.015,Document
Python,137,75,673.9500694444445,MERGED,0,26,3,0,2,14,False,0,0,0,1651,26,4.7619444444444445,Document
TypeScript,3392,2334,956.925775462963,MERGED,8,8,2,2,1,253,False,0,2,1,1938,16,78.18611111111112,Feature
Python,2407,12180,229.58836805555555,MERGED,1,1,1,3,2,0,False,2,1,1,1858,2,5.100555555555555,Document
TypeScript,3392,2334,957.5137962962963,MERGED,0,41,3,2,1,446,False,0,2,1,1673,41,9.937777777777777,Feature
Python,14532,41181,1076.3093055555555,MERGED,11,11,3,0,3,1407,True,0,0,0,2101,22,0.6705555555555556,Bug
TypeScript,2071,16638,1230.150150462963,MERGED,19,94,2,0,1,1,False,0,0,0,6184,113,429.83194444444445,Bug
Rust,3808,5430,432.7746527777778,MERGED,490,600,10,0,1,232,False,0,0,0,5359,1090,95.0075,Feature
Python,137,75,670.9885300925926,MERGED,0,84,4,0,3,12,False,0,0,0,2090,84,58.71527777777778,Document
TypeScript,3392,2334,957.4200347222222,MERGED,3,10,2,1,1,676,False,0,1,1,2421,13,0.17666666666666667,Bug
TypeScript,3392,2334,957.3485879629629,MERGED,2,2,2,2,1,445,False,0,2,1,1660,4,0.1711111111111111,Bug
JavaScript,3618,9017,2273.968923611111,CLOSED,1,15,2,9,2,33,False,4,5,3,2469,16,484.535,Feature
Starlark,440,286,476.5995833333333,MERGED,8,7,1,0,1,45,False,0,0,0,2096,15,28.170555555555556,Bug
Starlark,440,286,476.02125,MERGED,0,294,2,5,1,0,False,5,0,0,1873,294,42.04666666666667,Feature
TypeScript,3392,2334,956.0128472222223,MERGED,45,25,5,1,2,673,False,0,1,1,2466,70,20.295833333333334,Feature
TypeScript,3392,2334,953.9323495370371,MERGED,4,12,3,1,1,664,False,0,1,1,2025,16,101.31361111111111,Feature
TypeScript,3392,2334,956.3606249999999,MERGED,1,5,1,2,1,340,False,0,2,1,2037,6,0.19805555555555557,Feature
Vue,0,1,235.1056597222222,MERGED,9,123,10,0,1,177,True,0,0,0,1830,132,0.2086111111111111,Document
Rust,3808,5430,433.56881944444444,MERGED,252,301,22,0,1,459,False,0,0,0,7085,553,10.982777777777779,Document
Erlang,2054,12122,3782.251689814815,MERGED,5,72,4,0,1,309,False,0,0,0,1521,77,1.6752777777777779,Document
Vue,0,1,234.98085648148148,MERGED,32,1,5,0,1,52,False,0,0,0,2176,33,0.5944444444444444,Bug
TypeScript,3392,2334,956.117048611111,MERGED,4,5,1,1,2,296,False,0,1,1,1687,9,0.4866666666666667,Bug
Python,2407,12180,226.8873148148148,MERGED,9,16,2,1,3,221,True,1,0,0,2103,25,0.9936111111111111,Document
TypeScript,3392,2334,955.8865856481481,MERGED,6,39,3,1,1,669,False,0,1,1,2080,45,1.0044444444444445,Bug
Vue,0,1,234.3647222222222,MERGED,29,58,9,0,2,176,True,0,0,0,2247,87,14.511944444444444,Bug
Rust,591,3260,540.3529745370371,CLOSED,25,553,21,0,2,73,False,0,0,0,9565,578,2380.9544444444446,Document
TypeScript,3392,2334,955.2779282407408,MERGED,5,32,5,2,5,294,False,0,2,1,2128,37,17.113055555555555,Feature
C#,80,125,807.8603703703703,MERGED,202,367,33,0,6,50,True,0,0,0,1916,569,20.238333333333333,Document
C++,363,552,523.4449305555555,MERGED,3,2,2,0,5,210,False,0,0,0,2019,5,18.59722222222222,Document
Rust,3808,5430,433.4670833333333,MERGED,14,16,2,0,1,115,False,0,0,0,2888,30,2.07,Document
Go,1835,11245,1719.0131250000002,MERGED,3,3,2,0,1,505,False,0,0,0,1954,6,16.86,Document
TypeScript,3392,2334,954.1737384259259,MERGED,5,0,3,1,1,666,False,0,1,1,2051,5,1.2302777777777778,Feature
Go,1835,11245,1717.9866203703705,MERGED,17,1,2,0,1,504,False,0,0,0,1819,18,4.602222222222222,Document
TypeScript,261,3765,663.765474537037,MERGED,401,859,28,0,16,176,False,0,0,0,8326,1260,0.4216666666666667,Document
Rust,264,5382,391.9408564814815,MERGED,87,94,30,0,1,70,True,0,0,0,6036,181,195.1911111111111,Feature
JavaScript,22,26,911.1191203703703,MERGED,7,234,7,0,2,11,True,0,0,0,2848,241,9.09361111111111,Feature
JavaScript,8844,63474,4069.9657175925927,MERGED,59,427,25,0,7,85,True,0,0,0,6263,486,31.403055555555557,Bug
PHP,0,0,98.21489583333333,MERGED,1,433,10,0,2,28,False,0,0,0,4844,434,0.025,Document
Go,789,5551,1032.3459027777778,MERGED,3,3,1,2,1,189,True,2,0,0,2192,6,59.82388888888889,Document
JavaScript,8844,63474,4068.5002430555555,MERGED,2,134,14,0,3,82,True,0,0,0,6583,136,66.32027777777778,Document
Python,137,75,677.4188310185185,MERGED,37,29,13,2,23,1,False,0,2,2,3360,66,40.38611111111111,Bug
TypeScript,307,2556,526.7671527777778,MERGED,44,53,17,0,3,554,True,0,0,0,5309,97,305.42277777777775,Feature
Java,450,746,4061.3344791666664,MERGED,262,274,11,2,21,26,False,0,2,2,6618,536,88.41083333333333,Bug
Erlang,2054,12122,3788.1805787037033,MERGED,26,23,8,1,2,318,False,0,1,1,1976,49,21.531388888888888,Document
Python,2407,12180,229.83388888888888,MERGED,1,1,1,1,2,2,False,0,1,1,3457,2,2.080277777777778,Document
TypeScript,3989,23860,2821.267685185185,MERGED,2,9,2,1,1,171,False,0,1,1,2323,11,0.11444444444444445,Document
TypeScript,1297,21107,409.6240740740741,MERGED,154,555,15,2,5,909,True,0,2,2,5942,709,0.14472222222222222,Document
Python,2407,12180,231.68297453703704,MERGED,256,583,65,0,28,227,True,0,0,0,7792,839,11.280833333333334,Document
Starlark,440,286,479.1288310185185,MERGED,262,188,1,0,4,7,False,0,0,0,2255,450,136.5,Feature
Erlang,2054,12122,3783.4609490740745,MERGED,121,437,19,0,1,127,False,0,0,0,2011,558,180.00416666666666,Document
PHP,0,0,96.06037037037038,MERGED,32,180,30,0,5,25,False,0,0,0,6677,212,0.04722222222222222,Document
Starlark,440,286,482.0976273148148,CLOSED,0,157,2,0,2,1,False,0,0,0,2332,157,0.023333333333333334,Feature
Starlark,440,286,476.01957175925924,MERGED,0,696,4,0,4,7,False,0,0,0,2085,696,211.03416666666666,Document
JavaScript,34,25,190.64635416666667,MERGED,1,55,3,2,2,2,False,0,2,1,2521,56,0.3288888888888889,Bug
TypeScript,4,33,755.2112152777778,MERGED,213,234,28,2,2,590,True,1,1,1,2819,447,2.098333333333333,Bug
JavaScript,8844,63474,4066.388275462963,MERGED,24,145,5,0,3,80,True,0,0,0,7190,169,0.7408333333333333,Document
TypeScript,307,2556,526.4899189814815,MERGED,47,124,4,2,2,175,True,0,2,2,4646,171,172.75972222222222,Bug
TypeScript,4,33,754.3992939814815,MERGED,7,83,6,2,3,586,True,1,1,1,2569,90,22.151944444444446,Document
TypeScript,3989,23860,2818.394953703704,MERGED,22,61,8,2,1,0,False,1,1,1,3058,83,2.1691666666666665,Document
TypeScript,1297,21107,407.009212962963,MERGED,29,79,9,1,1,896,True,0,1,1,4981,108,0.2638888888888889,Document
Python,2407,12180,229.46715277777778,MERGED,1,1,1,3,3,0,False,1,2,2,2351,2,14.325833333333334,Document
TypeScript,58,78,812.6214467592594,MERGED,188,763,29,1,7,171,False,0,1,1,15352,951,65.3175,Bug
TypeScript,1297,21107,406.5685185185185,MERGED,4836,16149,357,2,6,893,True,0,2,2,7292,20985,1.0680555555555555,Document
Go,1835,11245,1715.8405787037036,MERGED,752,6113,81,1,10,15,True,0,1,1,7046,6865,667.3922222222222,Bug
Vue,0,1,238.29479166666667,MERGED,1,176,6,0,13,34,False,0,0,0,2342,177,0.6316666666666667,Feature
Python,2407,12180,229.81332175925925,MERGED,67,167,13,0,38,225,True,0,0,0,2684,234,2.5091666666666668,Document
TypeScript,3989,23860,2817.435972222222,MERGED,28,54,7,1,4,240,True,0,1,1,3158,82,19.642777777777777,Feature
Python,14532,41181,1078.262662037037,MERGED,16,22,2,0,7,1411,True,0,0,0,2381,38,2.5019444444444443,Document
Java,547,304,214.87758101851853,MERGED,0,138,1,1,5,4,False,1,0,0,3148,138,16.844166666666666,Document
Java,547,304,214.81104166666668,MERGED,122,157,2,0,8,3,False,0,0,0,3967,279,97.80694444444444,Document
Rust,264,5382,391.0285532407408,MERGED,126,233,16,1,1,68,True,1,0,0,6855,359,3.605,Bug
TypeScript,41369,87411,2926.543391203704,MERGED,15,41,4,0,1,68,True,0,0,0,5454,56,122.955,Document
Rust,264,5382,390.15989583333334,MERGED,87,92,3,0,1,208,True,0,0,0,6507,179,16.55611111111111,Bug
Starlark,440,286,478.7446296296296,MERGED,6,14,1,2,5,3,False,1,1,1,2283,20,4.128611111111111,Bug
TypeScript,4,33,751.2474537037037,MERGED,230,442,41,1,7,379,True,0,1,1,2718,672,81.40027777777777,Bug
Java,547,304,214.91145833333334,MERGED,0,6,1,0,13,506,False,0,0,0,3555,6,1.5902777777777777,Document
TypeScript,41369,87411,2926.0599305555556,CLOSED,22,283,5,5,2,1,False,3,2,2,6019,305,96.2325,Document
JavaScript,34,25,185.8864583333333,CLOSED,14,35,1,2,2,0,False,0,2,2,3058,49,84.17722222222223,Feature
Python,2407,12180,228.22275462962963,MERGED,123,142,3,0,10,223,True,0,0,0,2275,265,0.09222222222222222,Document
Erlang,2054,12122,3783.2590393518517,MERGED,2,2,2,0,1,315,False,0,0,0,1931,4,2.4477777777777776,Document
Python,137,75,671.7050694444445,MERGED,7,25,6,0,3,231,False,0,0,0,2852,32,2.5919444444444446,Bug
Vue,0,1,235.12466435185183,MERGED,11,41,4,0,1,178,True,0,0,0,2708,52,0.03861111111111111,Bug
TypeScript,1297,21107,403.52094907407405,MERGED,97,104,4,2,1,879,True,0,2,2,7999,201,0.22833333333333333,Document
TypeScript,41369,87411,2926.0233217592595,CLOSED,14,285,5,5,7,0,False,1,4,1,5777,299,0.9061111111111111,Document
Vue,0,1,234.4006712962963,MERGED,3,10,3,0,1,51,False,0,0,0,2658,13,0.14416666666666667,Bug
TypeScript,3392,2334,955.3620138888888,MERGED,1,302,13,1,4,295,False,0,1,1,2720,303,21.176666666666666,Feature
TypeScript,1297,21107,402.7341550925926,MERGED,267,121,23,2,8,876,True,0,2,2,8091,388,4.223611111111111,Document
TypeScript,41369,87411,2925.9229976851852,MERGED,68,61,5,0,8,399,True,0,0,0,5202,129,1.5891666666666666,Document
TypeScript,15,34,477.0495833333334,MERGED,25482,39176,13,0,18,152,False,0,0,0,4922,64658,29.170277777777777,Bug
Rust,3808,5430,432.79097222222225,CLOSED,41,2804,19,0,1,84,False,0,0,0,10577,2845,30.646944444444443,Document
TypeScript,41369,87411,2924.758888888889,MERGED,92,183,8,0,6,1565,True,0,0,0,4715,275,4.891666666666667,Document
TypeScript,4,33,748.6791666666667,MERGED,291,330,48,1,4,152,False,0,1,1,2916,621,0.1425,Feature
Python,1912,12139,61.16432870370371,CLOSED,0,5202,14,2,3,2,False,0,2,2,4739,5202,183.98472222222222,Feature
TypeScript,15,34,475.80357638888887,MERGED,50,116,9,0,4,301,False,0,0,0,6219,166,11.926944444444445,Bug
Go,30,295,340.16625,MERGED,4,159,17,3,4,89,True,0,3,2,11023,163,43.555277777777775,Bug
Go,1835,11245,1716.6047222222223,MERGED,179,198,6,0,1,503,False,0,0,0,2917,377,3.7080555555555557,Document
Go,1835,11245,1715.7875694444444,MERGED,0,19,3,0,1,502,False,0,0,0,2495,19,1.498888888888889,Document
Rust,264,5382,392.0729861111111,MERGED,717,1233,58,0,1,150,False,0,0,0,8260,1950,191.57722222222222,Feature
Starlark,440,286,479.58959490740745,MERGED,0,296,2,2,13,0,False,2,0,0,4244,296,299.49305555555554,Feature
TypeScript,184,377,1899.875,MERGED,3,4,1,1,1,203,False,1,0,0,2918,7,143.00722222222223,Document
TypeScript,184,377,1904.7295138888887,MERGED,1,15,1,0,16,207,False,0,0,0,2908,16,26.682777777777776,Document
Python,547,7160,2230.4647222222225,MERGED,55,475,12,4,47,220,False,2,2,2,11095,530,562.9605555555555,Bug
Rust,591,3260,540.0935069444445,MERGED,0,30,6,0,1,72,False,0,0,0,3323,30,32.11666666666667,Document
TypeScript,1297,21107,408.175613425926,MERGED,103,367,11,2,7,901,True,0,2,2,9898,470,8.695833333333333,Document
Starlark,440,286,483.2567245370371,MERGED,0,104,2,2,2,0,False,2,0,0,3440,104,39.32194444444445,Document
C++,2234,23694,2346.010636574074,MERGED,100,43,14,1,3,300,False,0,1,1,4085,143,185.42,Feature
Python,2407,12180,233.2084027777778,CLOSED,7,15,1,5,2,2,False,2,3,2,3207,22,36.6775,Document
TypeScript,1297,21107,406.6166435185185,MERGED,145,84,5,2,1,894,True,0,2,2,10247,229,0.145,Document
Python,2407,12180,233.08496527777777,MERGED,9,46,5,0,7,230,True,0,0,0,3381,55,0.042222222222222223,Document
TypeScript,1297,21107,406.07853009259264,MERGED,583,1136,19,1,3,891,True,0,1,1,8952,1719,0.22416666666666665,Document
C,5529,39701,51.54923611111111,MERGED,69,96,3,0,1,30,True,0,0,0,3285,165,3.7683333333333335,Bug
TypeScript,3392,2334,960.4505902777778,MERGED,264,224,6,2,1,0,False,0,2,1,3951,488,41.74388888888889,Bug
Starlark,440,286,478.2304398148148,MERGED,24,36,1,0,3,5,False,0,0,0,3119,60,158.00083333333333,Feature
Python,137,75,676.4232870370371,MERGED,40,56,23,0,2,212,False,0,0,0,5038,96,0.5975,Bug
Starlark,440,286,481.5903240740741,MERGED,6,25,3,0,3,47,False,0,0,0,3214,31,9.9875,Document
Python,2407,12180,231.91074074074075,MERGED,4,257,52,1,2,228,True,1,0,0,4526,261,0.2088888888888889,Document
TypeScript,149,2900,365.9928472222222,MERGED,10,1289,22,4,4,82,False,2,2,2,4168,1299,261.4238888888889,Bug
TypeScript,3989,23860,2819.4013194444447,MERGED,7,66,6,1,3,169,False,0,1,1,3918,73,15.703888888888889,Feature
TypeScript,4,33,754.472650462963,MERGED,158,189,24,2,3,587,True,1,1,1,4080,347,20.272222222222222,Feature
TypeScript,4,33,754.6157407407408,MERGED,27,48,5,1,1,158,False,0,1,1,3956,75,0.05638888888888889,Feature
TypeScript,1297,21107,403.5336226851852,CLOSED,205,159,2,2,1,880,True,0,2,2,9852,364,0.3641666666666667,Document
TypeScript,3392,2334,955.3224537037037,MERGED,21,21,7,2,1,0,False,0,2,1,4735,42,110.99861111111112,Bug
Rust,433,2229,224.94479166666667,MERGED,65,118,2,1,3,86,False,0,1,1,3667,183,70.18972222222222,Feature
Python,14532,41181,1076.492476851852,MERGED,4,20,2,0,3,1408,True,0,0,0,3420,24,0.3638888888888889,Document
JavaScript,34,25,188.10921296296297,MERGED,149,219,3,0,6,69,False,0,0,0,5180,368,6.81,Bug
Starlark,440,286,477.38906249999997,CLOSED,27,36,2,0,18,4,False,0,0,0,3314,63,12.134722222222223,Document
TypeScript,41369,87411,2924.444074074074,MERGED,848,2184,76,1,47,568,True,0,1,1,8982,3032,1.4938888888888888,Document
Python,2407,12180,226.94929398148147,MERGED,29,60,1,2,5,2,False,1,1,1,4271,89,30.727222222222224,Document
Vue,0,1,234.3494560185185,MERGED,11,368,8,0,6,50,False,0,0,0,3750,379,0.5205555555555555,Bug
Vue,0,1,233.99042824074073,MERGED,5,290,6,0,4,49,False,0,0,0,3161,295,0.355,Feature
Java,450,746,4058.979733796296,MERGED,4,28,5,1,2,69,True,0,1,1,3616,32,49.024166666666666,Feature
Rust,433,2229,222.63440972222222,MERGED,28,59,10,1,5,85,False,0,1,1,4982,87,1.7519444444444445,Feature
TypeScript,1297,21107,402.1899768518519,MERGED,58,60,4,9,10,1,False,2,7,4,3541,118,18.261944444444445,Document
TypeScript,3392,2334,953.8703125000001,MERGED,6,46,3,1,2,663,False,0,1,1,3230,52,0.2011111111111111,Document
TypeScript,178,1359,313.18922453703703,MERGED,1710,1633,75,1,11,0,True,0,1,1,15359,3343,23.344444444444445,Bug
Rust,591,3260,534.1079282407408,MERGED,56,273,21,0,16,30,True,0,0,0,6556,329,31.913055555555555,Document
Go,1835,11245,1715.047025462963,MERGED,79,161,21,2,1,72,False,1,1,1,4397,240,37.99638888888889,Document
JavaScript,8844,63474,4069.4314699074075,MERGED,161,1191,27,0,3,83,True,0,0,0,12855,1352,44.08111111111111,Feature
Rust,264,5382,391.15671296296296,MERGED,332,773,125,0,1,133,False,0,0,0,10665,1105,159.14555555555555,Bug
C,5529,39701,51.131134259259255,MERGED,258,479,4,1,4,25,False,1,0,0,7154,737,18.071666666666665,Feature
TypeScript,1297,21107,403.4040625,MERGED,93,337,11,7,11,24,False,2,5,3,11877,430,114.51444444444445,Document
Rust,3808,5430,429.6400462962963,MERGED,6,325,6,0,14,13,False,0,0,0,4275,331,164.35805555555555,Feature
Java,450,746,4059.0926273148148,MERGED,467,485,38,1,10,70,True,0,1,1,5427,952,526.7925,Bug
Python,2407,12180,233.41035879629632,CLOSED,68,164,13,13,8,10,False,4,9,3,6657,232,28.225833333333334,Document
Python,2407,12180,232.63730324074075,CLOSED,142,683,34,0,77,123,True,0,0,0,5029,825,0.08055555555555556,Document
TypeScript,4,33,749.182638888889,MERGED,279,1126,23,2,33,191,True,1,1,1,6701,1405,289.2272222222222,Document
TypeScript,4,33,754.9486111111111,MERGED,443,1011,33,1,21,159,False,0,1,1,6756,1454,46.38361111111111,Bug
Python,2407,12180,229.91997685185186,MERGED,142,782,39,0,27,226,True,0,0,0,6134,924,3.540277777777778,Document
Python,2407,12180,228.73761574074072,MERGED,15,179,3,3,74,122,True,1,2,1,7088,194,31.77111111111111,Document
TypeScript,139,827,735.9802430555555,MERGED,27,441,7,3,26,18,False,1,2,2,5130,468,61.201388888888886,Document
Python,2407,12180,228.2337037037037,MERGED,441,2916,44,0,12,224,True,0,0,0,6550,3357,0.3425,Document
Go,1835,11245,1720.0447222222222,MERGED,282,137,16,0,2,506,False,0,0,0,5377,419,67.42888888888889,Document
TypeScript,4,33,750.2025925925926,MERGED,464,530,26,1,18,377,True,0,1,1,6971,994,23.9775,Document
TypeScript,1297,21107,402.96113425925927,MERGED,46,119,5,8,5,2,False,3,5,2,5295,165,2.1102777777777777,Document
TypeScript,3392,2334,954.1837037037036,MERGED,43,137,7,1,2,293,False,0,1,1,6121,180,26.786944444444444,Feature
Vue,0,1,233.1061574074074,MERGED,14,238,7,0,2,48,False,0,0,0,6509,252,6.293611111111111,Bug
TypeScript,4,33,749.2001504629629,MERGED,283,385,13,1,7,376,True,0,1,1,6166,668,0.5202777777777777,Bug
Vue,0,1,232.54738425925927,MERGED,89,565,18,0,13,47,False,0,0,0,5658,654,9.232777777777779,Bug
TypeScript,3392,2334,956.3524074074074,MERGED,70,275,11,4,10,252,False,1,3,2,11140,345,396.0341666666667,Feature
TypeScript,15,34,477.2811458333333,MERGED,72,651,22,0,26,153,False,0,0,0,16933,723,268.4125,Document
TypeScript,3392,2334,957.3382638888888,MERGED,1608,173,37,4,4,0,False,1,3,2,10501,1781,216.1186111111111,Feature
Java,450,746,4060.0146412037034,MERGED,242,475,14,1,10,138,False,0,1,1,19223,717,120.16194444444444,Document
TypeScript,4,33,756.2334027777778,MERGED,53,41,5,5,2,592,True,4,1,1,7621,94,5.236666666666666,Feature
TypeScript,3392,2334,954.5563078703703,MERGED,64,1574,21,2,5,0,False,0,2,1,9363,1638,155.81194444444444,Feature
TypeScript,3392,2334,960.9323958333333,MERGED,80,49,13,1,6,682,False,0,1,1,9327,129,0.3983333333333333,Bug
TypeScript,3392,2334,959.8500694444446,MERGED,23018,25285,254,1,32,679,False,0,1,1,8386,48303,24.064166666666665,Document
TypeScript,4,33,751.6050925925925,MERGED,1908,2468,130,1,51,380,True,0,1,1,8302,4376,74.10083333333333,Document
Rust,591,3260,533.4452777777777,MERGED,6,940,13,0,3,70,False,0,0,0,7938,946,39.701388888888886,Document
Vue,0,1,236.37309027777778,MERGED,402,308,41,0,1,180,True,0,0,0,8862,710,18.600833333333334,Feature
C++,2234,23694,2344.7517939814816,CLOSED,89,315,15,0,7,298,False,0,0,0,8155,404,5.318611111111111,Bug
Rust,591,3260,535.1117824074074,MERGED,221,369,25,0,4,182,True,0,0,0,14337,590,4.5247222222222225,Document
Rust,433,2229,221.77135416666667,MERGED,107,657,16,3,20,84,False,1,2,2,8887,764,76.1675,Feature
JavaScript,34,25,184.90350694444444,MERGED,67,79,19,0,2,68,False,0,0,0,11138,146,1.3222222222222222,Bug
TypeScript,4,33,748.8840277777778,MERGED,141,156,26,1,1,153,False,0,1,1,8366,297,0.17166666666666666,Document
Rust,591,3260,535.4032638888889,MERGED,292,1390,30,1,6,71,False,0,1,1,11991,1682,137.9575,Document
TypeScript,42,46,763.3588425925926,MERGED,1790,2073,57,1,1,16,False,0,1,1,11173,3863,11.188611111111111,Document
Java,450,746,4065.129386574074,CLOSED,0,0,0,1,0,71,True,0,1,1,17196,0,0.6925,Document
JavaScript,5139,7048,1199.6691550925925,MERGED,13,37,5,3,3,0,False,0,3,3,220,50,94.09138888888889,Feature
C#,80,125,815.7170138888888,CLOSED,16398,4162,178,0,17,72,False,0,0,0,915,20560,148.10444444444445,Document
TypeScript,2147,14722,1468.8565740740742,MERGED,2,3,1,0,1,674,False,0,0,0,891,5,0.7855555555555556,Bug
TypeScript,2147,14722,1468.7616898148146,MERGED,3,4,1,0,1,673,False,0,0,0,806,7,0.5747222222222222,Bug
TypeScript,2147,14722,1469.7441435185185,MERGED,2,8,2,0,1,676,False,0,0,0,1198,10,28.502777777777776,Document
TypeScript,2147,14722,1467.023599537037,MERGED,2,2,1,0,2,668,False,0,0,0,1058,4,28.27722222222222,Bug
TypeScript,202,107,1138.1976388888888,CLOSED,478,523,4,3,2,118,True,0,3,3,3268,1001,2290.5441666666666,Document
TypeScript,3392,2334,963.1862037037037,CLOSED,2,5,2,1,2,305,False,0,1,1,1597,7,139.93666666666667,Bug
Rust,3808,5430,436.5000925925926,MERGED,6,43,4,2,10,29,False,1,1,1,488,49,1584.611388888889,Bug
V,2097,34361,1548.4814120370372,MERGED,14,11,2,0,2,9,True,0,0,0,3832,25,10.411666666666667,Document
TypeScript,178,1359,318.7909375,CLOSED,3,3,1,9,1,30,True,5,4,3,1369,6,933.3733333333333,Feature
TypeScript,2147,14722,1467.8085879629627,MERGED,27,238,4,0,1,669,False,0,0,0,2895,265,9.46861111111111,Document
Python,547,7160,2231.5027314814815,MERGED,3,1603,2,2,1,257,True,0,2,1,457,1606,0.2475,Bug
TypeScript,2071,16638,1237.3773958333334,CLOSED,0,26,2,2,2,25,True,1,1,1,2501,26,1632.8236111111112,Document
Python,19248,70257,2454.458576388889,CLOSED,14,14,7,13,7,0,False,5,8,3,371,28,368.37055555555554,Document
TypeScript,2147,14722,1468.1823032407408,MERGED,1388,32,12,0,1,671,False,0,0,0,3647,1420,0.5297222222222222,Bug
JavaScript,5139,7048,1198.9949074074075,CLOSED,0,13,1,4,1,0,False,2,2,1,513,13,1.7594444444444444,Feature
Rust,3808,5430,434.6646064814815,CLOSED,63,493,10,1,15,14,False,0,1,1,887,556,1421.67,Feature
Python,19248,70257,2456.7385185185185,CLOSED,4,8,3,1,3,1570,False,1,0,0,165,12,16.246388888888887,Feature
Rust,3808,5430,434.7182407407408,CLOSED,125,203,17,0,17,188,False,0,0,0,393,328,799.6205555555556,Feature
Rust,264,5382,398.73024305555555,CLOSED,0,59,5,1,1,384,False,0,1,1,2889,59,1372.2233333333334,Feature
Go,395,660,1260.0598842592592,CLOSED,0,14,1,2,2,1,False,0,2,2,238,14,989.2330555555556,Feature
TypeScript,2147,14722,1468.2232407407407,MERGED,0,8,4,0,1,672,False,0,0,0,533,8,0.6008333333333333,Document
TypeScript,2071,16638,1238.4654050925926,MERGED,1,1,1,2,3,0,False,1,1,1,632,2,255.4375,Document
TypeScript,178,1359,318.7652662037037,MERGED,1,1,1,2,1,2,False,0,2,2,818,2,0.009444444444444445,Bug
TypeScript,2147,14722,1469.2049189814816,MERGED,2,5,1,6,2,1,False,3,3,1,1049,7,38.07,Bug
TypeScript,2147,14722,1469.1028587962962,MERGED,26,6,3,0,1,98,False,0,0,0,1065,32,40.29361111111111,Bug
TypeScript,2147,14722,1469.025648148148,MERGED,0,5,2,0,2,160,False,0,0,0,846,5,42.40416666666667,Feature
Rust,3808,5430,434.8490277777778,CLOSED,73,116,16,0,9,190,False,0,0,0,478,189,744.7638888888889,Bug
TypeScript,2147,14722,1469.008009259259,MERGED,0,24,5,0,1,159,False,0,0,0,1202,24,0.27,Feature
JavaScript,8844,63474,4073.6346875,MERGED,3,215,9,0,2,88,True,0,0,0,452,218,63.10333333333333,Bug
TypeScript,41369,87411,2932.0378587962964,MERGED,29,140,9,3,15,7,False,0,3,2,5042,169,2510.4691666666668,Document
TypeScript,2147,14722,1467.9602199074072,MERGED,3,24,2,0,1,96,False,0,0,0,917,27,1.0591666666666666,Feature
Python,19248,70257,2455.382291666667,CLOSED,2,46,5,6,4,104,False,4,2,1,516,48,37.53111111111111,Feature
TypeScript,41369,87411,2933.789861111111,MERGED,120,271,10,1,7,47,False,0,1,1,5547,391,2448.7069444444446,Document
TypeScript,2147,14722,1466.8505555555555,MERGED,1,2,1,0,2,158,False,0,0,0,776,3,0.44027777777777777,Bug
TypeScript,7,6,641.0751273148148,MERGED,0,12,1,1,3,205,False,0,1,1,709,12,71.48277777777778,Feature
V,2097,34361,1548.8109722222223,MERGED,0,25,3,0,3,182,True,0,0,0,508,25,89.10083333333333,Bug
JavaScript,8844,63474,4073.1418171296295,MERGED,5,52,6,0,4,87,True,0,0,0,664,57,74.22666666666667,Bug
PHP,1334,2960,4202.298391203703,MERGED,3,0,1,0,1,197,False,0,0,0,880,3,1.9502777777777778,Document
TypeScript,261,3765,673.6953356481482,MERGED,28,0,2,0,1,856,True,0,0,0,1595,28,7.626388888888889,Document
Rust,264,5382,399.87406250000004,MERGED,0,1,1,0,1,320,False,0,0,0,712,1,2.1805555555555554,Feature
Python,547,7160,2235.0687152777778,MERGED,1,2,1,0,1,265,True,0,0,0,583,3,0.02861111111111111,Bug
Go,421,1654,1506.0690046296295,MERGED,3,4,1,0,1,419,True,0,0,0,1143,7,1.0277777777777777,Bug
Vue,293,495,826.8735185185186,MERGED,20,117,8,16,14,14,False,5,11,7,1039,137,238.52388888888888,Bug
JavaScript,5139,7048,1198.7214930555556,CLOSED,0,1,1,3,1,0,False,0,3,2,615,1,21.136388888888888,Feature
TypeScript,178,1359,317.5894328703704,MERGED,0,2,1,2,1,5,False,0,2,2,1150,2,13.086944444444445,Feature
C++,2234,23694,2351.9474421296295,MERGED,36,67,3,1,3,262,False,0,1,1,800,103,69.95305555555555,Feature
TypeScript,178,1359,318.7978240740741,MERGED,1,2,1,3,1,31,True,0,3,3,1743,3,124.62861111111111,Feature
TypeScript,2147,14722,1469.0332638888888,MERGED,8,9,2,0,2,97,False,0,0,0,1087,17,1.1558333333333333,Bug
JavaScript,8844,63474,4072.4188425925927,CLOSED,4,7,2,1,1,0,False,0,1,1,1705,11,474.08666666666664,Feature
TypeScript,2147,14722,1469.0153587962961,MERGED,1,3,1,0,1,675,False,0,0,0,1336,4,0.135,Feature
TypeScript,58,78,815.2086111111112,MERGED,0,101,2,1,3,116,False,0,1,1,1328,101,4.0216666666666665,Feature
TypeScript,178,1359,316.73162037037036,MERGED,2,10,1,4,3,4,False,2,2,2,1863,12,1.6844444444444444,Bug
Go,421,1654,1503.922037037037,MERGED,2,2,2,0,1,600,False,0,0,0,1021,4,0.9116666666666666,Document
TypeScript,85,722,310.98003472222223,MERGED,0,43,2,0,2,92,False,0,0,0,1474,43,0.7041666666666667,Document
TypeScript,2147,14722,1467.9693055555556,MERGED,168,242,56,0,6,670,False,0,0,0,1200,410,2.251388888888889,Bug
TypeScript,2147,14722,1467.9341319444445,MERGED,17,14,6,0,1,38,False,0,0,0,1596,31,1.1697222222222223,Bug
PHP,1334,2960,4203.026898148149,MERGED,7,31,2,1,4,67,False,0,1,1,1454,38,123.37333333333333,Document
TypeScript,58,78,814.5754398148148,MERGED,0,12,1,1,1,172,False,0,1,1,1317,12,14.230277777777777,Feature
Rust,264,5382,399.8836111111111,MERGED,17,20,1,0,2,221,True,0,0,0,822,37,1.8569444444444445,Feature
TypeScript,261,3765,670.4835879629629,MERGED,0,15,3,0,1,851,True,0,0,0,1454,15,0.09583333333333334,Document
HTML,11809,87636,150.42318287037037,CLOSED,3,3,2,0,2,0,False,0,0,0,1080,6,1407.0691666666667,Feature
V,2097,34361,1547.6206249999998,MERGED,1,1,1,4,1,1,False,1,3,2,639,2,18.138333333333332,Document
TypeScript,7,6,640.1376736111112,MERGED,8,8,5,0,5,7,True,0,0,0,1038,16,69.10027777777778,Feature
Rust,264,5382,400.2142824074074,CLOSED,10,0,1,0,1,388,False,0,0,0,816,10,0.19555555555555557,Feature
C++,2234,23694,2353.905474537037,MERGED,22,2,2,1,1,308,False,0,1,1,1132,24,50.85611111111111,Feature
TypeScript,307,2556,532.7457175925925,MERGED,1,17,2,3,3,176,True,1,2,2,1632,18,792.1366666666667,Bug
C++,2234,23694,2353.960358796296,MERGED,2,14,2,1,1,528,False,0,1,1,805,16,42.30083333333334,Bug
C++,2234,23694,2353.8977662037037,MERGED,55,1,3,1,6,306,False,0,1,1,1192,56,44.62361111111111,Feature
Rust,264,5382,399.7471180555556,MERGED,4,4,2,1,2,219,True,1,0,0,1067,8,4.851666666666667,Bug
Vue,293,495,826.2117013888889,MERGED,350,502,59,44,36,253,True,19,25,7,1913,852,611.7386111111111,Bug
C++,2234,23694,2353.001840277778,MERGED,56,6,4,1,4,304,False,0,1,1,856,62,65.31611111111111,Feature
TypeScript,2147,14722,1467.930439814815,MERGED,69,158,11,0,5,159,False,0,0,0,2195,227,7.083333333333333,Feature
Rust,264,5382,397.95900462962965,MERGED,256,48,7,3,1,72,True,2,1,1,914,304,54.77472222222222,Feature
Rust,264,5382,398.9774884259259,MERGED,152,14,1,0,1,75,True,0,0,0,851,166,0.7805555555555556,Feature
Rust,264,5382,398.8196759259259,MERGED,2,1,1,0,1,319,False,0,0,0,1006,3,0.02861111111111111,Feature
TypeScript,7,6,640.0026273148148,MERGED,8,1,1,0,1,9,False,0,0,0,763,9,3.1119444444444446,Feature
C++,2234,23694,2353.0167592592593,MERGED,39,19,3,1,2,305,False,0,1,1,1077,58,23.539166666666667,Feature
C++,2234,23694,2352.9133680555556,MERGED,34,5,2,2,4,301,False,1,1,1,896,39,26.01638888888889,Feature
TypeScript,7,6,639.9379282407407,MERGED,0,2,1,0,1,8,False,0,0,0,858,2,0.45,Feature
Go,421,1654,1505.9739467592592,MERGED,26,46,2,0,1,417,True,0,0,0,1412,72,3.318888888888889,Bug
TypeScript,261,3765,672.7855208333334,MERGED,0,11,2,0,2,855,True,0,0,0,1981,11,1.1741666666666666,Document
Rust,264,5382,398.12385416666666,MERGED,544,930,5,0,4,318,False,0,0,0,1127,1474,16.148333333333333,Feature
Rust,264,5382,397.87083333333334,MERGED,20,45,7,2,3,62,False,1,1,1,1064,65,24.99138888888889,Feature
TypeScript,261,3765,671.6937847222222,MERGED,3,21,4,0,5,180,False,0,0,0,2034,24,22.120833333333334,Document
Go,421,1654,1504.9813310185184,MERGED,6,2,2,2,1,56,False,2,0,0,1341,8,3.296111111111111,Bug
TypeScript,261,3765,671.8517824074074,MERGED,2,7,2,0,2,96,False,0,0,0,1694,9,0.029444444444444443,Document
Rust,264,5382,397.79983796296295,MERGED,1,14,1,0,1,383,False,0,0,0,929,15,5.721111111111111,Bug
PHP,1334,2960,4203.27619212963,MERGED,118,200,2,0,12,156,True,0,0,0,1880,318,164.5688888888889,Document
C++,2234,23694,2352.9938888888887,MERGED,60,115,7,1,15,263,False,0,1,1,1234,175,257.81694444444446,Feature
PHP,1334,2960,4202.233472222222,MERGED,1,1,1,0,1,153,False,0,0,0,1528,2,15.710555555555555,Document
TypeScript,261,3765,673.551875,CLOSED,0,0,0,0,0,0,False,0,0,0,2371,0,170.2538888888889,Document
TypeScript,58,78,814.1097337962964,MERGED,4,16,2,1,2,115,False,0,1,1,1782,20,1.4827777777777778,Feature
Rust,3808,5430,435.70982638888887,CLOSED,1,1,1,0,1,402,False,0,0,0,374,2,91.65944444444445,Feature
Java,450,746,4066.1260648148145,MERGED,2,2,2,2,3,140,False,0,2,1,1119,4,120.0425,Bug
Rust,264,5382,400.03719907407407,MERGED,21,106,9,4,23,0,False,2,2,1,1774,127,113.99555555555555,Bug
Java,450,746,4068.0700347222223,MERGED,4,4,1,0,2,29,False,0,0,0,960,8,0.07138888888888889,Bug
TypeScript,4,33,757.3395717592592,MERGED,102,113,5,1,3,160,False,0,1,1,75,215,0.21472222222222223,Feature
Vue,293,495,825.9498148148149,CLOSED,5,7,2,6,1,1,False,1,5,3,1466,12,223.1225,Bug
V,2097,34361,1546.6171180555557,MERGED,65,148,1,0,3,33,False,0,0,0,936,213,0.6411111111111111,Bug
C++,2234,23694,2354.0799074074075,MERGED,29,340,9,1,26,15,False,0,1,1,1309,369,110.95777777777778,Feature
TypeScript,58,78,815.0575462962962,MERGED,1,3,2,1,2,177,True,0,1,1,219,4,7.989722222222222,Feature
Ruby,98,356,1004.0299074074073,MERGED,46,116,7,0,6,200,True,0,0,0,486,162,145.3986111111111,Document
TypeScript,202,107,1138.4939583333332,MERGED,1,1,1,4,2,206,True,0,4,4,992,2,1.6519444444444444,Document
Go,421,1654,1505.97875,MERGED,4,8,1,0,1,418,True,0,0,0,1842,12,1.9222222222222223,Bug
V,2097,34361,1546.1591666666666,MERGED,1,10,1,0,1,32,False,0,0,0,905,11,3.2247222222222223,Document
Go,395,660,1261.0723726851852,MERGED,1,3,1,0,1,78,False,0,0,0,154,4,96.36111111111111,Feature
TypeScript,149,2900,376.9287847222222,MERGED,403,354,5,3,2,88,False,2,1,1,481,757,432.47194444444443,Feature
Java,450,746,4068.1667939814815,MERGED,14,9,3,1,3,972,False,0,1,1,317,23,261.9291666666667,Feature
Go,421,1654,1505.305150462963,MERGED,7,12,2,0,1,601,False,0,0,0,1853,19,14.890555555555556,Bug
Rust,3808,5430,434.70937499999997,CLOSED,0,3,1,0,1,15,False,0,0,0,275,3,41.47083333333333,Feature
Python,1912,12139,63.037256944444444,MERGED,7,10,2,1,1,10,False,0,1,1,1666,17,11.225277777777778,Feature
Rust,3808,5430,435.5324074074074,MERGED,26,26,2,0,3,28,False,0,0,0,342,52,1.4602777777777778,Bug
Rust,3808,5430,435.5,CLOSED,2,7,1,2,1,27,False,1,1,1,336,9,0.7994444444444444,Feature
Go,421,1654,1505.1927546296295,MERGED,99,12,8,0,1,413,True,0,0,0,2509,111,0.7775,Document
TypeScript,7,6,640.1813078703703,MERGED,1,5,2,0,3,219,False,0,0,0,1790,6,70.1138888888889,Bug
Go,395,660,1261.2155555555555,MERGED,2,3,2,0,3,3,False,0,0,0,211,5,136.5113888888889,Feature
TypeScript,42,46,766.055636574074,CLOSED,5985,18062,27,1,12,18,False,0,1,1,164,24047,0.0925,Feature
Go,4154,13945,1910.4133564814813,MERGED,10,10,9,1,1,309,False,1,0,0,374,20,0.8255555555555556,Feature
Vue,293,495,825.7404166666666,MERGED,1506,1407,5,13,5,153,True,3,10,5,1517,2913,150.96027777777778,Bug
Rust,3808,5430,434.53136574074074,MERGED,378,408,21,0,1,208,False,0,0,0,350,786,1.2133333333333334,Feature
Go,395,660,1260.831851851852,MERGED,1,1,1,2,3,74,False,2,0,0,211,2,122.01722222222222,Bug
Rust,264,5382,400.1820023148148,MERGED,0,14,3,0,1,223,True,0,0,0,1489,14,1.4225,Feature
Rust,264,5382,400.1196180555555,MERGED,14,7,2,0,1,222,True,0,0,0,1320,21,0.7688888888888888,Feature
PHP,1334,2960,4202.126724537037,MERGED,2,2,1,0,1,66,False,0,0,0,1699,4,0.35305555555555557,Document
Go,395,660,1261.0893287037036,MERGED,16,2,1,0,1,79,False,0,0,0,242,18,90.6325,Feature
TypeScript,2147,14722,1469.1612037037037,MERGED,11,267,8,0,1,74,False,0,0,0,3072,278,13.670277777777779,Feature
Go,395,660,1260.9999652777778,MERGED,7,11,2,0,2,77,False,0,0,0,202,18,93.29916666666666,Feature
Go,395,660,1261.1097916666665,MERGED,1,3,1,0,2,80,False,0,0,0,235,4,88.46972222222222,Feature
Rust,3808,5430,435.59625,MERGED,0,1,1,2,1,464,False,0,2,2,495,1,47.545833333333334,Document
Erlang,2054,12122,3790.020266203704,MERGED,239,620,17,3,7,482,True,1,2,1,1490,859,651.9852777777778,Document
TypeScript,261,3765,672.7048842592593,MERGED,0,16,6,0,1,151,False,0,0,0,2692,16,0.08,Document
Erlang,2054,12122,3789.4769444444446,MERGED,0,17,3,2,1,4,False,0,2,1,1189,17,177.41166666666666,Document
TypeScript,261,3765,672.6255787037037,MERGED,19,3,4,0,3,571,True,0,0,0,2525,22,0.6480555555555556,Document
V,2097,34361,1545.961087962963,MERGED,0,29,2,14,6,0,False,6,8,3,1100,29,196.43777777777777,Feature
Rust,3808,5430,434.5542939814815,MERGED,32,37,3,0,6,9,False,0,0,0,499,69,72.30972222222222,Document
Rust,264,5382,398.9539351851852,MERGED,160,171,14,0,1,386,False,0,0,0,1585,331,5.719444444444444,Bug
Go,395,660,1260.8089236111111,MERGED,1,1,1,0,1,73,False,0,0,0,237,2,73.70583333333333,Bug
TypeScript,178,1359,316.35314814814814,MERGED,1,59,6,1,2,6,True,0,1,1,2641,60,14.817222222222222,Feature
TypeScript,41369,87411,2932.788564814815,MERGED,0,5,1,0,1,1891,True,0,0,0,2349,5,0.5202777777777777,Document
Python,547,7160,2232.4626157407406,MERGED,12,20,9,3,12,221,False,2,1,1,987,32,268.2266666666667,Bug
TypeScript,261,3765,671.6600810185186,MERGED,7,15,5,0,2,570,True,0,0,0,2366,22,0.7738888888888888,Document
Rust,3808,5430,435.55142361111115,MERGED,273,392,13,1,1,237,False,1,0,0,642,665,172.81916666666666,Bug
TypeScript,202,107,1139.7909722222223,MERGED,1,2,1,4,2,69,True,0,4,4,1350,3,91.11694444444444,Document
TypeScript,261,3765,671.5375115740741,MERGED,8,18,3,0,1,179,False,0,0,0,2879,26,0.2675,Document
TypeScript,307,2556,534.6603587962962,MERGED,34,36,1,5,1,296,True,1,4,3,1284,70,90.75916666666667,Bug
PHP,1334,2960,4202.134502314815,MERGED,142,219,50,1,9,74,False,0,1,1,2273,361,164.91722222222222,Document
TypeScript,15,34,485.04206018518516,MERGED,25,25,2,0,1,902,False,0,0,0,183,50,12.572777777777778,Bug
C,5529,39701,54.259745370370375,MERGED,1,17,1,1,4,8,False,1,0,0,1755,18,15.709722222222222,Feature
TypeScript,17,33,712.8754050925926,MERGED,3,8,2,1,1,33,False,0,1,1,172,11,45.04472222222222,Feature
Rust,3808,5430,434.47034722222224,MERGED,112,314,11,0,1,236,False,0,0,0,607,426,172.3275,Feature
Rust,3808,5430,434.4415856481482,CLOSED,0,12,1,2,1,235,False,2,0,0,655,12,168.83055555555555,Feature
Go,421,1654,1505.9722106481483,MERGED,63,69,3,2,1,57,False,1,1,1,2474,132,47.735277777777775,Bug
Vue,293,495,824.8729282407407,MERGED,1,1,1,6,1,341,True,1,5,3,1114,2,30.71638888888889,Bug
TypeScript,307,2556,534.7695833333333,MERGED,1,2,2,6,2,560,True,3,3,1,1138,3,46.121944444444445,Bug
TypeScript,307,2556,534.7061921296296,CLOSED,3,3,1,2,1,558,True,0,2,2,965,6,47.55833333333333,Bug
Python,547,7160,2233.9021180555555,CLOSED,5,10,5,1,1,128,False,1,0,0,460,15,3.656111111111111,Bug
Python,547,7160,2233.9021527777777,CLOSED,20,19,6,3,5,129,False,3,0,0,465,39,3.651666666666667,Bug
TypeScript,307,2556,534.682511574074,MERGED,202,0,3,1,1,557,True,0,1,1,1132,202,46.76777777777778,Feature
Python,547,7160,2233.9020833333334,MERGED,62,45,3,1,1,127,False,1,0,0,468,107,0.4938888888888889,Bug
Python,547,7160,2233.9020601851853,MERGED,1,1,1,1,1,126,False,1,0,0,461,2,0.49416666666666664,Bug
TypeScript,41369,87411,2933.7239120370373,MERGED,67,2190,9,1,14,109,False,0,1,1,2963,2257,632.4611111111111,Document
Erlang,2054,12122,3790.116550925926,MERGED,950,28,27,2,2,990,True,0,2,1,1220,978,529.5736111111111,Document
Go,395,660,1260.0542939814816,CLOSED,0,14,1,0,1,0,False,0,0,0,233,14,0.03722222222222222,Feature
TypeScript,1297,21107,411.1485069444445,MERGED,10,18,3,1,1,916,True,0,1,1,1675,28,0.10277777777777777,Document
Python,547,7160,2233.667002314815,MERGED,4,12,5,0,3,264,True,0,0,0,451,16,0.023055555555555555,Bug
TypeScript,1297,21107,410.99091435185187,MERGED,4,22,4,1,2,914,True,0,1,1,1642,26,4.133055555555556,Document
Go,395,660,1259.9625115740741,MERGED,74,124,6,0,5,23,False,0,0,0,312,198,143.70333333333335,Feature
TypeScript,307,2556,533.5956481481481,MERGED,7,0,1,1,1,24,True,0,1,1,1068,7,75.01333333333334,Feature
Go,395,660,1260.9334722222222,MERGED,1,1,1,0,1,76,False,0,0,0,248,2,95.46861111111112,Bug
TypeScript,202,107,1139.8133449074073,MERGED,3,3,2,4,2,209,True,0,4,4,1291,6,1.1119444444444444,Document
Rust,264,5382,400.20297453703705,MERGED,71,118,5,0,3,224,True,0,0,0,2182,189,68.26555555555555,Feature
Python,547,7160,2231.6725810185185,MERGED,209,522,30,0,23,260,True,0,0,0,1505,731,49.17388888888889,Bug
TypeScript,15,34,483.6886226851852,MERGED,5,7,1,0,1,896,False,0,0,0,228,12,0.05333333333333334,Document
TypeScript,15,34,483.6348726851852,MERGED,2,3,1,0,3,893,False,0,0,0,183,5,0.021944444444444444,Bug
TypeScript,178,1359,319.55333333333334,MERGED,1,1,1,2,1,0,False,0,2,2,556,2,49.844722222222224,Feature
TypeScript,202,107,1139.4510300925926,MERGED,19,22,1,4,2,208,True,0,4,4,1826,41,1.1883333333333332,Document
Go,395,660,1260.8632060185184,MERGED,188,2,4,0,2,75,False,0,0,0,387,190,78.52583333333334,Feature
Go,395,660,1261.0106712962963,MERGED,1,1,1,0,3,2,False,0,0,0,327,2,72.31277777777778,Bug
Rust,3808,5430,436.4325347222222,MERGED,1,1,1,0,3,0,False,0,0,0,541,2,27.285555555555554,Document
JavaScript,5139,7049,1199.7703703703703,MERGED,43,99,46,4,9,89,False,2,2,2,3668,142,118.7175,Bug
Java,450,746,4067.290150462963,MERGED,37,92,1,1,1,411,False,0,1,1,1465,129,17.76388888888889,Feature
Go,395,660,1260.1556828703704,MERGED,26,28,4,0,6,1,False,0,0,0,382,54,95.64805555555556,Feature
PHP,883,2337,1827.1199189814815,CLOSED,1,31,4,5,7,0,False,1,4,2,3421,32,1005.4222222222222,Document
Rust,264,5382,400.983900462963,MERGED,945,956,6,0,2,226,True,0,0,0,2162,1901,1.2236111111111112,Feature
Python,547,7160,2231.5828587962965,MERGED,2,16,1,0,5,0,False,0,0,0,632,18,120.39944444444444,Bug
Vue,293,495,825.5053472222222,MERGED,27,23,9,5,4,50,False,1,4,3,1710,50,176.97833333333332,Bug
Python,547,7160,2232.493483796296,MERGED,0,1,1,1,2,262,True,0,1,1,472,1,0.11694444444444445,Bug
TypeScript,15,34,484.29028935185187,MERGED,16,16,2,0,2,157,False,0,0,0,291,32,89.65388888888889,Bug
TypeScript,202,107,1138.608912037037,MERGED,2,8,1,4,1,207,True,0,4,4,1547,10,4.1130555555555555,Document
C++,2234,23694,2353.671412037037,CLOSED,36,67,3,1,4,264,False,0,1,1,2298,103,46.49305555555556,Bug
TypeScript,15,34,484.5540509259259,MERGED,4297,3466,149,0,32,307,False,0,0,0,440,7763,173.4175,Feature
Rust,3808,5430,434.43782407407406,MERGED,25,99,3,0,1,234,False,0,0,0,609,124,51.37222222222222,Feature
Rust,264,5382,400.0332407407407,MERGED,60,108,6,0,5,322,False,0,0,0,2559,168,1.2230555555555556,Feature
Rust,264,5382,399.7723726851852,MERGED,9,291,5,2,2,387,False,1,1,1,635,300,79.58027777777778,Bug
Rust,264,5382,399.83663194444443,MERGED,557,544,3,0,1,220,True,0,0,0,2021,1101,2.3647222222222224,Feature
Rust,3808,5430,435.46119212962964,MERGED,2,18,4,0,4,209,False,0,0,0,525,20,1.5108333333333333,Feature
Java,450,746,4066.0296412037037,MERGED,2,19,3,1,4,28,False,0,1,1,1621,21,1.0180555555555555,Bug
TypeScript,15,34,484.77670138888885,MERGED,1600,1670,852,0,3,901,False,0,0,0,358,3270,18.483055555555556,Bug
Python,547,7160,2233.966388888889,CLOSED,85,161,3,1,1,135,False,1,0,0,565,246,2.1280555555555556,Bug
Python,547,7160,2233.9227199074076,CLOSED,5,4,1,1,1,130,False,1,0,0,526,9,3.1555555555555554,Bug
Python,547,7160,2233.922777777778,CLOSED,1,2,1,1,1,132,False,1,0,0,561,3,3.1494444444444443,Bug
Python,547,7160,2233.9019444444443,CLOSED,14,25,1,1,1,123,False,1,0,0,571,39,3.6658333333333335,Bug
Python,547,7160,2233.9020138888886,MERGED,2,2,1,1,1,125,False,1,0,0,529,4,0.495,Bug
Python,547,7160,2233.6472800925926,MERGED,2,2,1,0,1,263,True,0,0,0,491,4,0.015,Bug
TypeScript,15,34,484.6729050925926,MERGED,2,4,1,0,1,900,False,0,0,0,253,6,2.56,Feature
TypeScript,15,34,484.67118055555557,MERGED,2,2,1,0,1,158,False,0,0,0,403,4,0.16194444444444445,Feature
Go,30,295,342.00135416666666,MERGED,4,17,2,2,1,36,True,0,2,1,1855,21,0.3927777777777778,Bug
TypeScript,15,34,484.6418402777778,MERGED,26,31,7,0,2,899,False,0,0,0,352,57,0.02361111111111111,Feature
Rust,264,5382,398.9502662037037,MERGED,3,53,10,0,2,217,True,0,0,0,2478,56,0.34944444444444445,Feature
Rust,264,5382,398.8940509259259,MERGED,3,28,4,0,1,385,False,0,0,0,2512,31,1.101388888888889,Bug
TypeScript,2147,14722,1469.0669328703705,MERGED,0,1,1,1,3,0,False,0,1,1,634,1,41.38722222222222,Bug
TypeScript,15,34,484.33141203703707,MERGED,6,8,2,0,2,306,False,0,0,0,350,14,3.850277777777778,Bug
Go,395,660,1260.0702199074074,MERGED,0,21,1,0,1,77,False,0,0,0,294,21,0.2175,Document
JavaScript,9664,43889,3652.9360185185183,MERGED,5,69,6,0,1,78,False,0,0,0,480,74,0.5727777777777778,Bug
Go,395,660,1260.0279513888888,MERGED,8,3,7,0,1,76,False,0,0,0,399,11,0.12472222222222222,Feature
Go,395,660,1260.0736689814814,MERGED,42,102,3,0,5,72,False,0,0,0,405,144,117.91666666666667,Feature
TypeScript,15,34,483.70197916666666,MERGED,21,4,3,0,2,897,False,0,0,0,266,25,22.155277777777776,Document
Go,395,660,1260.853726851852,MERGED,61,117,13,1,1,45,False,1,0,0,464,178,77.9888888888889,Feature
C++,2234,23694,2352.9279745370372,CLOSED,72,38,6,1,4,302,False,0,1,1,2169,110,1.4802777777777778,Feature
TypeScript,178,1359,317.5100347222222,MERGED,1,92,6,6,6,9,True,2,4,2,3357,93,103.57694444444445,Feature
PHP,0,0,102.42975694444443,MERGED,31,218,1,0,2,8,False,0,0,0,530,249,0.010833333333333334,Document
TypeScript,15,34,483.6366898148148,MERGED,2,4,1,0,1,894,False,0,0,0,299,6,0.9791666666666666,Feature
Vue,293,495,826.7642708333333,MERGED,51,36,6,4,8,290,True,1,3,2,1802,87,2.4458333333333333,Bug
Rust,3808,5430,436.38535879629626,MERGED,145,554,7,0,1,239,False,0,0,0,868,699,151.75472222222223,Feature
JavaScript,8844,63474,4072.739224537037,MERGED,143,309,18,9,8,0,False,2,7,3,4426,452,275.1191666666667,Bug
TypeScript,261,3765,672.7947916666667,MERGED,4,18,2,2,2,6,False,0,2,2,1634,22,21.540555555555557,Document
Python,547,7160,2231.5736574074076,MERGED,8,7,1,0,2,259,True,0,0,0,495,15,0.051944444444444446,Bug
TypeScript,307,2556,534.842650462963,MERGED,2,2,1,2,2,20,False,1,1,1,1186,4,43.92138888888889,Bug
PHP,0,0,101.21880787037037,MERGED,1,60,4,0,3,7,False,0,0,0,576,61,0.01,Document
PHP,0,0,101.11598379629629,MERGED,0,55,2,0,1,51,True,0,0,0,502,55,0.027777777777777776,Document
PHP,0,0,101.09434027777779,MERGED,1,150,3,0,1,50,True,0,0,0,624,151,0.5163888888888889,Document
TypeScript,42,46,766.0593171296296,MERGED,321,740,13,1,5,19,False,0,1,1,565,1061,92.6061111111111,Feature
PHP,0,0,100.11055555555555,MERGED,2,21,4,0,3,49,True,0,0,0,540,23,0.6658333333333334,Document
TypeScript,202,107,1139.0449305555555,MERGED,2,7,2,4,1,2,True,1,3,3,1919,9,6.631388888888889,Document
TypeScript,178,1359,316.65074074074073,MERGED,41,228,4,2,6,8,True,0,2,2,4167,269,6.603888888888889,Feature
Python,547,7160,2233.9227430555557,CLOSED,102,98,14,1,8,131,False,1,0,0,557,200,3.1519444444444447,Bug
Python,547,7160,2233.922800925926,CLOSED,1,2,1,1,1,133,False,1,0,0,595,3,3.1469444444444443,Bug
Python,547,7160,2233.922835648148,CLOSED,3,3,1,3,1,134,False,3,0,0,605,6,3.129166666666667,Bug
Python,547,7160,2233.9019791666665,CLOSED,68,51,6,1,4,124,False,1,0,0,593,119,3.6694444444444443,Bug
TypeScript,41369,87411,2933.7604976851853,MERGED,1,1,1,0,1,1571,True,0,0,0,2132,2,1.1294444444444445,Document
TypeScript,261,3765,672.7794328703704,MERGED,7,133,6,0,1,854,True,0,0,0,3103,140,0.245,Document
TypeScript,41369,87411,2933.479085648148,MERGED,1,1,1,0,1,1569,True,0,0,0,2037,2,0.41333333333333333,Document
TypeScript,307,2556,533.5170370370371,MERGED,33,6,2,1,2,556,True,0,1,1,1471,39,4.453333333333333,Bug
C++,2234,23694,2353.9362615740743,MERGED,8,37,2,2,4,268,False,1,1,1,2890,45,140.83555555555554,Feature
TypeScript,15,34,487.10777777777776,MERGED,111,92,6,0,1,905,False,0,0,0,577,203,13.288611111111111,Feature
TypeScript,41369,87411,2932.530428240741,MERGED,2,0,1,1,2,0,False,0,1,1,2111,2,1.4558333333333333,Document
TypeScript,41369,87411,2932.5321875000004,CLOSED,0,2,1,2,1,1,False,0,2,2,2112,2,1.3508333333333333,Document
TypeScript,261,3765,671.6719097222223,MERGED,24,42,3,0,1,211,True,0,0,0,4143,66,0.20222222222222222,Document
C#,80,125,815.5312037037037,CLOSED,4,9,1,0,1,172,False,0,0,0,613,13,2.5169444444444444,Document
TypeScript,85,722,311.3849652777778,MERGED,11,304,14,1,26,10,False,1,0,0,6359,315,572.2513888888889,Document
JavaScript,9664,43889,3651.9497569444447,MERGED,207,55,24,0,4,262,True,0,0,0,543,262,2.8366666666666664,Feature
Java,450,746,4066.0891203703704,MERGED,8,26,10,3,6,22,False,1,2,1,779,34,46.61333333333334,Feature
TypeScript,2071,16638,1238.3379282407407,MERGED,2,2,1,0,1,0,False,0,0,0,2667,4,90.7425,Bug
TypeScript,41369,87411,2931.768819444444,MERGED,27,672,9,2,2,25,False,0,2,2,2687,699,331.8225,Document
TypeScript,41369,87411,2931.441446759259,MERGED,0,1,1,3,1,570,True,1,2,2,2117,1,0.44166666666666665,Document
Rust,264,5382,401.00856481481486,MERGED,991,976,6,0,1,227,True,0,0,0,2991,1967,0.6636111111111112,Feature
C++,2234,23694,2353.8710069444446,MERGED,10,14,2,1,8,267,False,0,1,1,3447,24,49.96722222222222,Feature
C++,2234,23694,2353.808761574074,MERGED,19,8,9,1,1,265,False,0,1,1,2761,27,51.46944444444444,Feature
Vue,293,495,824.5647685185186,MERGED,108,152,44,16,35,252,True,5,11,7,2362,260,199.15444444444444,Bug
Go,421,1654,1505.9193055555554,MERGED,114,532,11,0,2,415,True,0,0,0,4834,646,3.339166666666667,Bug
Python,72,25,1631.7269097222222,MERGED,17,98,2,0,2,26,False,0,0,0,3431,115,67.81527777777778,Feature
TypeScript,15,34,484.6088541666666,MERGED,2,15,4,0,2,898,False,0,0,0,565,17,0.21944444444444444,Document
Java,547,304,223.48909722222223,MERGED,0,5,1,0,2,363,False,0,0,0,1209,5,10.850833333333334,Document
TypeScript,2071,16638,1238.524085648148,MERGED,1,1,1,0,1,0,False,0,0,0,2810,2,13.5975,Bug
C++,2234,23694,2352.9460069444444,MERGED,22,43,2,1,1,527,False,0,1,1,3028,65,23.930833333333332,Bug
Rust,264,5382,398.98615740740746,MERGED,226,8,11,0,1,76,True,0,0,0,2647,234,0.5333333333333333,Feature
Erlang,2054,12122,3790.440300925926,MERGED,238,498,34,0,17,991,True,0,0,0,1277,736,540.2580555555555,Document
Java,450,746,4068.013726851852,CLOSED,134,468,13,2,10,141,False,0,2,1,3312,602,119.56583333333333,Bug
TypeScript,17,33,712.8571759259258,MERGED,23,28,5,1,1,32,False,0,1,1,518,51,45.65555555555556,Feature
TypeScript,2071,16638,1237.293912037037,MERGED,2,1,1,0,1,73,True,0,0,0,2403,3,1.9930555555555556,Bug
PHP,0,0,101.14905092592592,MERGED,50,64,12,0,3,31,False,0,0,0,777,114,0.024722222222222222,Document
Go,182,37,1702.1927777777776,MERGED,0,18,3,5,7,540,False,5,0,0,1048,18,114.025,Document
V,2097,34361,1548.7462962962964,MERGED,4,60,6,1,2,181,True,0,1,1,983,64,48.51027777777778,Bug
Rust,264,5382,397.9667592592593,MERGED,65,66,2,0,1,73,True,0,0,0,2443,131,4.448055555555555,Document
TypeScript,2071,16638,1236.542662037037,MERGED,0,31,1,0,2,0,False,0,0,0,2700,31,16.711944444444445,Document
V,2097,34361,1547.4098611111112,MERGED,0,18,7,0,1,211,True,0,0,0,2501,18,58.655,Document
TypeScript,307,2556,534.7079166666666,MERGED,34,33,3,1,2,559,True,0,1,1,2316,67,47.505833333333335,Bug
TypeScript,41369,87411,2932.987071759259,MERGED,0,2,1,0,1,1,False,0,0,0,2480,2,1.0933333333333333,Document
JavaScript,9664,43889,3652.8927546296295,MERGED,1623,34,14,0,1,263,True,0,0,0,867,1657,0.37777777777777777,Feature
TypeScript,41369,87411,2933.665648148148,MERGED,2,36,2,0,2,10,False,0,0,0,2650,38,26.14472222222222,Document
TypeScript,3392,2334,963.0839930555557,MERGED,0,1,1,2,1,448,False,0,2,1,1076,1,0.5197222222222222,Bug
TypeScript,41369,87411,2933.6120254629627,MERGED,4,3,3,12,6,1,False,5,7,3,2581,7,27.18888888888889,Document
TypeScript,17,33,714.8636226851851,MERGED,40,280,27,1,3,34,False,0,1,1,821,320,118.01944444444445,Bug
TypeScript,307,2556,533.504988425926,MERGED,3,2,3,1,1,555,True,0,1,1,1547,5,27.328055555555554,Document
C#,80,125,815.4217592592591,MERGED,11,54,3,0,2,167,True,0,0,0,737,65,0.4563888888888889,Document
Java,547,304,223.35364583333333,MERGED,9,9,1,4,2,1,True,2,2,2,1531,18,14.147777777777778,Document
C#,80,125,814.6491203703704,MERGED,857,391,18,0,36,171,False,0,0,0,914,1248,19.41027777777778,Document
C#,80,125,814.593738425926,MERGED,291,496,18,0,42,163,True,0,0,0,699,787,18.39666666666667,Document
TypeScript,7,6,640.1527546296296,MERGED,62,262,5,0,10,20,False,0,0,0,3442,324,307.0375,Feature
TypeScript,41369,87411,2932.9269328703704,MERGED,0,2,1,0,2,0,False,0,0,0,2362,2,2.5597222222222222,Document
TypeScript,3392,2334,961.9452777777778,MERGED,10,14,2,1,1,86,False,0,1,1,992,24,0.8416666666666667,Bug
TypeScript,41369,87411,2931.427893518519,MERGED,35,43,1,0,2,569,True,0,0,0,3048,78,3.767777777777778,Document
TypeScript,178,1359,318.8979282407407,MERGED,714,856,7,8,6,3,False,5,3,2,5429,1570,137.60222222222222,Feature
TypeScript,41369,87411,2931.6622337962963,CLOSED,16,19,1,0,1,403,True,0,0,0,2673,35,0.2225,Document
Erlang,2054,12122,3790.604479166667,MERGED,2,4,1,0,1,352,True,0,0,0,1068,6,276.96722222222223,Document
Java,547,304,224.689375,MERGED,0,7,1,0,10,528,False,0,0,0,1958,7,67.00833333333334,Document
Java,547,304,224.70289351851852,CLOSED,0,0,0,0,10,530,False,0,0,0,1878,0,80.89833333333333,Document
Java,547,304,224.57297453703703,MERGED,0,35,1,0,2,6,False,0,0,0,1757,35,2.206111111111111,Document
Java,547,304,224.72940972222224,MERGED,0,4,1,0,13,531,False,0,0,0,1800,4,80.27388888888889,Document
Python,2407,12180,234.2332638888889,CLOSED,6,15,1,17,2,4,False,2,15,3,2612,21,12.080833333333333,Document
Java,547,304,223.49526620370372,MERGED,0,6,1,0,2,366,False,0,0,0,1995,6,10.724722222222223,Document
Java,547,304,224.80218749999997,MERGED,0,7,1,0,6,533,False,0,0,0,1854,7,9.247777777777777,Document
Java,547,304,224.80851851851853,CLOSED,0,0,0,0,9,535,False,0,0,0,1834,0,78.42027777777778,Document
Java,547,304,224.81056712962962,MERGED,0,7,1,0,12,536,False,0,0,0,1862,7,20.177222222222223,Document
Java,547,304,224.8140162037037,MERGED,0,7,1,0,10,537,False,0,0,0,1717,7,78.3025,Document
Java,547,304,222.9428472222222,MERGED,0,33,1,0,1,8,False,0,0,0,1727,33,9.64611111111111,Document
Java,547,304,224.21355324074077,MERGED,0,21,1,0,2,10,False,0,0,0,1798,21,10.2475,Document
Java,547,304,223.4909375,MERGED,0,2,1,0,1,364,False,0,0,0,1622,2,7.033611111111111,Document
Java,547,304,223.49221064814813,MERGED,0,5,1,0,2,365,False,0,0,0,1672,5,10.789722222222222,Document
Java,547,304,221.65179398148146,MERGED,0,5,1,0,18,527,False,0,0,0,1802,5,54.93361111111111,Document
TypeScript,178,1359,319.5726851851852,MERGED,101,146,15,1,1,32,True,0,1,1,5356,247,1.0372222222222223,Feature
Rust,264,5382,399.9671759259259,MERGED,108,186,76,3,8,321,False,2,1,1,4385,294,122.12972222222223,Feature
TypeScript,2071,16638,1237.3083449074074,MERGED,7,14,1,0,2,1,False,0,0,0,3628,21,190.98666666666668,Bug
Java,547,304,221.60175925925924,MERGED,0,4,1,0,7,525,False,0,0,0,1938,4,56.12583333333333,Document
Java,547,304,221.59385416666666,MERGED,0,8,1,0,4,523,False,0,0,0,1839,8,7.9225,Document
Java,547,304,221.20976851851853,MERGED,0,9,1,0,1,4,False,0,0,0,1607,9,21.224722222222223,Document
Java,547,304,221.59034722222222,MERGED,0,4,1,0,11,522,False,0,0,0,1940,4,56.37722222222222,Document
TypeScript,4,33,757.9505324074074,MERGED,327,374,17,1,9,383,True,0,1,1,1181,701,228.98916666666668,Document
Erlang,2054,12122,3791.9786689814814,MERGED,2,2,2,0,1,355,True,0,0,0,1089,4,119.5286111111111,Document
TypeScript,41369,87411,2932.713460648148,MERGED,7,549,9,1,4,27,False,1,0,0,3950,556,334.2313888888889,Document
TypeScript,41369,87411,2932.0082986111115,MERGED,23,257,9,0,3,26,False,0,0,0,3192,280,354.61944444444447,Document
Go,30,295,342.98141203703705,MERGED,10,130,6,5,2,97,True,1,4,1,4177,140,75.88583333333334,Feature
TypeScript,85,722,310.98824074074076,MERGED,1199,2261,67,0,17,74,False,0,0,0,7628,3460,91.76166666666667,Document
Erlang,2054,12122,3790.6586574074076,MERGED,139,329,12,0,8,353,True,0,0,0,1185,468,150.27083333333334,Document
Erlang,2054,12122,3791.439375,MERGED,239,232,14,0,5,50,False,0,0,0,1017,471,105.14333333333333,Document
TypeScript,41369,87411,2931.761701388889,MERGED,36,182,10,2,28,71,True,1,1,1,4632,218,339.39666666666665,Document
C++,2234,23694,2353.865300925926,MERGED,98,146,8,2,3,266,False,1,1,1,5266,244,74.83055555555555,Feature
Go,2,11,1139.8343055555556,MERGED,71,335,33,0,5,23,False,0,0,0,998,406,29.48027777777778,Bug
Rust,264,5382,400.28614583333336,MERGED,34,64,9,1,1,225,True,1,0,0,4140,98,40.391666666666666,Feature
Erlang,2054,12122,3792.876793981481,MERGED,7,14,5,0,1,997,True,0,0,0,1210,21,28.7875,Document
TypeScript,3392,2334,963.3929398148148,MERGED,96,86,3,4,5,0,False,1,3,2,3277,182,827.8430555555556,Feature
TypeScript,261,3765,672.9731018518519,MERGED,203,561,45,0,9,573,True,0,0,0,5872,764,36.68277777777778,Document
TypeScript,4,33,758.5088657407408,MERGED,1559,218,60,2,2,595,True,1,1,1,1559,1777,115.04638888888888,Bug
Erlang,2054,12122,3789.2391087962965,MERGED,2,2,1,0,1,36,False,0,0,0,1372,4,138.57333333333332,Document
TypeScript,261,3765,672.4774189814815,MERGED,390,582,25,0,7,90,True,0,0,0,6341,972,47.655277777777776,Document
Python,547,7160,2232.724189814815,MERGED,24,548,4,0,15,14,False,0,0,0,6268,572,121.36083333333333,Document
Erlang,2054,12122,3789.2967361111114,MERGED,9,19,1,0,1,319,False,0,0,0,1033,28,115.85527777777777,Document
C#,80,125,815.8987847222223,MERGED,23,210,9,0,18,8,False,0,0,0,1242,233,114.45416666666667,Document
Erlang,2054,12122,3789.9215972222223,CLOSED,1,2,1,1,1,481,True,0,1,1,1257,3,89.9025,Document
Erlang,2054,12122,3789.8946296296294,MERGED,2,2,2,1,1,480,True,0,1,1,1117,4,90.51388888888889,Document
Go,2083,11768,1512.3563310185184,MERGED,0,265,8,8,2,0,False,4,4,2,3567,265,359.9075,Document
HTML,11809,87636,150.7579976851852,CLOSED,0,5,2,0,1,0,False,0,0,0,1080,5,0.021111111111111112,Feature
Erlang,2054,12122,3791.7243865740743,MERGED,15,96,11,0,3,476,False,0,0,0,1274,111,4.2075,Document
TypeScript,2071,16638,1238.4430555555557,MERGED,6,8,1,0,1,0,False,0,0,0,3312,14,2.5094444444444446,Document
TypeScript,261,3765,672.8402893518519,MERGED,52,113,17,0,3,249,True,0,0,0,7090,165,0.43583333333333335,Document
Erlang,2054,12122,3790.9490393518518,MERGED,1,1,1,0,1,228,True,0,0,0,1084,2,17.44,Document
Erlang,2054,12122,3790.8240972222225,MERGED,1,1,1,0,1,352,True,0,0,0,1186,2,20.0125,Document
TypeScript,85,722,310.003912037037,MERGED,764,1022,12,0,1,90,False,0,0,0,5151,1786,5.954722222222222,Document
Go,421,1654,1507.0497916666666,MERGED,182,133,15,0,1,420,True,0,0,0,7016,315,20.19472222222222,Document
C#,80,125,815.9302314814814,MERGED,31,103,3,0,3,179,False,0,0,0,1227,134,64.70777777777778,Document
Python,2407,12180,234.53216435185186,MERGED,0,223,2,1,5,126,True,0,1,1,1701,223,41.30222222222222,Document
TypeScript,41369,87411,2931.5129166666666,CLOSED,2,8,3,4,5,0,False,2,2,1,2892,10,205.27305555555554,Document
C#,80,125,815.7868981481482,MERGED,7,74,5,0,4,173,False,0,0,0,1325,81,63.981944444444444,Document
TypeScript,2147,14722,1466.8849537037038,MERGED,25,89,2,0,1,37,False,0,0,0,1360,114,4.671111111111111,Feature
Starlark,440,286,484.7857407407407,MERGED,8,8,1,0,1,66,False,0,0,0,1099,16,0.02,Document
TypeScript,261,3765,671.7007523148148,MERGED,20,25,17,0,1,853,True,0,0,0,5163,45,0.051111111111111114,Document
TypeScript,7046,76150,2626.4970949074072,MERGED,309,17,22,4,1,101,False,0,4,2,3918,326,0.5272222222222223,Document
TypeScript,202,107,1138.911400462963,MERGED,135,102,4,5,4,119,True,0,5,5,3871,237,112.29777777777778,Document
TypeScript,2071,16638,1237.2137037037037,MERGED,5,19,1,0,1,2,False,0,0,0,4603,24,0.16666666666666666,Bug
Rust,264,5382,397.91983796296296,MERGED,38,87,2,0,6,317,False,0,0,0,3604,125,4.668888888888889,Document
Starlark,440,286,484.1213078703704,MERGED,2,2,1,0,2,49,False,0,0,0,1373,4,15.649722222222222,Document
Starlark,440,286,483.97709490740743,MERGED,1,1,1,3,16,4,False,1,2,1,1226,2,22.058888888888887,Bug
Rust,264,5382,397.83990740740745,MERGED,21,222,17,0,3,216,True,0,0,0,4154,243,2.301388888888889,Feature
JavaScript,34,25,191.17049768518518,MERGED,23351,183,3,5,17,3,False,3,2,2,1717,23534,117.34416666666667,Feature
Erlang,2054,12122,3789.934351851852,MERGED,3,17,3,1,1,351,True,0,1,1,1253,20,0.22944444444444445,Document
Python,2407,12180,235.86025462962962,MERGED,9,9,1,2,4,0,False,1,1,1,2456,18,9.439722222222223,Document
Erlang,2054,12122,3789.8498263888887,MERGED,2,4,1,0,1,349,True,0,0,0,1164,6,1.531111111111111,Document
TypeScript,4,33,758.4209953703704,MERGED,2,3,2,1,2,162,False,0,1,1,1014,5,0.29305555555555557,Bug
TypeScript,15,34,485.21146990740743,MERGED,61,152,4,0,9,127,False,0,0,0,981,213,102.78166666666667,Document
TypeScript,41369,87411,2934.4800925925924,MERGED,5,33,3,3,7,0,False,1,2,1,3420,38,48.160833333333336,Document
V,2097,34361,1548.005914351852,MERGED,13,110,4,0,9,180,True,0,0,0,3618,123,21.81833333333333,Bug
TypeScript,3392,2334,963.3627314814815,MERGED,1,1,1,2,1,260,False,0,2,1,1806,2,0.27805555555555556,Bug
TypeScript,3392,2334,963.2739351851851,MERGED,0,16,2,1,1,91,False,0,1,1,1589,16,0.05555555555555555,Feature
TypeScript,41369,87411,2933.4435763888887,MERGED,6,17,8,1,8,1568,True,0,1,1,3186,23,79.74305555555556,Document
TypeScript,3392,2334,963.0291550925926,MERGED,7,0,1,1,1,302,False,0,1,1,1530,7,2.355277777777778,Feature
TypeScript,3392,2334,963.0384953703705,MERGED,0,8,1,1,2,303,False,0,1,1,1083,8,1.0994444444444444,Feature
C#,80,125,815.5627777777778,MERGED,1048,1064,6,0,9,71,False,0,0,0,1066,2112,2.2952777777777778,Document
C#,80,125,815.3946412037036,MERGED,593,329,5,0,4,164,True,0,0,0,1107,922,3.2616666666666667,Document
TypeScript,4,33,757.4828125,MERGED,12,21,5,1,4,382,True,0,1,1,1418,33,0.3458333333333333,Document
C#,80,125,815.4134375,MERGED,291,496,18,0,44,165,True,0,0,0,1207,787,0.6530555555555555,Document
TypeScript,3392,2334,962.4147337962963,MERGED,1,1,1,2,1,259,False,0,2,1,1546,2,11.437222222222223,Bug
TypeScript,41369,87411,2934.730509259259,MERGED,7,7,4,0,1,20,False,0,0,0,3283,14,0.32055555555555554,Document
C#,80,125,814.6993518518519,MERGED,451,827,17,0,11,178,False,0,0,0,1389,1278,22.9125,Document
TypeScript,1297,21107,411.0930439814815,MERGED,11,131,11,1,4,915,True,0,1,1,3178,142,0.36916666666666664,Document
TypeScript,41369,87411,2933.4141550925924,MERGED,0,132,4,0,3,1,False,0,0,0,2619,132,52.50194444444445,Document
TypeScript,3392,2334,962.389212962963,MERGED,2,2,1,2,1,258,False,0,2,1,1345,4,1.0247222222222223,Feature
Erlang,2054,12122,3791.941273148148,MERGED,35,271,10,0,2,353,True,0,0,0,1559,306,66.94888888888889,Document
TypeScript,3392,2334,962.0131365740741,MERGED,12,0,2,1,1,87,False,0,1,1,1421,12,0.48777777777777775,Feature
TypeScript,218,1201,2921.919108796296,MERGED,28,26,3,1,3,31,False,1,0,0,2441,54,502.2275,Bug
Vue,0,1,240.96694444444447,MERGED,2,42,2,0,1,1,False,0,0,0,1501,44,0.17277777777777778,Bug
TypeScript,41369,87411,2933.6486921296296,CLOSED,0,157,5,0,1,75,True,0,0,0,3410,157,17.279722222222222,Document
TypeScript,41369,87411,2933.658888888889,CLOSED,0,0,0,0,0,0,False,0,0,0,1684,0,1.6908333333333334,Bug
TypeScript,41369,87411,2933.6510185185184,MERGED,1,25,3,3,3,41,True,1,2,2,3610,26,0.7402777777777778,Document
TypeScript,41369,87411,2933.4440509259257,CLOSED,0,157,5,0,1,73,True,0,0,0,3410,157,4.904444444444445,Document
Go,1835,11245,1725.0738425925927,MERGED,3,3,1,0,1,135,False,0,0,0,1445,6,0.24138888888888888,Document
Go,1835,11245,1725.0288657407407,MERGED,0,497,2,1,1,0,False,0,1,1,1421,497,0.1363888888888889,Document
Starlark,440,286,486.10559027777776,MERGED,5,9,1,0,5,3,False,0,0,0,1922,14,116.15305555555555,Bug
Starlark,440,286,485.1952777777778,MERGED,0,490,2,1,1,0,False,1,0,0,1698,490,141.5175,Document
TypeScript,41369,87411,2931.458877314815,MERGED,7,207,2,0,1,571,True,0,0,0,4124,214,0.8847222222222222,Document
Java,547,304,224.58083333333332,MERGED,0,28,1,0,2,7,False,0,0,0,2383,28,22.829444444444444,Document
Java,547,304,224.69278935185184,MERGED,0,2,1,0,15,529,False,0,0,0,2498,2,1.7169444444444444,Document
TypeScript,178,1359,319.1170138888889,MERGED,4556,4848,192,1,55,1,True,0,1,1,8525,9404,51.25222222222222,Feature
Erlang,2054,12122,3791.916736111111,MERGED,16,18,10,2,2,354,True,1,1,1,1618,34,55.00472222222222,Document
Java,547,304,224.79817129629632,MERGED,0,7,1,0,12,532,False,0,0,0,2208,7,78.63277777777778,Document
Java,547,304,224.80388888888888,MERGED,0,7,1,0,7,534,False,0,0,0,2299,7,78.50888888888889,Document
Python,2407,12180,237.685462962963,MERGED,19,31,2,0,4,234,True,0,0,0,1956,50,4.503333333333333,Document
Erlang,2054,12122,3791.7718402777778,MERGED,9,10,2,0,1,229,True,0,0,0,1635,19,1.2047222222222222,Document
TypeScript,3392,2334,964.9641898148147,MERGED,0,2,2,2,1,261,False,0,2,1,1930,2,71.81972222222223,Feature
Java,547,304,221.98695601851853,MERGED,0,60,3,2,5,4,False,1,1,1,2335,60,3.2741666666666664,Document
TypeScript,2147,14722,1468.8382523148148,MERGED,134,483,13,0,11,160,False,0,0,0,9169,617,73.14777777777778,Feature
Java,547,304,221.59914351851853,MERGED,0,4,1,0,8,524,False,0,0,0,2642,4,56.178333333333335,Document
TypeScript,7,6,640.1230324074074,MERGED,27,396,13,1,63,260,False,1,0,0,5957,423,409.60555555555555,Feature
Python,2407,12180,236.28537037037037,MERGED,1,1,1,0,1,233,True,0,0,0,1758,2,0.46305555555555555,Document
TypeScript,3392,2334,965.1306712962963,MERGED,1,5,1,2,1,263,False,0,2,1,1709,6,5.836666666666667,Bug
TypeScript,3706,54074,1351.382997685185,MERGED,145,46,8,0,1,32,True,0,0,0,2839,191,116.6,Feature
Python,2407,12180,234.47201388888888,MERGED,20,19,1,0,4,125,True,0,0,0,1776,39,42.714444444444446,Document
TypeScript,3392,2334,962.0335069444444,MERGED,32,92,14,1,6,301,False,0,1,1,1724,124,94.61361111111111,Feature
TypeScript,3392,2334,963.4148842592593,MERGED,8,8,3,1,1,92,False,0,1,1,2114,16,1.1997222222222221,Bug
TypeScript,3392,2334,962.8597222222223,MERGED,2,2,2,1,1,89,False,0,1,1,1980,4,1.96,Bug
Java,450,746,4066.0724421296295,MERGED,49,372,5,1,13,2,False,0,1,1,5723,421,527.5183333333333,Bug
TypeScript,3392,2334,962.2670486111111,MERGED,10,2,2,2,1,0,False,0,2,1,2203,12,16.509444444444444,Bug
TypeScript,3392,2334,961.9131481481481,MERGED,4,20,2,2,2,300,False,0,2,2,1932,24,1.9752777777777777,Bug
Go,1835,11245,1725.004699074074,MERGED,4,7,1,0,1,511,False,0,0,0,1638,11,1.8425,Document
JavaScript,5139,7049,1197.838611111111,MERGED,482,300,26,2,12,180,False,0,2,2,10164,782,182.56333333333333,Bug
TypeScript,41369,87411,2933.817094907407,MERGED,17,5128,9,0,2,28,False,0,0,0,4957,5145,284.97777777777776,Document
Go,789,5551,1037.2127199074073,MERGED,44,14,3,2,3,11,False,1,1,1,2546,58,90.96055555555556,Document
TypeScript,41369,87411,2931.7719444444447,MERGED,49,261,9,0,18,72,True,0,0,0,4844,310,340.215,Document
Starlark,440,286,485.12759259259263,MERGED,0,62,3,0,11,1,False,0,0,0,2929,62,185.7775,Feature
TypeScript,3989,23860,2824.2891319444443,MERGED,12,64,6,5,23,34,False,0,5,5,3599,76,837.7322222222223,Document
JavaScript,8844,63474,4072.320706018518,MERGED,270,2095,11,0,46,86,True,0,0,0,5839,2365,93.79277777777777,Bug
Starlark,440,286,485.68703703703704,MERGED,13,26,1,0,1,1,False,0,0,0,2473,39,126.74166666666666,Bug
Rust,264,5382,398.3917245370371,MERGED,68,5548,37,2,34,3,False,0,2,2,6383,5616,82.90833333333333,Bug
Python,2407,12180,234.74421296296296,CLOSED,15,57,3,5,4,6,False,2,3,1,2911,72,150.48277777777778,Document
Rust,264,5382,398.9569560185185,MERGED,0,403,42,0,2,218,True,0,0,0,7132,403,25.52638888888889,Feature
TypeScript,41369,87411,2933.637777777778,CLOSED,40,250,9,0,3,74,True,0,0,0,5564,290,0.12805555555555556,Document
Rust,264,5382,397.9724537037037,MERGED,535,642,22,2,1,1,False,1,1,1,6158,1177,49.24861111111111,Bug
Rust,264,5382,399.04094907407404,MERGED,527,656,24,0,3,151,False,0,0,0,5280,1183,2.569722222222222,Document
Rust,264,5382,398.95636574074075,MERGED,68,236,12,0,4,256,True,0,0,0,6204,304,1.8516666666666666,Feature
Rust,264,5382,397.98630787037035,MERGED,103,475,21,0,1,134,False,0,0,0,5937,578,0.24833333333333332,Bug
Erlang,2054,12122,3790.9178240740744,MERGED,32,196,24,0,2,227,True,0,0,0,2520,228,20.861666666666668,Document
TypeScript,4,33,759.7083564814815,MERGED,19,22,4,1,1,166,False,0,1,1,2859,41,0.04722222222222222,Feature
TypeScript,1297,21107,411.9511458333333,MERGED,76,335,13,2,5,919,True,0,2,2,6266,411,0.6911111111111111,Document
TypeScript,218,1201,2922.2893402777777,MERGED,3,16,2,1,3,7,False,0,1,1,2494,19,259.4275,Feature
TypeScript,1297,21107,411.74304398148143,MERGED,677,681,27,1,14,918,True,0,1,1,8717,1358,4.255,Document
Starlark,440,286,484.90444444444444,MERGED,0,0,2,0,1,68,False,0,0,0,2499,0,0.02,Document
Erlang,2054,12122,3789.8963078703705,MERGED,168,442,7,0,3,350,True,0,0,0,2438,610,25.344166666666666,Document
Java,450,746,4066.2153125,MERGED,11,18,5,2,5,372,True,0,2,2,2376,29,136.93444444444444,Feature
Python,547,7160,2232.6637962962964,CLOSED,1,0,1,0,16,122,False,0,0,0,2460,1,33.85944444444444,Bug
Erlang,2054,12122,3789.8602546296297,MERGED,1,3,2,0,2,350,True,0,0,0,1858,4,1.1558333333333333,Document
TypeScript,1297,21107,410.6606597222222,MERGED,97,49,38,1,1,912,True,0,1,1,5277,146,0.1925,Document
TypeScript,3392,2334,963.1806134259259,MERGED,11,27,1,1,1,304,False,0,1,1,2376,38,0.09444444444444444,Feature
TypeScript,3392,2334,962.3255787037037,MERGED,11,11,2,2,1,0,False,0,2,1,2686,22,0.16527777777777777,Bug
TypeScript,3392,2334,962.0733101851852,MERGED,4,51,5,2,2,341,False,0,2,1,2681,55,19.39361111111111,Bug
TypeScript,41369,87411,2932.501770833333,MERGED,345,327,264,5,2,404,True,2,3,2,7053,672,9.213055555555556,Document
V,2097,34361,1545.6027777777779,MERGED,25,22,1,0,1,31,True,0,0,0,4425,47,0.1361111111111111,Document
TypeScript,41369,87411,2932.0555671296297,MERGED,3,42,4,0,5,73,True,0,0,0,6956,45,13.131944444444445,Document
Java,547,304,221.58767361111111,MERGED,0,6,1,0,8,521,False,0,0,0,2941,6,56.07944444444445,Document
Go,421,1654,1504.8699768518518,MERGED,49,1138,14,0,1,11,False,0,0,0,12409,1187,101.26194444444444,Bug
Go,1835,11245,1723.1163425925924,MERGED,16,18,3,0,1,134,False,0,0,0,3003,34,0.28805555555555556,Document
Go,1835,11245,1722.149224537037,MERGED,21,216,5,0,4,77,False,0,0,0,2786,237,10.526666666666667,Document
Go,1835,11245,1722.8638425925926,MERGED,21,13,8,0,1,507,False,0,0,0,2723,34,2.2675,Bug
Rust,264,5382,400.0254976851852,MERGED,4781,122,23,1,1,77,True,1,0,0,8631,4903,73.66083333333333,Bug
Rust,264,5382,399.11508101851854,MERGED,580,132,32,0,1,135,False,0,0,0,9379,712,15.805277777777778,Document
JavaScript,8844,63474,4072.5500810185185,MERGED,46,228,20,0,4,103,True,0,0,0,9994,274,23.064722222222223,Document
Erlang,2054,12122,3791.843645833333,MERGED,24,52,24,0,3,230,True,0,0,0,3283,76,116.63777777777777,Document
TypeScript,41369,87411,2933.6972453703706,MERGED,394,3267,53,0,13,573,True,0,0,0,9392,3661,75.05694444444444,Document
Python,2407,12180,237.37905092592595,MERGED,4,7,3,5,10,2,False,2,3,2,3373,11,16.281388888888888,Document
Erlang,2054,12122,3792.000972222222,MERGED,6,16,1,0,1,231,True,0,0,0,3372,22,54.47027777777778,Document
TypeScript,1297,21107,410.89929398148143,MERGED,37,360,16,2,6,913,True,0,2,2,8966,397,0.2838888888888889,Document
Python,2407,12180,235.98855324074074,MERGED,761,1109,34,0,17,232,True,0,0,0,4467,1870,6.824166666666667,Document
Go,789,5551,1035.0159490740741,MERGED,5,5,5,0,1,190,True,0,0,0,3639,10,1.9388888888888889,Document
TypeScript,4,33,759.6548726851852,MERGED,32,41,7,1,1,165,False,0,1,1,3825,73,0.06305555555555556,Document
TypeScript,4,33,759.5796759259259,MERGED,138,145,4,1,2,164,False,0,1,1,3718,283,0.8094444444444444,Bug
Python,2407,12180,234.604375,MERGED,65,73,9,0,4,11,False,0,0,0,4091,138,39.63472222222222,Document
TypeScript,3392,2334,963.0892013888889,MERGED,42,75,3,1,2,90,False,0,1,1,4681,117,23.086388888888887,Document
Python,2407,12180,234.23010416666668,CLOSED,6,16,1,0,2,3,False,0,0,0,3517,22,0.05444444444444444,Document
TypeScript,3392,2334,961.8765046296297,MERGED,60,84,6,1,3,683,False,0,1,1,4614,144,1.035,Feature
Vue,0,1,240.3764236111111,MERGED,12,428,17,0,8,182,True,0,0,0,3946,440,14.349722222222223,Bug
Go,1835,11245,1723.637986111111,MERGED,124,70,12,0,1,78,False,0,0,0,4158,194,1.1341666666666668,Feature
Rust,591,3260,543.135613425926,CLOSED,79,139,11,1,12,52,False,1,0,0,6430,218,267.2033333333333,Document
Rust,591,3260,542.2139930555555,MERGED,110,105,13,0,12,187,True,0,0,0,6153,215,20.14666666666667,Document
Go,421,1654,1504.1420023148148,MERGED,114,333,14,4,4,2,False,2,2,1,14175,447,24.805,Bug
TypeScript,41369,87411,2933.8103472222224,MERGED,332,372,269,4,5,194,False,3,1,1,11148,704,0.6913888888888889,Document
TypeScript,41369,87411,2933.766493055555,CLOSED,30030,28490,129,2,36,13,False,0,2,2,11496,58520,0.09083333333333334,Document
TypeScript,3392,2334,962.2186226851851,MERGED,5600,5988,144,3,6,684,False,1,2,2,7401,11588,446.92944444444447,Bug
Python,1912,12140,63.93837962962963,MERGED,29,111,3,0,4,11,False,0,0,0,4032,140,18.390555555555554,Feature
Go,2,11,1138.9037731481483,MERGED,109,1216,41,0,25,22,False,0,0,0,6260,1325,52.05638888888889,Document
Python,2407,12180,236.53885416666665,MERGED,0,461,7,10,6,127,True,2,8,2,6334,461,36.75277777777778,Document
Go,789,5551,1035.2944907407407,MERGED,5,119,5,1,5,10,False,1,0,0,4917,124,22.147222222222222,Document
TypeScript,85,722,310.9389351851852,MERGED,36,185,12,0,1,91,False,0,0,0,8003,221,1.8755555555555556,Document
TypeScript,4,33,758.7340046296296,MERGED,38,188,9,1,4,163,False,0,1,1,6147,226,0.5416666666666666,Feature
Python,2407,12180,234.45912037037036,CLOSED,142,683,34,0,77,124,True,0,0,0,5102,825,0.0030555555555555557,Document
TypeScript,3392,2334,961.5040393518519,MERGED,4059,14,64,2,1,0,False,0,2,1,5707,4073,34.909444444444446,Feature
Go,1835,11245,1725.564699074074,MERGED,66,46,12,0,1,512,False,0,0,0,5454,112,5.541111111111111,Document
Vue,0,1,243.18604166666668,MERGED,55,181,11,0,14,36,False,0,0,0,7153,236,23.368055555555557,Bug
C++,2234,23694,2353.9020370370367,MERGED,132,55,10,1,12,307,False,0,1,1,7757,187,73.40916666666666,Feature
TypeScript,41369,87411,2931.4602199074075,MERGED,638,513,41,2,19,572,True,1,1,1,16198,1151,0.8455555555555555,Document
Rust,591,3260,543.6477199074073,MERGED,285,661,26,1,35,188,True,1,0,0,14290,946,67.30527777777777,Document
TypeScript,4,33,757.4334722222221,MERGED,214,497,28,2,8,594,True,1,1,1,12590,711,528.8813888888889,Feature
TypeScript,4,33,757.6129861111111,MERGED,224,347,20,1,5,161,False,0,1,1,11461,571,0.14972222222222223,Feature
Go,1835,11245,1724.0634375,MERGED,1408,2241,46,1,1,510,False,0,1,1,10670,3649,22.281666666666666,Document
Go,1835,11245,1725.6488657407408,MERGED,458,523,26,0,1,513,False,0,0,0,17396,981,3.5055555555555555,Document
Go,1835,11245,1723.7086111111112,MERGED,178,525,19,0,1,509,False,0,0,0,16488,703,4.354166666666667,Document
V,2097,34361,1554.880902777778,CLOSED,1,1,1,3,2,13,True,2,1,1,571,2,15.310555555555556,Bug
TypeScript,218,1201,2930.2546875000003,MERGED,12,78,1,4,5,304,True,3,1,1,378,90,2583.983333333333,Feature
Go,395,660,1264.0098379629628,CLOSED,32,38,6,0,1,335,False,0,0,0,476,70,2763.726388888889,Document
PHP,883,2338,1831.0189583333333,CLOSED,1,1,1,2,1,0,False,0,2,2,1812,2,19.273888888888887,Document
V,2097,34361,1550.5346759259257,MERGED,2,72,2,0,1,11,True,0,0,0,1338,74,5.597222222222222,Document
C#,80,125,821.1624768518518,CLOSED,4,6,4,1,2,157,True,0,1,1,389,10,2362.9036111111113,Document
TypeScript,2071,16638,1240.622488425926,MERGED,1,6,1,2,1,7,False,1,1,1,1622,7,35.97888888888889,Bug
Python,547,7160,2239.565474537037,CLOSED,98,71,10,1,1,143,False,1,0,0,621,169,2449.2183333333332,Document
TypeScript,178,1359,323.31662037037034,CLOSED,3,64,8,3,1,0,False,1,2,2,4113,67,2340.8008333333332,Bug
V,2097,34361,1553.8868171296297,MERGED,27,27,12,0,4,12,True,0,0,0,3151,54,6.288888888888889,Document
Python,19248,70257,2463.60787037037,CLOSED,4,5,2,1,1,1583,False,1,0,0,277,9,5.2875,Feature
TypeScript,2442,17074,2563.5096064814816,CLOSED,0,22,1,5,2,9,True,2,3,1,1291,22,1660.1233333333332,Feature
TypeScript,2147,14722,1475.0386574074073,MERGED,1,6,2,0,1,684,False,0,0,0,1100,7,70.80305555555556,Feature
TypeScript,2147,14722,1473.2118287037038,MERGED,12,4,2,0,1,679,False,0,0,0,825,16,0.71,Bug
Vue,293,495,828.9224421296295,MERGED,297,926,41,37,79,51,False,16,21,5,1694,1223,746.4008333333334,Bug
TypeScript,178,1359,325.49385416666667,CLOSED,3,3,2,3,2,0,False,1,2,2,1170,6,1242.5866666666666,Bug
TypeScript,2147,14722,1472.7962962962963,MERGED,26,34,3,0,1,678,False,0,0,0,1558,60,0.3466666666666667,Bug
TypeScript,2071,16638,1245.018287037037,MERGED,2,5,2,0,4,0,False,0,0,0,3821,7,2529.333611111111,Bug
PHP,883,2338,1835.0103124999998,CLOSED,2,2,1,2,1,0,False,0,2,2,2081,4,1820.1402777777778,Document
C#,80,125,821.8887500000001,CLOSED,427,893,190,0,10,78,False,0,0,0,1260,1320,2345.4177777777777,Document
C#,80,125,821.5669560185185,CLOSED,16724,4877,354,0,21,77,False,0,0,0,1497,21601,2353.136388888889,Document
TypeScript,2147,14722,1471.8607291666667,MERGED,26,87,3,0,1,677,False,0,0,0,2485,113,6.836111111111111,Bug
TypeScript,3392,2334,970.0974421296296,CLOSED,4,10,2,1,3,316,False,0,1,1,1267,14,118.74277777777777,Feature
TypeScript,3392,2334,966.0746759259259,CLOSED,0,8,1,1,1,309,False,0,1,1,1552,8,96.23166666666667,Feature
TypeScript,495,2659,1906.2361574074075,MERGED,2410,1455,52,5,28,97,True,3,2,1,1189,3865,1940.8125,Feature
TypeScript,2147,14722,1475.0254282407407,MERGED,13,32,4,0,1,683,False,0,0,0,2597,45,71.13,Document
TypeScript,2147,14722,1474.2312268518517,MERGED,45,42,4,0,1,681,False,0,0,0,3209,87,0.6747222222222222,Bug
TypeScript,2147,14722,1473.243287037037,MERGED,2,2,1,0,1,162,False,0,0,0,623,4,0.16527777777777777,Bug
Python,547,7160,2236.7511458333333,CLOSED,7,21,2,1,1,137,False,1,0,0,1412,28,2225.4575,Bug
Python,547,7160,2237.4669560185184,CLOSED,3,42,4,0,9,28,False,0,0,0,738,45,1541.7525,Bug
TypeScript,2071,16638,1243.0900578703704,CLOSED,3,21,1,1,2,0,False,1,0,0,2891,24,1633.0213888888889,Bug
TypeScript,2147,14722,1474.187314814815,MERGED,3,3,1,0,1,163,False,0,0,0,695,6,0.3636111111111111,Feature
Python,547,7160,2239.759074074074,CLOSED,106,53,2,0,3,17,False,0,0,0,686,159,1341.6894444444445,Document
TypeScript,41369,87411,2937.671875,MERGED,3,2,2,15,8,42,True,6,9,5,3153,5,2137.3755555555554,Document
TypeScript,2071,16638,1245.0562962962963,MERGED,9,61,3,1,11,3,False,0,1,1,5391,70,2529.0808333333334,Document
Vue,293,495,834.7417013888889,MERGED,3,1,1,5,2,16,False,0,5,5,764,4,363.9277777777778,Bug
Python,19248,70257,2459.543402777778,CLOSED,6,42,2,8,2,226,False,4,4,2,673,48,178.52916666666667,Feature
TypeScript,2147,14722,1475.1297569444444,MERGED,1,8,1,0,3,667,False,0,0,0,634,9,63.468333333333334,Bug
TypeScript,178,1359,326.82358796296296,MERGED,2,2,1,2,1,0,False,0,2,2,919,4,23.03,Document
PHP,883,2338,1831.0562499999999,CLOSED,4,4,1,2,3,4,False,1,1,1,1707,8,1006.2736111111111,Document
TypeScript,184,377,1913.5132291666666,CLOSED,6,2,1,1,4,123,True,1,0,0,782,8,0.8155555555555556,Feature
TypeScript,178,1359,325.618587962963,MERGED,1,1,1,3,1,5,False,1,2,2,798,2,51.71111111111111,Bug
PHP,883,2338,1834.8280092592593,CLOSED,6,204,5,1,1,0,False,0,1,1,5733,210,2519.244166666667,Document
TypeScript,178,1359,323.10229166666664,MERGED,3,3,1,1,1,18,True,0,1,1,720,6,0.015555555555555555,Bug
Go,421,1654,1509.1178819444447,CLOSED,12,18,1,0,1,81,False,0,0,0,1436,30,3.2975,Document
TypeScript,85,722,317.97666666666663,MERGED,1,0,1,2,1,0,False,2,0,0,1199,1,77.38416666666667,Document
Python,19248,70257,2463.667071759259,CLOSED,2,2,1,3,1,1585,False,2,1,1,181,4,0.31444444444444447,Feature
TypeScript,2147,14722,1473.0339814814815,MERGED,9,12,3,0,3,75,False,0,0,0,667,21,4.6338888888888885,Bug
TypeScript,2147,14722,1472.9891898148146,MERGED,1,7,1,0,1,99,False,0,0,0,671,8,3.2358333333333333,Bug
Python,19248,70257,2461.614872685185,CLOSED,2,4,1,1,2,1577,False,1,0,0,183,6,2.0347222222222223,Bug
TypeScript,178,1359,322.755787037037,MERGED,0,39,4,2,5,0,False,0,2,2,856,39,30.842777777777776,Feature
TypeScript,2147,14722,1475.0280208333334,MERGED,6,15,2,0,3,164,False,0,0,0,1578,21,0.9,Document
Python,547,7160,2238.0134027777776,MERGED,103,227,19,0,37,7,False,0,0,0,956,330,549.5263888888888,Bug
Kotlin,164,4296,408.4927662037037,CLOSED,4,4,1,1,1,0,False,0,1,1,388,8,604.7261111111111,Bug
TypeScript,2147,14722,1472.0422453703704,MERGED,0,1,1,0,1,48,False,0,0,0,634,1,0.44027777777777777,Feature
TypeScript,2147,14722,1470.8905787037038,MERGED,2,2,2,2,1,285,False,0,2,1,938,4,0.4177777777777778,Bug
TypeScript,2147,14722,1471.0370486111112,MERGED,1,1,1,0,1,666,False,0,0,0,739,2,16.833333333333332,Bug
TypeScript,178,1359,320.3952199074074,CLOSED,0,1,1,1,1,0,False,0,1,1,757,1,69.45166666666667,Feature
TypeScript,85,722,316.9275578703704,MERGED,0,3,2,0,1,95,False,0,0,0,1231,3,0.7538888888888889,Document
TypeScript,85,722,316.93074074074076,MERGED,3,5,1,0,1,93,False,0,0,0,1282,8,0.0225,Document
TypeScript,178,1359,320.3429513888889,MERGED,1,1,1,2,1,1,True,0,2,2,782,2,67.75722222222223,Feature
TypeScript,2147,14722,1473.7969212962962,MERGED,5,18,2,1,2,162,False,1,0,0,1033,23,3.453888888888889,Bug
Erlang,2054,12122,3797.317384259259,MERGED,13,26,4,2,1,131,False,0,2,1,631,39,116.09555555555555,Bug
TypeScript,178,1359,321.37716435185183,MERGED,7,20,1,1,1,17,True,0,1,1,791,27,8.148055555555555,Bug
C++,2234,23694,2357.6803125,CLOSED,20,24,2,2,2,188,True,0,2,2,577,44,215.60833333333332,Feature
TypeScript,58,78,820.5109837962963,CLOSED,25168,334,141,3,26,180,True,2,1,1,616,25502,159.32472222222222,Bug
Rust,264,5382,401.2108449074074,MERGED,3,213,13,5,1,0,False,1,4,2,7213,216,2398.173888888889,Bug
TypeScript,2147,14722,1473.2190972222222,MERGED,3,1,1,0,1,680,False,0,0,0,790,4,0.5719444444444445,Feature
TypeScript,178,1359,320.39907407407406,MERGED,5,10,1,1,2,7,True,0,1,1,1025,15,31.615277777777777,Bug
TypeScript,178,1359,324.50217592592594,MERGED,6,121,5,3,3,9,True,1,2,2,1298,127,77.00611111111111,Feature
Python,19248,70257,2462.726412037037,CLOSED,46,60,3,1,1,1578,False,1,0,0,288,106,21.60861111111111,Feature
PHP,1334,2960,4208.410173611111,MERGED,0,15,2,0,4,157,True,0,0,0,731,15,18.3575,Document
Python,19248,70257,2462.548773148148,CLOSED,82,82,7,3,1,10,False,1,2,1,2436,164,1168.233611111111,Feature
TypeScript,85,722,320.2915277777778,MERGED,0,9,1,0,2,4,False,0,0,0,1801,9,16.55666666666667,Document
TypeScript,85,722,320.2428703703704,MERGED,0,7,1,0,2,3,False,0,0,0,1686,7,17.724444444444444,Document
TypeScript,2147,14722,1477.0008449074076,MERGED,2,3,1,1,1,2,False,0,1,1,1737,5,23.725833333333334,Bug
Vue,293,495,833.8217939814814,MERGED,24,35,5,5,10,160,True,2,3,2,658,59,71.53583333333333,Bug
V,2097,34361,1554.7876157407409,MERGED,1,14,3,4,4,185,True,1,3,2,690,15,131.5675,Bug
TypeScript,2147,14722,1471.0313310185186,MERGED,2,2,2,0,1,665,False,0,0,0,994,4,16.979444444444443,Bug
C++,2234,23694,2357.9976967592593,MERGED,1,1,1,1,2,272,False,0,1,1,579,2,1.7469444444444444,Feature
C++,2234,23694,2359.968287037037,MERGED,20,52,9,1,5,273,False,0,1,1,612,72,24.996388888888887,Feature
C++,2234,23694,2359.9741666666664,MERGED,1,10,1,1,1,6,False,0,1,1,690,11,12.341944444444444,Bug
TypeScript,2147,14722,1470.8442708333332,MERGED,2,2,1,1,1,0,False,0,1,1,589,4,0.4688888888888889,Document
TypeScript,2147,14722,1470.8176041666666,MERGED,6,5,2,0,2,161,False,0,0,0,1054,11,2.1425,Feature
TypeScript,261,3765,678.5370949074074,MERGED,1,1,1,0,2,586,True,0,0,0,1098,2,1.6511111111111112,Document
C++,2234,23694,2359.928877314815,MERGED,1,10,1,0,1,5,False,0,0,0,744,11,0.9744444444444444,Bug
Go,421,1654,1510.8974305555555,MERGED,0,4,1,0,1,430,True,0,0,0,777,4,6.423333333333333,Bug
Vue,293,495,833.7248958333333,MERGED,26,37,4,3,3,159,True,0,3,2,718,63,6.400833333333333,Document
C++,2234,23694,2356.9801041666665,MERGED,7,9,1,1,1,532,False,0,1,1,501,16,1.4702777777777778,Bug
TypeScript,261,3765,677.6986689814815,MERGED,2,9,2,0,2,864,True,0,0,0,1687,11,0.8080555555555555,Document
TypeScript,261,3765,677.6770486111111,MERGED,12,23,2,0,3,184,False,0,0,0,1628,35,0.7572222222222222,Document
TypeScript,261,3765,677.5095023148148,MERGED,58,118,8,0,9,582,True,0,0,0,1397,176,7.560277777777777,Document
C++,2234,23694,2359.590266203704,MERGED,5,41,3,6,4,177,False,3,3,2,839,46,143.95111111111112,Feature
Rust,264,5382,403.9446759259259,MERGED,1,1,1,2,1,391,False,0,2,1,667,2,3.3805555555555555,Feature
Go,30,295,347.07611111111106,MERGED,577,572,136,1,4,99,True,0,1,1,610,1149,2.0077777777777777,Feature
PHP,1334,2960,4208.038599537037,MERGED,2,2,1,1,1,862,False,0,1,1,769,4,0.5908333333333333,Bug
JavaScript,8844,63474,4076.8569560185188,MERGED,1,1,1,0,1,89,True,0,0,0,811,2,200.37416666666667,Feature
TypeScript,41369,87411,2938.9917824074073,MERGED,5,21,2,5,1,1582,True,0,5,4,3048,26,10.436111111111112,Document
C++,2234,23694,2357.928865740741,MERGED,38,32,1,1,1,536,False,0,1,1,756,70,18.8825,Feature
Rust,264,5382,405.9918171296296,MERGED,1,1,1,0,1,91,True,0,0,0,769,2,71.97055555555555,Bug
Rust,264,5382,403.00409722222224,MERGED,3,51,1,0,1,80,True,0,0,0,707,54,21.511388888888888,Feature
JavaScript,5139,7049,1202.7126273148149,CLOSED,0,29,1,1,1,0,False,0,1,1,757,29,2.1619444444444444,Feature
TypeScript,2147,14722,1474.0531365740742,CLOSED,27,32,7,0,2,0,False,0,0,0,1722,59,1.8186111111111112,Bug
TypeScript,85,722,316.97435185185185,MERGED,11,19,1,0,1,154,False,0,0,0,1484,30,0.2761111111111111,Document
TypeScript,2071,16638,1243.4037037037037,CLOSED,0,15,1,1,1,0,False,0,1,1,932,15,137.9175,Document
JavaScript,5139,7049,1205.3756018518518,CLOSED,0,36,1,3,1,1,False,0,3,2,860,36,0.18944444444444444,Feature
TypeScript,261,3765,680.655636574074,MERGED,3,68,2,0,5,1,False,0,0,0,1655,71,5.490277777777778,Document
TypeScript,178,1359,321.49439814814815,MERGED,7,41,3,1,2,8,True,0,1,1,1454,48,7.620277777777778,Bug
PHP,1334,2960,4211.295405092593,CLOSED,1,1,1,4,1,0,False,0,4,2,1505,2,39.540277777777774,Document
Vue,293,495,833.714363425926,MERGED,67,81,10,5,4,158,True,0,5,3,1017,148,94.86,Bug
TypeScript,7,6,643.9343518518518,CLOSED,2,11,1,1,5,8,True,0,1,1,1050,13,168.5,Feature
Vue,293,495,831.5896875,MERGED,0,3,1,2,1,362,False,0,2,2,678,3,0.8486111111111111,Bug
TypeScript,58,78,822.1486458333334,MERGED,2,16,2,1,1,118,False,0,1,1,2049,18,82.51527777777778,Feature
TypeScript,7,6,643.0917361111111,MERGED,8,76,7,0,7,220,False,0,0,0,917,84,187.53472222222223,Feature
TypeScript,85,722,315.95765046296293,MERGED,1,1,1,0,1,77,False,0,0,0,1235,2,1.1375,Document
TypeScript,85,722,315.96557870370367,MERGED,1,3,2,0,2,94,False,0,0,0,1283,4,0.7308333333333333,Document
Kotlin,164,4296,405.86020833333333,MERGED,3,35,11,3,1,52,False,1,2,1,391,38,0.10222222222222223,Feature
PHP,883,2338,1832.2311805555555,CLOSED,2,47,3,4,2,0,False,1,3,2,2352,49,1049.6755555555555,Document
Rust,264,5382,402.0278703703704,MERGED,1,1,1,0,1,324,False,0,0,0,688,2,0.3836111111111111,Feature
TypeScript,261,3765,674.7763425925926,MERGED,36,37,2,0,1,257,True,0,0,0,1399,73,17.032777777777778,Document
Rust,264,5382,405.84307870370367,MERGED,2,2,1,2,1,393,False,1,1,1,937,4,0.8033333333333333,Feature
TypeScript,2147,14722,1471.8310532407406,MERGED,2,12,1,0,1,286,False,0,0,0,1094,14,23.79138888888889,Bug
V,2097,34361,1555.497337962963,MERGED,0,14,2,1,3,187,True,0,1,1,845,14,19.946944444444444,Bug
Vue,293,495,834.7376273148147,MERGED,1,2,2,5,1,161,True,0,5,3,1025,3,2.0683333333333334,Bug
TypeScript,261,3765,674.9397569444444,MERGED,1,1,1,0,1,858,True,0,0,0,1116,2,0.9572222222222222,Document
TypeScript,85,722,315.03497685185187,CLOSED,1,15,3,0,4,91,False,0,0,0,1506,16,6.204444444444444,Document
TypeScript,261,3765,678.9647569444445,MERGED,44,62,4,0,4,186,False,0,0,0,1854,106,22.386666666666667,Document
Go,421,1654,1510.9957986111112,MERGED,1044,536,26,0,1,432,True,0,0,0,707,1580,29.20611111111111,Document
Rust,3808,5430,439.71722222222223,CLOSED,1,477,5,0,5,6,False,0,0,0,551,478,595.1444444444444,Feature
TypeScript,261,3765,674.7085416666666,MERGED,43,36,1,0,1,574,True,0,0,0,1222,79,0.4588888888888889,Document
TypeScript,178,1359,323.56018518518516,MERGED,7,23,1,2,1,4,False,0,2,2,1929,30,11.524166666666666,Document
Rust,3808,5430,441.91079861111115,MERGED,26,2,2,2,1,182,False,1,1,1,296,28,205.90916666666666,Feature
Python,547,7160,2237.511203703704,MERGED,27,35,1,0,1,266,True,0,0,0,784,62,0.49416666666666664,Bug
TypeScript,2147,14722,1471.0247569444446,MERGED,6,126,2,0,1,664,False,0,0,0,1483,132,17.15888888888889,Feature
TypeScript,2147,14722,1470.8499421296294,MERGED,9,103,2,0,2,662,False,0,0,0,1511,112,21.357777777777777,Document
Rust,264,5382,404.7944212962963,MERGED,10,46,7,0,1,155,False,0,0,0,947,56,0.8286111111111111,Feature
TypeScript,202,107,1146.1034837962964,MERGED,49,51,1,6,2,239,True,1,5,4,1001,100,105.26472222222222,Document
TypeScript,261,3765,678.5252199074074,MERGED,3,12,2,0,3,92,True,0,0,0,2034,15,0.26222222222222225,Document
TypeScript,2147,14722,1470.8377430555556,MERGED,1,15,2,0,3,661,False,0,0,0,1707,16,6.970833333333333,Feature
TypeScript,2147,14722,1470.9498726851853,MERGED,4,4,1,0,1,47,False,0,0,0,1322,8,0.8211111111111111,Feature
V,2097,34361,1555.4872800925925,MERGED,55,61,6,0,5,186,True,0,0,0,871,116,20.99111111111111,Bug
TypeScript,7,6,643.992511574074,MERGED,2,2,1,0,2,9,True,0,0,0,999,4,45.191944444444445,Feature
TypeScript,2147,14722,1474.794976851852,MERGED,4,5,1,0,2,50,False,0,0,0,1764,9,0.2875,Bug
Rust,264,5382,404.052974537037,MERGED,0,1,1,0,1,392,False,0,0,0,788,1,0.48055555555555557,Feature
TypeScript,261,3765,677.8565277777778,MERGED,0,17,4,0,1,156,False,0,0,0,1778,17,0.09833333333333333,Document
Rust,264,5382,403.9723148148148,MERGED,3,6,3,0,2,154,False,0,0,0,781,9,0.6775,Bug
Rust,264,5382,403.9570138888889,MERGED,0,7,2,0,2,63,False,0,0,0,803,7,0.5194444444444445,Feature
TypeScript,178,1359,319.94930555555555,MERGED,1,71,3,4,5,4,False,2,2,2,2196,72,111.91527777777777,Document
TypeScript,261,3765,677.6481944444445,MERGED,3,4,2,0,1,155,False,0,0,0,1717,7,0.8980555555555556,Document
JavaScript,8844,63474,4077.2486689814814,MERGED,15,16,4,0,3,60,True,0,0,0,921,31,23.394444444444446,Bug
Java,450,746,4072.2165162037036,MERGED,1,1,1,1,2,25,False,0,1,1,932,2,1.1325,Bug
PHP,1334,2960,4209.057546296296,MERGED,1,1,1,0,1,863,False,0,0,0,1239,2,0.10138888888888889,Document
C++,2234,23694,2357.904270833333,MERGED,0,32,2,1,1,535,False,0,1,1,851,32,17.13888888888889,Bug
PHP,1334,2960,4209.011990740741,CLOSED,1,1,1,1,1,20,False,1,0,0,1568,2,0.40694444444444444,Document
TypeScript,261,3765,677.4886226851852,MERGED,8,28,2,0,2,581,True,0,0,0,2225,36,0.28833333333333333,Document
TypeScript,2147,14722,1474.1429282407407,MERGED,16,20,2,0,1,0,False,0,0,0,1933,36,1.481111111111111,Bug
PHP,1334,2960,4208.187118055555,MERGED,16,0,2,0,1,85,False,0,0,0,1331,16,25.20888888888889,Feature
TypeScript,2147,14722,1474.0777314814814,MERGED,2,4,4,0,1,163,False,0,0,0,1997,6,3.2505555555555556,Feature
Vue,293,495,831.2706828703704,MERGED,2,23,2,4,4,15,False,0,4,4,956,25,38.44833333333333,Bug
Vue,293,495,832.171875,MERGED,575,51,2,5,1,295,True,1,4,3,717,626,0.23555555555555555,Bug
Rust,3808,5430,439.9782638888889,CLOSED,4,1825,5,2,9,465,False,0,2,2,506,1829,496.9772222222222,Feature
TypeScript,495,2659,1907.001261574074,MERGED,84,90,26,0,11,99,True,0,0,0,243,174,169.26694444444445,Feature
PHP,1334,2960,4207.890254629629,MERGED,0,0,1,0,1,19,False,0,0,0,1577,0,32.58555555555556,Document
Python,547,7160,2240.8103819444445,MERGED,1,1,1,0,1,18,False,0,0,0,1710,2,65.42805555555556,Document
JavaScript,8844,63474,4075.2767245370374,MERGED,1,1,1,1,2,0,False,0,1,1,974,2,36.17944444444444,Bug
Python,19248,70257,2462.796956018519,CLOSED,0,3,1,1,2,1580,False,1,0,0,124,3,1.5697222222222222,Feature
TypeScript,178,1359,324.5632986111111,MERGED,71,73,2,9,13,10,False,4,5,2,2469,144,144.36444444444444,Feature
TypeScript,7,6,643.829224537037,MERGED,1,2,2,1,2,206,False,1,0,0,965,3,5.279444444444445,Feature
Go,421,1654,1512.1687962962963,MERGED,7,30,1,1,1,236,False,0,1,1,1981,37,90.8938888888889,Bug
Erlang,2054,12122,3796.2983564814817,MERGED,58,122,34,0,8,41,False,0,0,0,1363,180,1140.6630555555555,Document
C++,2234,23694,2357.0442245370373,MERGED,2,46,3,1,1,533,False,0,1,1,1033,48,17.16611111111111,Feature
TypeScript,85,722,315.2900231481481,MERGED,25,58,9,0,2,93,False,0,0,0,1068,83,0.2697222222222222,Document
TypeScript,261,3765,675.6002662037037,MERGED,5,14,6,0,1,258,True,0,0,0,1914,19,45.44111111111111,Document
Rust,264,5382,402.7450578703704,MERGED,0,12,1,0,1,78,True,0,0,0,921,12,1.8844444444444444,Feature
TypeScript,7,6,643.1447916666667,MERGED,1,1,1,0,3,10,False,0,0,0,810,2,23.28361111111111,Bug
C++,2234,23694,2356.9621412037036,MERGED,0,29,2,1,1,531,False,0,1,1,1040,29,17.371111111111112,Feature
Rust,264,5382,402.6907523148148,MERGED,1,2,1,0,2,389,False,0,0,0,963,3,2.160833333333333,Feature
TypeScript,261,3765,676.5285416666667,MERGED,1,11,3,0,1,860,True,0,0,0,2124,12,0.3525,Document
Go,421,1654,1509.2287152777778,MERGED,4,0,1,0,1,426,True,0,0,0,1066,4,16.06388888888889,Bug
Go,54,353,731.8558796296296,MERGED,3,4,3,1,2,206,True,1,0,0,1329,7,1.8077777777777777,Feature
TypeScript,85,722,316.1519328703704,MERGED,9,6,2,0,1,153,False,0,0,0,2281,15,1.8269444444444445,Document
JavaScript,5139,7049,1205.5257986111112,MERGED,2,11,2,4,1,250,False,2,2,2,1191,13,11.81,Bug
TypeScript,85,722,316.02578703703705,MERGED,246,77,6,0,1,78,False,0,0,0,2370,323,1.0252777777777777,Document
TypeScript,495,2659,1908.9997337962961,MERGED,0,1,1,0,1,242,False,0,0,0,323,1,191.37833333333333,Feature
C++,2234,23694,2356.8209606481482,MERGED,1,23,2,1,2,309,False,0,1,1,841,24,1.2797222222222222,Feature
Java,450,746,4074.033472222222,MERGED,25,97,7,2,2,74,True,0,2,1,763,122,28.419166666666666,Bug
TypeScript,178,1359,325.7619907407407,MERGED,1,15,1,2,2,10,True,0,2,2,2597,16,49.158611111111114,Feature
TypeScript,202,107,1145.6817824074074,MERGED,1,1,1,4,1,4,True,1,3,3,1030,2,2.633888888888889,Document
TypeScript,85,722,314.865162037037,MERGED,4,34,4,0,2,75,False,0,0,0,1858,38,26.01222222222222,Document
TypeScript,261,3765,675.6359722222222,MERGED,4,4,4,0,1,859,True,0,0,0,1987,8,0.10972222222222222,Document
Rust,3808,5430,442.10877314814815,MERGED,1,38,3,0,2,288,False,0,0,0,372,39,45.93527777777778,Document
TypeScript,261,3765,675.4901620370371,MERGED,4,14,3,0,1,576,True,0,0,0,1753,18,0.28583333333333333,Document
PHP,1334,2960,4206.213483796296,MERGED,11,2,6,0,1,198,False,0,0,0,1960,13,17.38861111111111,Feature
PHP,1334,2960,4206.11212962963,MERGED,1,1,1,0,1,68,False,0,0,0,1419,2,19.648888888888887,Document
C++,2234,23694,2355.6919907407405,MERGED,2,13,2,1,1,529,False,0,1,1,1006,15,4.268611111111111,Feature
JavaScript,5139,7049,1202.685289351852,MERGED,145,72,5,7,1,246,False,2,5,5,1764,217,92.52527777777777,Bug
Rust,3808,5430,441.619212962963,MERGED,95,254,2,1,1,241,False,0,1,1,497,349,164.37972222222223,Feature
Rust,264,5382,405.1416898148148,MERGED,82,659,35,1,27,0,False,0,1,1,1303,741,135.6286111111111,Feature
Go,2083,11769,1522.3165509259259,CLOSED,2,8,1,2,3,0,False,1,1,1,1169,10,0.33,Document
Go,54,353,732.9734027777778,MERGED,2,3,1,0,1,72,True,0,0,0,858,5,14.501666666666667,Document
TypeScript,178,1359,325.4583101851852,MERGED,372,298,5,1,3,0,False,0,1,1,2903,670,14.5425,Feature
C++,2234,23694,2360.8758564814816,MERGED,34,72,3,1,10,178,False,0,1,1,1733,106,74.07,Feature
Rust,3808,5430,442.0825578703704,MERGED,9,11,2,0,1,183,False,0,0,0,319,20,10.957777777777778,Document
Vue,293,495,832.5199421296296,MERGED,7,40,6,10,11,257,True,2,8,6,1424,47,179.61027777777778,Bug
PHP,1334,2960,4207.0704282407405,MERGED,17,9,5,12,13,76,False,7,5,1,2217,26,385.6336111111111,Document
PHP,883,2338,1830.141122685185,CLOSED,2,12,3,3,1,64,False,0,3,3,2033,14,430.30611111111114,Document
Python,19248,70257,2461.5734143518516,CLOSED,5,0,1,3,1,1576,False,2,1,1,117,5,1.0880555555555556,Feature
TypeScript,4,33,761.2334953703704,CLOSED,0,0,4,3,1,195,True,2,1,1,75,0,44.54416666666667,Feature
F#,271,818,2728.8087731481482,MERGED,1,3,1,1,1,2,False,0,1,1,1700,4,28.95861111111111,Document
TypeScript,2147,14722,1470.912951388889,MERGED,2,9,2,0,1,663,False,0,0,0,1915,11,0.44416666666666665,Document
Vue,293,495,835.0578356481482,MERGED,57,2,2,5,2,371,False,0,5,4,1545,59,42.12722222222222,Bug
Vue,293,495,835.0148032407407,MERGED,0,8,1,5,1,368,False,0,5,3,1398,8,43.104166666666664,Bug
Vue,293,495,835.024224537037,MERGED,1,1,1,5,2,369,False,0,5,4,1410,2,42.639722222222225,Bug
Rust,264,5382,404.03873842592594,MERGED,2,10,2,0,2,64,False,0,0,0,1468,12,137.9922222222222,Bug
Vue,293,495,834.9568518518519,MERGED,114,67,6,6,3,367,False,1,5,3,1599,181,44.243611111111115,Bug
Go,1835,11245,1730.037951388889,MERGED,4,4,3,0,3,85,False,0,0,0,121,8,4.845555555555555,Feature
TypeScript,261,3765,678.7775115740741,MERGED,14,20,12,0,3,868,True,0,0,0,2817,34,65.14888888888889,Document
TypeScript,42,46,770.0324884259259,MERGED,17,27,5,1,1,20,False,0,1,1,752,44,1.7077777777777778,Feature
V,2097,34361,1550.772662037037,MERGED,1,13,2,0,2,183,True,0,0,0,749,14,21.185277777777777,Bug
Go,395,660,1267.0876851851851,MERGED,12,54,2,0,2,85,False,0,0,0,361,66,286.4916666666667,Feature
TypeScript,202,107,1143.0860069444445,MERGED,2,2,1,4,1,3,True,1,3,3,1147,4,12.169166666666667,Document
PHP,1334,2960,4209.086307870371,MERGED,59,6,7,0,2,145,False,0,0,0,2601,65,0.6905555555555556,Document
Python,547,7160,2236.4322569444444,MERGED,2,45,1,1,4,27,False,0,1,1,526,47,73.10805555555555,Bug
PHP,1334,2960,4208.983622685185,MERGED,7,66,3,0,2,144,False,0,0,0,2600,73,0.5961111111111111,Bug
Rust,433,2229,238.60847222222222,MERGED,1,1,1,0,1,799,False,0,0,0,232,2,0.007222222222222222,Feature
Vue,293,495,833.9824537037038,MERGED,7,13,1,8,4,366,False,2,6,5,1466,20,53.39416666666666,Bug
TypeScript,7,6,647.1438888888889,MERGED,0,1,1,0,1,12,False,0,0,0,1256,1,0.8205555555555556,Feature
Rust,3808,5430,440.5141087962963,MERGED,0,20,1,0,2,53,False,0,0,0,284,20,3.946388888888889,Feature
Rust,264,5382,405.9036458333333,MERGED,7,26,2,0,1,394,False,0,0,0,1496,33,0.505,Document
Vue,293,495,831.7207754629629,MERGED,12,150,9,7,6,155,True,1,6,5,1676,162,123.24944444444445,Bug
PHP,883,2338,1835.0875578703706,CLOSED,2,2,1,2,1,27,False,0,2,2,1554,4,66.55583333333334,Document
TypeScript,41369,87411,2937.494537037037,MERGED,0,0,1,0,1,0,False,0,0,0,2082,0,1.916111111111111,Document
Python,19248,70257,2463.456053240741,CLOSED,1,7,1,3,1,0,False,0,3,2,256,8,78.40722222222222,Feature
PHP,1334,2960,4205.932604166667,MERGED,50,1,4,4,4,75,False,1,3,2,1879,51,99.07944444444445,Document
TypeScript,0,0,159.06256944444445,MERGED,39,2093,17,1,13,4,False,0,1,1,3418,2132,472.2825,Document
Go,421,1654,1509.149583333333,MERGED,12,23,2,0,1,424,True,0,0,0,2063,35,2.5411111111111113,Document
Rust,264,5382,405.1977893518519,MERGED,10,5,1,0,1,327,False,0,0,0,1433,15,14.02111111111111,Bug
TypeScript,15,34,493.53092592592594,MERGED,3,4,1,0,1,923,False,0,0,0,253,7,1.4755555555555555,Bug
TypeScript,85,722,318.00395833333334,MERGED,0,9,2,0,5,80,False,0,0,0,2754,9,0.6277777777777778,Document
Java,450,746,4074.0783449074074,MERGED,6,36,2,1,2,373,False,0,1,1,314,42,172.74333333333334,Feature
PHP,1334,2960,4207.85505787037,MERGED,1,2,1,1,5,44,False,0,1,1,1792,3,5.512222222222222,Document
Vue,293,495,831.803275462963,MERGED,9,63,5,16,10,52,False,7,9,7,1616,72,97.34972222222223,Bug
Vue,293,495,833.8051388888889,MERGED,4,4,1,5,2,53,False,1,4,3,1404,8,3.987222222222222,Bug
Vue,293,495,832.7130092592593,MERGED,14,82,7,6,3,157,True,0,6,3,1664,96,50.69611111111111,Document
Rust,3808,5430,439.78888888888883,MERGED,1,2,1,0,1,91,False,0,0,0,302,3,0.7069444444444445,Feature
Rust,264,5382,405.08473379629635,MERGED,8,35,3,0,1,88,True,0,0,0,1686,43,0.49444444444444446,Feature
TypeScript,261,3765,678.7547106481481,MERGED,1,16,3,0,2,867,True,0,0,0,2344,17,0.32555555555555554,Document
TypeScript,261,3765,678.7282638888888,MERGED,12,64,2,0,1,866,True,0,0,0,2415,76,0.25305555555555553,Document
Rust,433,2229,240.6969212962963,MERGED,2,8,2,2,1,811,False,1,1,1,266,10,21.928333333333335,Feature
Go,1835,11245,1728.8496412037036,MERGED,1,1,1,0,1,84,False,0,0,0,114,2,0.014166666666666666,Feature
Erlang,2054,12122,3795.1131828703706,MERGED,3,0,1,0,1,159,False,0,0,0,241,3,1.3075,Feature
Go,30,295,348.0565856481482,MERGED,74,28,1,1,1,37,True,0,1,1,1917,102,0.07805555555555556,Document
TypeScript,261,3765,678.4823148148148,MERGED,5,15,4,0,1,584,True,0,0,0,2333,20,0.21638888888888888,Document
Vue,293,495,832.8246180555556,MERGED,1396,446,35,10,55,298,True,2,8,4,1346,1842,30.094722222222224,Bug
Rust,3808,5430,441.7431365740741,MERGED,126,140,7,1,1,118,False,1,0,0,490,266,23.585833333333333,Document
Python,19248,70257,2460.700636574074,CLOSED,48,85,3,7,11,229,False,5,2,2,942,133,167.43972222222223,Document
F#,33,60,2258.975729166667,MERGED,19,16,2,0,1,23,False,0,0,0,2749,35,0.6113888888888889,Bug
TypeScript,2147,14722,1474.205173611111,MERGED,19,41,2,0,1,287,False,0,0,0,2564,60,0.2075,Document
Rust,417,2801,924.2182291666667,MERGED,5,23,3,0,1,264,False,0,0,0,269,28,3.390833333333333,Feature
Go,421,1654,1508.2449189814815,MERGED,1,3,1,0,1,422,True,0,0,0,1893,4,16.45777777777778,Bug
Java,1,10,235.82969907407406,MERGED,1,1,1,0,1,25,True,0,0,0,1862,2,0.08305555555555555,Document
JavaScript,5139,7049,1204.5477893518519,MERGED,13,19,12,2,2,249,False,0,2,2,2598,32,22.635833333333334,Document
Rust,3808,5430,440.986724537037,CLOSED,54,40,6,0,1,31,False,0,0,0,454,94,18.295277777777777,Feature
PHP,1334,2960,4205.916423611111,MERGED,1,5,3,0,3,42,False,0,0,0,1757,6,25.455833333333334,Document
TypeScript,85,722,315.1660300925926,MERGED,85,135,7,0,7,76,False,0,0,0,2812,220,18.477222222222224,Document
TypeScript,261,3765,677.4905439814814,MERGED,32,27,5,0,1,863,True,0,0,0,2256,59,0.3433333333333333,Document
Vue,293,495,831.7379861111111,MERGED,0,22,2,7,2,156,True,1,6,4,1393,22,35.086666666666666,Bug
Vue,293,495,832.0811805555555,MERGED,1,1,1,2,1,364,False,0,2,2,1399,2,18.62,Bug
TypeScript,7,6,647.1382175925926,MERGED,1,62,2,0,12,21,False,0,0,0,2093,63,143.48333333333332,Feature
Go,395,660,1268.0785648148149,MERGED,77,157,4,0,8,86,False,0,0,0,377,234,120.6625,Feature
TypeScript,261,3765,676.7899884259259,MERGED,0,15,2,0,2,862,True,0,0,0,2337,15,16.735,Document
Rust,264,5382,402.9916666666666,MERGED,3,27,3,0,1,79,True,0,0,0,1837,30,19.13722222222222,Document
PHP,1334,2960,4205.890173611111,MERGED,89,2,2,3,1,41,False,1,2,1,1899,91,5.631944444444445,Document
Vue,293,495,832.0455671296296,MERGED,27,26,2,4,8,294,True,1,3,2,1367,53,0.895,Bug
Vue,293,495,831.9825462962963,MERGED,1,1,1,3,1,293,True,0,3,2,1230,2,0.8658333333333333,Bug
TypeScript,261,3765,676.6524652777778,MERGED,49,48,6,0,1,259,True,0,0,0,2398,97,1.0533333333333332,Document
C++,2234,23694,2357.753923611111,MERGED,40,89,3,1,1,534,False,0,1,1,1288,129,3.3175,Feature
TypeScript,218,1201,2930.2014236111113,MERGED,267,86,17,6,7,127,False,2,4,2,659,353,335.4819444444444,Bug
TypeScript,261,3765,676.5188425925926,MERGED,7,211,11,0,4,154,False,0,0,0,3102,218,1.0363888888888888,Document
Rust,433,2229,238.69052083333335,MERGED,4,2,1,1,1,133,False,0,1,1,331,6,0.8025,Feature
Rust,433,2229,238.62961805555554,MERGED,4,14,3,1,1,800,False,1,0,0,281,18,2.044722222222222,Feature
Rust,3808,5430,439.5840393518518,MERGED,0,21,3,0,2,60,False,0,0,0,478,21,30.566111111111113,Feature
TypeScript,85,722,315.2955324074074,MERGED,5,39,3,0,6,152,False,0,0,0,3178,44,21.586944444444445,Document
TypeScript,307,2556,539.8278703703703,MERGED,6,6,2,2,1,565,True,0,2,2,1703,12,2.3991666666666664,Feature
Go,395,660,1266.1538773148147,MERGED,13,4,1,1,2,83,False,1,0,0,200,17,18.613055555555555,Feature
Go,395,660,1266.1686226851853,MERGED,1,1,1,0,1,79,False,0,0,0,252,2,3.8152777777777778,Feature
Vue,293,495,830.4341782407408,MERGED,21,4,2,9,9,256,True,2,7,5,1529,25,58.82222222222222,Bug
TypeScript,261,3765,678.6846643518519,MERGED,4,177,6,0,5,93,True,0,0,0,3960,181,331.26694444444445,Document
Go,395,660,1266.1319791666667,MERGED,1,1,1,0,1,82,False,0,0,0,199,2,18.192777777777778,Bug
Rust,264,5382,402.9864236111111,MERGED,0,11,2,0,1,2,False,0,0,0,1222,11,1.1466666666666667,Feature
Rust,264,5382,402.9518865740741,MERGED,36,35,1,0,1,177,False,0,0,0,1312,71,2.0141666666666667,Feature
C++,2234,23694,2356.866608796296,MERGED,7,22,1,1,6,310,False,0,1,1,1429,29,21.1575,Document
TypeScript,261,3765,675.7298032407408,MERGED,1,1,1,0,3,579,True,0,0,0,2537,2,18.960277777777776,Document
TypeScript,178,1359,320.4432175925926,MERGED,37,218,6,1,1,35,True,0,1,1,2949,255,4.525,Feature
Kotlin,164,4296,403.818900462963,MERGED,11,73,7,0,2,51,False,0,0,0,386,84,22.121944444444445,Bug
PHP,883,2338,1834.8017592592594,CLOSED,0,1,1,2,1,0,False,0,2,2,1813,1,76.52666666666667,Document
Vue,293,495,829.5143055555556,MERGED,6,19,2,3,3,254,True,0,3,3,1414,25,80.56944444444444,Bug
Rust,3808,5430,439.6663888888889,MERGED,139,43,10,0,1,90,False,0,0,0,473,182,1.0647222222222221,Feature
Vue,293,495,831.1854861111111,MERGED,270,399,2,5,2,291,True,1,4,3,1428,669,0.5122222222222222,Bug
PHP,0,0,108.145,MERGED,1,1,1,0,2,10,False,0,0,0,422,2,0.011944444444444445,Document
Go,421,1654,1512.189710648148,MERGED,12,12,3,0,1,434,True,0,0,0,2559,24,21.450277777777778,Bug
Vue,293,495,831.1059953703704,MERGED,0,7,1,4,1,361,False,0,4,3,1416,7,0.4761111111111111,Bug
PHP,0,0,108.07046296296296,MERGED,3,80,2,0,2,37,False,0,0,0,518,83,0.015,Document
Vue,293,495,831.0455555555556,MERGED,1,1,1,3,1,360,False,0,3,3,1287,2,1.2283333333333333,Bug
Vue,293,495,830.9858564814814,MERGED,4,8,2,3,2,359,False,0,3,2,1475,12,2.707222222222222,Bug
Rust,433,2229,233.5832060185185,MERGED,1,11,1,1,2,779,False,0,1,1,225,12,30.78388888888889,Feature
Go,421,1654,1509.2187152777778,MERGED,49,154,3,6,3,12,False,2,4,3,3290,203,140.55833333333334,Bug
TypeScript,2147,14722,1471.8938657407407,MERGED,74,201,14,0,6,161,False,0,0,0,3445,275,4.031944444444444,Document
Python,19248,70257,2459.9739236111113,CLOSED,4,21,2,3,2,1572,False,3,0,0,362,25,67.06083333333333,Bug
Vue,293,495,830.8785532407406,MERGED,26,7,1,4,1,374,True,0,4,3,1138,33,0.7627777777777778,Document
Erlang,2054,12122,3797.8518981481484,MERGED,1,3,2,2,2,359,True,0,2,1,1074,4,7.851388888888889,Document
TypeScript,178,1359,319.68327546296297,MERGED,30,5,6,1,1,33,True,0,1,1,2800,35,0.3477777777777778,Bug
TypeScript,15,34,489.7704166666667,MERGED,1,6,1,0,2,907,False,0,0,0,238,7,0.48527777777777775,Bug
Python,547,7160,2238.7999421296295,MERGED,7,1,2,0,2,15,False,0,0,0,1617,8,1.0969444444444445,Document
Erlang,2054,12122,3794.3825694444445,MERGED,84,520,13,1,4,5,False,1,0,0,1342,604,1058.0127777777777,Document
Vue,293,495,830.1212037037036,MERGED,12,2,2,6,2,358,False,1,5,3,1312,14,15.206388888888888,Bug
Python,547,7160,2238.681898148148,MERGED,8,8,4,1,1,142,False,1,0,0,465,16,5.843055555555556,Bug
TypeScript,261,3765,674.8340162037038,MERGED,16,32,3,0,1,575,True,0,0,0,2918,48,0.46166666666666667,Document
TypeScript,261,3765,674.8036458333333,MERGED,52,90,4,0,1,857,True,0,0,0,2864,142,1.196388888888889,Document
JavaScript,5139,7049,1203.6437152777778,MERGED,5,34,3,6,5,247,False,3,3,2,2903,39,25.739722222222223,Feature
Python,547,7160,2237.4750925925923,CLOSED,26,117,5,0,3,24,True,0,0,0,711,143,348.5938888888889,Bug
TypeScript,261,3765,674.6386689814815,MERGED,15,71,13,0,2,181,False,0,0,0,2549,86,0.6813888888888889,Document
JavaScript,5139,7049,1201.945300925926,MERGED,4,19,3,1,1,290,False,0,1,1,2240,23,3.6294444444444443,Document
Vue,293,495,830.0627893518518,MERGED,16,0,2,4,1,255,True,0,4,3,1439,16,2.1891666666666665,Bug
TypeScript,15,34,492.4761111111111,MERGED,0,3,1,0,1,164,False,0,0,0,408,3,4.864166666666667,Feature
TypeScript,15,34,492.52759259259255,MERGED,11,16,1,0,2,919,False,0,0,0,335,27,2.108888888888889,Feature
Erlang,2054,12122,3795.17662037037,MERGED,9,62,3,2,1,15,False,0,2,1,1302,71,42.23111111111111,Document
Vue,293,495,835.0455208333333,MERGED,59,75,14,7,3,370,False,1,6,3,1755,134,22.23611111111111,Bug
TypeScript,307,2556,539.7033680555555,MERGED,5,9,1,1,2,178,True,0,1,1,1233,14,3.0566666666666666,Bug
Vue,293,495,827.9143634259259,MERGED,1,3,1,11,3,356,False,2,9,4,1564,4,77.12361111111112,Bug
Go,395,660,1267.8135300925926,MERGED,3,3,3,0,1,194,False,0,0,0,297,6,1.0802777777777777,Feature
Java,450,746,4071.085335648148,MERGED,5,26,1,2,7,31,False,1,1,1,1217,31,72.62638888888888,Bug
Python,19248,70257,2459.6335069444444,CLOSED,1,29,2,4,4,1571,False,3,1,1,431,30,7.5280555555555555,Bug
Java,450,746,4072.1724652777775,MERGED,19,19,2,1,3,142,False,0,1,1,1480,38,19.34888888888889,Bug
TypeScript,15,34,488.2706712962963,MERGED,6,4,1,0,1,128,False,0,0,0,328,10,3.6155555555555554,Feature
TypeScript,15,34,491.61994212962964,MERGED,19,22,11,0,5,914,False,0,0,0,359,41,8.499166666666667,Feature
TypeScript,15,34,491.4460185185185,MERGED,14,28,6,0,4,163,False,0,0,0,320,42,15.344444444444445,Feature
TypeScript,15,34,491.79052083333335,MERGED,0,6,1,0,2,308,False,0,0,0,283,6,0.13083333333333333,Feature
Python,547,7160,2236.788738425926,MERGED,4,12,1,2,2,138,False,2,0,0,1039,16,42.33722222222222,Bug
TypeScript,15,34,491.7191203703704,MERGED,21,19,4,0,2,917,False,0,0,0,286,40,1.2077777777777778,Feature
TypeScript,15,34,491.6578240740741,MERGED,22,0,1,0,1,915,False,0,0,0,320,22,2.6816666666666666,Feature
Rust,264,5382,405.9703240740741,MERGED,34,33,3,0,1,90,True,0,0,0,1918,67,1.3611111111111112,Feature
Go,395,660,1263.8861921296295,MERGED,1,2,1,0,1,192,False,0,0,0,242,3,0.28888888888888886,Feature
TypeScript,15,34,491.56840277777775,MERGED,3,15,2,0,1,913,False,0,0,0,372,18,2.3561111111111113,Document
JavaScript,9664,43889,3660.806435185185,MERGED,1,184,3,4,1,0,False,2,2,1,719,185,433.3702777777778,Feature
TypeScript,307,2556,538.7187847222223,MERGED,2,2,1,1,1,563,True,0,1,1,1035,4,16.658333333333335,Bug
Rust,433,2229,238.6498726851852,MERGED,1245,1268,10,1,1,801,False,0,1,1,456,2513,1.5547222222222221,Feature
TypeScript,7,6,646.135150462963,MERGED,25,50,4,0,9,11,False,0,0,0,2359,75,21.400277777777777,Feature
TypeScript,2071,16638,1243.3221064814813,CLOSED,9,329,7,5,11,0,False,4,1,1,8754,338,2139.6116666666667,Document
Go,395,660,1266.185,MERGED,21,50,1,1,2,84,False,1,0,0,255,71,21.33972222222222,Feature
Rust,433,2229,235.61645833333333,MERGED,13,18,3,0,1,788,False,0,0,0,278,31,0.5455555555555556,Feature
C++,2234,23694,2356.7627777777775,MERGED,11,37,2,3,12,270,False,1,2,2,2536,48,145.38222222222223,Bug
Rust,433,2229,235.59046296296296,MERGED,23,17,3,1,1,787,False,0,1,1,298,40,1.1669444444444443,Feature
TypeScript,15,34,491.12532407407406,MERGED,3,6,3,2,1,474,True,1,1,1,311,9,5.699166666666667,Feature
V,2097,34361,1555.3082638888889,MERGED,3,21,3,0,3,214,True,0,0,0,1617,24,66.80361111111111,Document
Rust,3808,5430,440.77738425925924,MERGED,0,189,3,0,1,94,False,0,0,0,519,189,1.5352777777777777,Bug
Go,395,660,1266.1230324074074,MERGED,6,9,1,0,1,78,False,0,0,0,259,15,17.684722222222224,Feature
C++,2234,23694,2355.892025462963,MERGED,10,13,2,1,4,2,False,0,1,1,2344,23,92.27083333333333,Document
Go,421,1654,1509.242210648148,MERGED,59,0,2,0,1,427,True,0,0,0,2792,59,15.729166666666666,Document
JavaScript,5139,7049,1205.901701388889,MERGED,7,37,3,1,1,79,False,0,1,1,3377,44,14.92,Bug
TypeScript,15,34,493.48898148148146,MERGED,66,104,2,1,5,310,False,1,0,0,535,170,0.8513888888888889,Feature
TypeScript,15,34,493.4478125,MERGED,5,357,9,0,2,309,False,0,0,0,528,362,0.7297222222222223,Bug
Erlang,2054,12122,3797.3365856481482,MERGED,0,29,2,2,1,324,False,0,2,1,1151,29,7.849166666666667,Document
Erlang,2054,12122,3795.244699074074,MERGED,23,163,7,0,1,130,False,0,0,0,450,186,14.660277777777777,Bug
JavaScript,5139,7049,1205.825324074074,MERGED,3,33,3,2,3,93,False,1,1,1,2887,36,2.233888888888889,Feature
C#,80,125,819.4204976851852,CLOSED,327,10649,60,0,27,171,True,0,0,0,834,10976,552.3822222222223,Document
TypeScript,17,33,719.9513425925926,MERGED,9,18,2,3,2,36,False,1,2,2,392,27,26.471944444444443,Feature
JavaScript,9664,43889,3655.770717592593,MERGED,2,12,1,0,1,79,False,0,0,0,319,14,0.4197222222222222,Feature
Python,547,7160,2238.6818634259257,MERGED,10,10,3,1,1,141,False,1,0,0,566,20,5.181388888888889,Bug
Python,547,7160,2238.6818171296295,MERGED,30,18,1,1,2,140,False,1,0,0,552,48,4.740555555555556,Bug
Go,395,660,1265.0362499999999,MERGED,4,9,2,0,1,47,False,0,0,0,275,13,22.334722222222222,Feature
C#,80,125,819.589513888889,MERGED,10436,25935,241,0,174,176,False,0,0,0,1021,36371,534.2688888888889,Document
C#,80,125,821.5795601851852,MERGED,0,9223,39,0,20,212,False,0,0,0,974,9223,452.21222222222224,Document
JavaScript,5139,7049,1204.7285069444445,MERGED,12,35,8,3,4,0,False,1,2,2,319,47,19.226666666666667,Bug
F#,271,818,2727.4525810185182,MERGED,17,16,3,1,2,70,False,1,0,0,2941,33,10.899722222222222,Document
PHP,1334,2960,4206.197592592593,MERGED,23,25,3,1,1,861,False,1,0,0,3279,48,26.780277777777776,Document
TypeScript,178,1359,322.75567129629627,MERGED,2,55,11,7,2,0,False,3,4,3,4593,57,119.1075,Feature
PHP,0,0,108.10016203703704,MERGED,1,2,2,0,1,9,False,0,0,0,570,3,0.010555555555555556,Document
TypeScript,15,34,492.2033333333333,MERGED,14,21,4,0,1,918,False,0,0,0,538,35,4.849722222222222,Feature
Go,395,660,1265.1161689814815,MERGED,8,12,1,0,1,48,False,0,0,0,289,20,0.11972222222222222,Feature
PHP,1334,2960,4206.037210648148,MERGED,35,22,4,0,7,43,False,0,0,0,2439,57,21.353055555555557,Document
Rust,264,5382,403.0173611111111,MERGED,42,42,8,2,1,81,True,1,1,1,1928,84,18.520555555555557,Feature
C++,2234,23694,2355.691828703704,CLOSED,18,77,4,1,9,269,False,0,1,1,2280,95,99.62666666666667,Feature
JavaScript,8844,63474,4076.3755092592596,MERGED,210,216,4,0,2,1,False,0,0,0,2298,426,20.6225,Bug
Python,137,75,686.1460300925927,MERGED,0,357,14,0,32,4,False,0,0,0,4523,357,2182.715,Document
Rust,264,5382,402.8787037037037,MERGED,3,6,3,0,1,229,True,0,0,0,2066,9,3.8958333333333335,Feature
TypeScript,15,34,488.7282060185185,MERGED,3,9,1,0,1,906,False,0,0,0,417,12,0.42916666666666664,Document
TypeScript,15,34,490.5508101851852,MERGED,159,192,10,1,18,129,False,0,1,1,553,351,44.00083333333333,Feature
TypeScript,41369,87411,2941.492962962963,MERGED,1,0,1,2,1,0,False,0,2,2,2061,1,1.4005555555555556,Document
C++,2234,23694,2356.9841435185185,MERGED,11,22,2,1,1,311,False,0,1,1,2259,33,18.330833333333334,Feature
TypeScript,15,34,490.33157407407407,MERGED,51,116,13,0,8,161,False,0,0,0,502,167,48.716944444444444,Feature
Python,547,7160,2236.582523148148,CLOSED,20,53,3,0,3,74,False,0,0,0,415,73,47.71944444444444,Feature
Go,30,295,345.1377199074074,MERGED,5,7,2,0,2,90,True,0,0,0,2283,12,26.828055555555554,Document
TypeScript,17,33,721.9181018518519,MERGED,27,18,3,1,1,38,False,0,1,1,493,45,1.3608333333333333,Bug
Rust,264,5382,402.01376157407407,MERGED,31,125,7,0,1,136,False,0,0,0,1818,156,19.435555555555556,Document
Vue,293,495,829.8054976851853,MERGED,101,46,6,5,2,154,True,1,4,3,1803,147,57.06861111111111,Bug
TypeScript,261,3765,678.7140856481482,MERGED,255,302,81,1,7,260,True,0,1,1,4865,557,75.51583333333333,Document
TypeScript,15,34,490.56784722222227,MERGED,3,18,2,0,1,910,False,0,0,0,559,21,24.420555555555556,Feature
Java,450,746,4072.1967013888893,CLOSED,253,648,21,1,3,24,False,0,1,1,480,901,0.12694444444444444,Bug
JavaScript,5139,7049,1203.8908912037036,MERGED,13,19,14,1,5,95,False,0,1,1,3274,32,2.3333333333333335,Document
TypeScript,2071,16638,1244.0728125,MERGED,1,3,1,0,2,2,False,0,0,0,2272,4,95.68027777777777,Document
JavaScript,5139,7049,1202.7831481481483,MERGED,6,162,10,3,10,90,False,1,2,2,3096,168,46.36388888888889,Feature
C#,80,125,820.8292013888889,CLOSED,5,8,2,3,1,4,False,0,3,2,652,13,136.95777777777778,Document
Rust,264,5382,401.13124999999997,MERGED,28,79,15,0,10,0,False,0,0,0,1912,107,38.64861111111111,Bug
TypeScript,139,827,747.4704976851853,MERGED,1,121,4,3,4,26,False,1,2,2,460,122,19.461111111111112,Feature
Go,2083,11769,1517.7984374999999,MERGED,22,22,2,7,2,0,False,2,5,2,1531,44,0.7233333333333334,Document
TypeScript,15,34,490.4581597222222,MERGED,1,79,2,0,4,909,False,0,0,0,425,80,1.856111111111111,Feature
TypeScript,15,34,490.4333564814815,MERGED,10,19,9,0,3,908,False,0,0,0,467,29,1.673888888888889,Feature
TypeScript,2147,14722,1475.01375,MERGED,50,56,7,0,1,288,False,0,0,0,4158,106,0.03333333333333333,Document
JavaScript,9664,43889,3660.4275115740743,MERGED,1,1,1,0,1,626,False,0,0,0,499,2,0.16722222222222222,Bug
Java,450,746,4071.0951620370374,MERGED,30,73,2,1,4,23,False,0,1,1,582,103,3.195,Feature
C#,80,125,820.7086342592593,MERGED,607,2181,86,1,67,177,False,1,0,0,1034,2788,381.96194444444444,Document
TypeScript,1297,21107,416.14416666666665,MERGED,1,27,5,1,2,931,True,0,1,1,2255,28,0.6683333333333333,Document
C#,80,125,818.6178356481481,MERGED,8,8,2,0,2,175,False,0,0,0,520,16,1.6472222222222221,Document
TypeScript,41369,87411,2939.636134259259,MERGED,2,2,2,5,4,412,True,3,2,1,2107,4,9.335833333333333,Document
TypeScript,15,34,489.7399421296296,MERGED,3,11,2,0,1,160,False,0,0,0,420,14,1.4597222222222221,Bug
TypeScript,41369,87411,2939.6955555555555,CLOSED,14,168,11,5,3,0,False,2,3,2,2080,182,1.2372222222222222,Document
Python,547,7160,2239.8158564814817,MERGED,0,5,5,0,2,227,False,0,0,0,675,5,1.3816666666666666,Bug
C#,80,125,820.5176157407408,MERGED,735,1121,38,0,53,173,True,0,0,0,877,1856,361.77194444444444,Document
PHP,0,0,105.19640046296297,MERGED,1,190,5,0,1,34,False,0,0,0,649,191,0.045,Document
JavaScript,5139,7049,1203.8053125,MERGED,1,735,15,3,6,0,False,1,2,2,394,736,42.61472222222222,Feature
TypeScript,41369,87411,2937.449930555556,CLOSED,1,1,1,1,1,1896,True,0,1,1,2056,2,0.3075,Document
TypeScript,261,3765,678.4904861111112,MERGED,15,81,6,0,2,213,True,0,0,0,3937,96,0.22944444444444445,Document
Python,19248,70257,2460.8129166666668,CLOSED,3,6,2,1,1,1574,False,1,0,0,568,9,3.3091666666666666,Bug
Java,450,746,4074.0590625,MERGED,5,198,21,1,6,26,False,0,1,1,757,203,3.147777777777778,Document
TypeScript,15,34,492.52449074074076,MERGED,4,8,1,0,1,130,False,0,0,0,573,12,23.88111111111111,Feature
TypeScript,41369,87411,2938.799965277778,MERGED,0,1,1,0,2,1899,True,0,0,0,2085,1,1.1855555555555555,Document
Python,19248,70257,2460.3764583333336,CLOSED,6,6,2,1,1,1573,False,1,0,0,485,12,4.98,Feature
PHP,0,0,104.24719907407406,MERGED,1,39,3,0,1,52,True,0,0,0,688,40,0.01,Document
TypeScript,41369,87411,2938.438136574074,MERGED,6,7,2,1,2,1578,True,0,1,1,2106,13,0.4913888888888889,Document
JavaScript,34,25,198.6273611111111,MERGED,3002,3784,1,0,1,11,False,0,0,0,700,6786,11.30638888888889,Feature
Python,137,75,686.1219560185185,MERGED,0,285,11,0,17,2,False,0,0,0,2164,285,986.1469444444444,Document
TypeScript,15,34,488.3614351851852,MERGED,7,7,1,0,1,472,True,0,0,0,399,14,2.3725,Feature
Vue,293,495,829.8293402777778,MERGED,3157,15,24,4,1,373,True,0,4,4,599,3172,25.624444444444446,Feature
TypeScript,178,1359,320.7804513888889,MERGED,1686,115,10,2,1,36,True,0,2,2,3667,1801,22.455833333333334,Feature
Rust,3808,5430,439.51371527777775,MERGED,33,51,2,0,1,240,False,0,0,0,718,84,100.25916666666667,Bug
Rust,264,5382,405.9934375,MERGED,50,140,12,0,7,395,False,0,0,0,3257,190,72.86277777777778,Feature
Python,547,7160,2237.834988425926,MERGED,16,10,2,1,2,139,False,1,0,0,614,26,17.471944444444443,Bug
TypeScript,15,34,492.18792824074075,MERGED,83,257,7,0,7,475,True,0,0,0,552,340,3.220833333333333,Feature
C#,80,125,820.546076388889,MERGED,11,25,4,0,2,156,True,0,0,0,661,36,14.775,Document
TypeScript,261,3765,676.8660648148149,MERGED,14,77,7,0,1,183,False,0,0,0,3929,91,1.3847222222222222,Document
Python,2407,12180,244.84587962962962,MERGED,0,1,1,4,2,0,False,2,2,1,728,1,4.940555555555555,Document
Erlang,2054,12122,3797.3145717592593,MERGED,140,2018,37,2,4,16,False,0,2,1,1721,2158,689.6325,Document
Java,450,746,4071.031828703704,MERGED,26,31,2,0,1,30,False,0,0,0,2122,57,2.3133333333333335,Bug
Rust,433,2229,235.55881944444445,MERGED,13,394,8,1,2,786,False,0,1,1,606,407,2.2605555555555554,Document
TypeScript,15,34,491.67223379629627,MERGED,10,2,1,0,1,916,False,0,0,0,523,12,0.26305555555555554,Bug
TypeScript,261,3765,676.5304050925926,MERGED,364,399,29,0,2,580,True,0,0,0,4526,763,0.25833333333333336,Document
C++,2234,23694,2360.0428819444446,MERGED,5,12,6,1,4,7,False,0,1,1,964,17,66.29805555555555,Feature
JavaScript,9664,43889,3657.1249652777774,MERGED,2,22,4,0,1,52,True,0,0,0,481,24,0.30722222222222223,Feature
TypeScript,2147,14722,1471.9531828703703,MERGED,61,50,6,0,1,67,False,0,0,0,4104,111,0.5736111111111111,Feature
TypeScript,15,34,490.58730324074077,MERGED,47,87,16,1,5,911,False,1,0,0,639,134,23.926111111111112,Bug
TypeScript,261,3765,675.8415856481481,MERGED,191,226,15,0,5,153,False,0,0,0,3606,417,0.24416666666666667,Document
Python,2407,12180,243.83755787037038,MERGED,1,1,1,0,2,250,True,0,0,0,792,2,29.0625,Document
TypeScript,261,3765,675.7599074074075,MERGED,16,38,5,0,2,97,False,0,0,0,3983,54,0.3136111111111111,Document
TypeScript,261,3765,675.6224652777778,MERGED,265,299,34,0,3,578,True,0,0,0,4651,564,1.1744444444444444,Document
JavaScript,5139,7049,1204.8508796296296,MERGED,27,1651,12,1,12,90,False,0,1,1,3899,1678,115.79722222222222,Feature
TypeScript,41369,87411,2937.7592476851855,MERGED,2,14,2,0,1,19,False,0,0,0,2520,16,279.90527777777777,Document
TypeScript,2071,16638,1244.3186226851851,MERGED,10,38,1,0,2,105,True,0,0,0,2365,48,22.943055555555556,Bug
PHP,1334,2960,4209.083240740741,MERGED,1,1,1,2,4,77,False,1,1,1,4428,2,2.9191666666666665,Document
PHP,0,0,108.2259837962963,MERGED,230,322,14,0,3,38,False,0,0,0,902,552,0.035277777777777776,Document
JavaScript,9664,43889,3659.431087962963,MERGED,875,875,2,3,3,1,False,1,2,1,882,1750,129.35916666666665,Document
Rust,264,5382,404.9998148148148,MERGED,11,147,9,1,2,233,True,1,0,0,3069,158,19.495833333333334,Feature
PHP,0,0,108.1552662037037,MERGED,22,251,9,0,7,53,True,0,0,0,823,273,0.03611111111111111,Document
TypeScript,41369,87411,2935.7426736111115,MERGED,29,26,1,3,4,407,True,2,1,1,2094,55,2.359166666666667,Document
PHP,1334,2960,4208.09556712963,MERGED,19,230,7,1,31,69,False,1,0,0,4339,249,50.9175,Document
C#,80,125,818.6616203703703,MERGED,1,2,1,0,1,180,False,0,0,0,642,3,0.84,Document
C#,80,125,823.6172337962963,MERGED,7,4490,14,0,7,174,True,0,0,0,828,4497,70.60527777777777,Document
TypeScript,69,2214,313.6217939814815,MERGED,3,28,4,2,4,67,False,0,2,1,758,31,1.6208333333333333,Document
TypeScript,2071,16638,1242.9793518518518,MERGED,1,1,1,0,1,5,False,0,0,0,2291,2,54.83444444444444,Bug
TypeScript,41369,87411,2935.4352199074074,MERGED,3,0,1,0,1,1892,True,0,0,0,2100,3,0.4897222222222222,Document
Rust,264,5382,404.76940972222224,MERGED,217,141,13,0,1,86,True,0,0,0,2957,358,0.6355555555555555,Feature
Go,395,660,1264.0681597222222,MERGED,252,317,11,0,13,81,False,0,0,0,526,569,45.22472222222222,Feature
Go,421,1654,1510.0651157407408,MERGED,45,48,16,0,1,429,True,0,0,0,4911,93,20.671666666666667,Document
TypeScript,4,33,760.1547916666667,MERGED,1,1,1,0,3,56,False,0,0,0,723,2,0.5594444444444444,Feature
Go,421,1654,1509.4878124999998,MERGED,120,209,9,2,8,58,False,1,1,1,4524,329,39.84861111111111,Bug
C#,80,125,820.651875,MERGED,67,88,34,0,12,76,False,0,0,0,762,155,166.2061111111111,Document
Rust,264,5382,404.1824652777778,MERGED,508,545,5,0,1,232,True,0,0,0,3296,1053,14.05888888888889,Feature
TypeScript,495,2659,1906.9478240740739,MERGED,0,12,1,0,2,241,False,0,0,0,808,12,49.047777777777775,Document
Go,421,1654,1509.1823032407408,CLOSED,130,9,5,0,1,425,True,0,0,0,3376,139,42.61222222222222,Document
Rust,264,5382,403.64351851851853,MERGED,1,200,13,6,5,0,False,3,3,2,2802,201,27.5225,Bug
TypeScript,3392,2334,971.4463194444444,MERGED,2,2,2,2,1,451,False,0,2,1,1071,4,8.24388888888889,Feature
C#,80,125,822.5705671296296,MERGED,274,29,20,0,1,158,True,0,0,0,929,303,73.61194444444445,Document
Rust,591,3260,548.1232291666666,MERGED,1,18,1,1,1,75,False,1,0,0,1153,19,22.451666666666668,Document
PHP,1093,3326,2854.234849537037,MERGED,5,292,14,0,32,399,False,0,0,0,1058,297,186.4586111111111,Bug
TypeScript,15,34,488.7452430555556,MERGED,21,62,2,0,2,159,False,0,0,0,644,83,1.7075,Feature
Vue,293,495,832.2358796296297,CLOSED,477,376,34,9,51,297,True,4,5,4,2568,853,14.125555555555556,Bug
TypeScript,41369,87411,2941.9020486111112,MERGED,5,8,1,1,1,0,False,0,1,1,2452,13,2.7669444444444444,Document
PHP,0,0,106.20127314814816,MERGED,1,201,6,0,1,36,False,0,0,0,799,202,0.04833333333333333,Document
JavaScript,5139,7049,1205.7032523148148,MERGED,20,18,14,4,5,92,False,2,2,2,3786,38,18.261111111111113,Bug
PHP,0,0,106.13766203703705,MERGED,48,332,9,0,5,35,False,0,0,0,916,380,0.02388888888888889,Document
Vue,293,495,831.8738888888888,MERGED,661,27,37,2,35,292,True,0,2,2,3348,688,3.4691666666666667,Bug
C#,80,125,821.5846064814815,MERGED,26,1908,44,0,29,213,False,0,0,0,1469,1934,528.7291666666666,Document
Rust,264,5382,402.9654976851852,MERGED,2,24,11,2,2,20,True,1,1,1,3053,26,1.7994444444444444,Document
C++,2234,23694,2356.9471296296297,MERGED,5,47,6,1,4,530,False,0,1,1,2848,52,20.295277777777777,Feature
Java,547,304,230.07655092592594,MERGED,0,3,1,0,21,556,False,0,0,0,1619,3,0.455,Document
Java,547,304,230.0523726851852,MERGED,0,13,1,0,1,12,False,0,0,0,1519,13,3.106388888888889,Document
TypeScript,2071,16638,1241.357037037037,MERGED,1,5,1,0,1,74,True,0,0,0,2656,6,18.548333333333332,Bug
JavaScript,5139,7049,1203.4073726851852,MERGED,8,84,6,12,18,1,False,6,6,3,3076,92,76.82666666666667,Document
JavaScript,5139,7049,1204.6183101851852,MERGED,12,77,11,3,14,91,False,1,2,2,3910,89,22.99361111111111,Bug
Java,547,304,230.05729166666666,MERGED,0,13,1,0,1,13,False,0,0,0,1549,13,2.9963888888888888,Document
V,2097,34361,1553.3605902777779,MERGED,0,33,3,0,3,213,True,0,0,0,2595,33,18.33361111111111,Document
Java,547,304,228.39898148148146,MERGED,0,6,1,0,3,368,False,0,0,0,1448,6,444.5761111111111,Document
JavaScript,5139,7049,1204.0558333333333,MERGED,12,165,15,4,2,78,False,2,2,2,3934,177,37.63583333333333,Bug
Rust,264,5382,401.9017592592593,MERGED,57,51,6,2,6,323,False,1,1,1,2684,108,8.123333333333333,Feature
JavaScript,5139,7049,1204.5138657407408,MERGED,15,21,14,3,3,181,False,1,2,2,3680,36,3.378888888888889,Bug
TypeScript,2071,16638,1243.3675694444444,CLOSED,5,32,3,4,2,1,False,3,1,1,4008,37,255.89833333333334,Document
Go,1835,11245,1732.8740625,MERGED,0,1,1,0,1,90,False,0,0,0,868,1,0.1075,Bug
Erlang,2054,12122,3794.9856597222224,MERGED,11,11,1,0,1,38,False,0,0,0,896,22,0.6322222222222222,Document
TypeScript,7,6,646.0429050925926,MERGED,22,1654,37,2,65,262,False,1,1,1,3988,1676,338.2583333333333,Feature
TypeScript,41369,87411,2939.6953240740745,MERGED,2,2,1,6,2,413,True,3,3,3,2149,4,6.495,Document
TypeScript,1297,21107,416.08653935185185,MERGED,5758,17,12,1,2,929,True,0,1,1,2626,5775,0.1922222222222222,Document
TypeScript,41369,87411,2939.7262731481483,MERGED,2,2,2,0,1,6,True,0,0,0,2866,4,0.2136111111111111,Document
TypeScript,41369,87411,2939.6733680555553,MERGED,2,46,3,2,2,1583,True,0,2,2,2454,48,1.5769444444444445,Document
TypeScript,41369,87411,2939.500046296296,MERGED,4,4,2,4,3,2,False,1,3,3,2370,8,5.479722222222223,Document
TypeScript,3392,2334,967.9730671296296,MERGED,4,4,1,1,1,691,False,0,1,1,1217,8,0.9727777777777777,Bug
V,2097,34361,1551.5924768518519,MERGED,3,28,6,0,5,212,True,0,0,0,2108,31,39.30916666666667,Document
TypeScript,41369,87411,2939.4995833333337,CLOSED,3,3,1,0,1,0,False,0,0,0,2533,6,0.14166666666666666,Document
TypeScript,41369,87411,2939.2503125000003,MERGED,7,7,3,0,2,2,False,0,0,0,2679,14,6.013055555555556,Document
Java,547,304,225.24005787037038,MERGED,0,11,1,0,7,2,False,0,0,0,1397,11,30.61888888888889,Feature
Java,547,304,225.22877314814812,MERGED,0,18,1,0,4,1,False,0,0,0,1189,18,30.88111111111111,Feature
TypeScript,41369,87411,2938.1304976851848,MERGED,0,2,2,2,2,0,False,2,0,0,2335,2,39.015,Document
C#,80,125,819.6922453703704,MERGED,79,106,245,0,11,75,False,0,0,0,896,185,44.955,Document
TypeScript,41369,87411,2938.8796759259258,CLOSED,1,1,1,2,1,1,False,1,1,1,2645,2,8.813888888888888,Document
TypeScript,15,34,491.4195949074074,MERGED,38,65,5,0,4,162,False,0,0,0,731,103,17.198611111111113,Bug
Go,1835,11245,1730.9037037037035,MERGED,1,1,1,0,6,88,False,0,0,0,1001,2,0.3169444444444444,Bug
TypeScript,41369,87411,2938.6970138888887,MERGED,4,17,3,0,2,1,False,0,0,0,2898,21,3.0830555555555557,Document
TypeScript,41369,87411,2938.752951388889,MERGED,0,214,2,0,5,1581,True,0,0,0,2439,214,1.0930555555555554,Document
V,2097,34361,1551.6249537037038,MERGED,8,18,2,0,4,33,True,0,0,0,2180,26,4.158055555555555,Document
Java,547,304,225.11028935185186,MERGED,0,12,1,0,1,0,False,0,0,0,1102,12,1.8955555555555557,Feature
TypeScript,41369,87411,2941.9354166666667,CLOSED,3,131,9,4,2,112,False,1,3,2,3980,134,372.3675,Document
TypeScript,261,3765,675.5106944444444,CLOSED,220,556,15,0,4,91,True,0,0,0,7136,776,484.95444444444445,Document
TypeScript,15,34,490.64868055555553,MERGED,21,33,12,0,7,912,False,0,0,0,922,54,22.89361111111111,Document
Rust,3808,5430,441.9636689814815,MERGED,66,89,3,6,4,32,False,2,4,2,969,155,131.2786111111111,Bug
TypeScript,41369,87411,2937.6368171296294,MERGED,5,19,2,0,2,409,True,0,0,0,2735,24,24.500555555555554,Document
C#,80,125,819.5888310185186,CLOSED,7,7,1,0,1,172,True,0,0,0,831,14,0.042222222222222223,Document
C#,80,125,818.9740972222222,MERGED,57,333,379,0,7,74,False,0,0,0,890,390,15.379722222222222,Document
TypeScript,41369,87411,2937.766203703704,MERGED,6,28,2,0,1,1577,True,0,0,0,3064,34,0.8977777777777778,Document
TypeScript,41369,87411,2937.640601851852,MERGED,4,4,3,1,2,410,True,1,0,0,2595,8,2.7041666666666666,Document
TypeScript,4,33,761.5662962962964,MERGED,2,4,1,0,1,168,False,0,0,0,905,6,0.04861111111111111,Bug
Go,1835,11245,1730.6572222222221,MERGED,2,1,1,0,1,136,False,0,0,0,1038,3,0.0525,Bug
TypeScript,41369,87411,2937.6179050925925,MERGED,2,10,1,0,1,1897,True,0,0,0,2499,12,0.7930555555555555,Document
TypeScript,41369,87411,2937.611400462963,MERGED,2,10,1,0,1,408,True,0,0,0,3051,12,0.6527777777777778,Document
C#,80,125,818.6078240740741,MERGED,5488,2322,14,0,9,174,False,0,0,0,772,7810,23.503611111111113,Document
TypeScript,41369,87411,2937.484293981481,MERGED,2,18,2,0,1,0,False,0,0,0,3124,20,2.910833333333333,Document
C#,80,125,818.3794791666666,MERGED,13,210,10,0,3,169,True,0,0,0,680,223,27.52722222222222,Document
TypeScript,3392,2334,965.8912847222223,MERGED,1,1,1,1,1,93,False,0,1,1,1156,2,0.07444444444444444,Bug
TypeScript,7,6,648.1051967592592,CLOSED,1,99,3,0,6,209,False,0,0,0,5039,100,141.76,Feature
TypeScript,41369,87411,2936.803101851852,MERGED,2,2,2,1,1,1895,True,1,0,0,2685,4,2.837222222222222,Document
TypeScript,41369,87411,2936.6672453703704,MERGED,1,1,1,0,1,0,False,0,0,0,2171,2,0.3844444444444444,Document
TypeScript,41369,87411,2936.448634259259,MERGED,7,42,5,0,3,1894,True,0,0,0,2500,49,6.313611111111111,Document
Erlang,2054,12122,3798.082615740741,CLOSED,104,506,18,0,3,52,False,0,0,0,1185,610,171.50916666666666,Document
TypeScript,41369,87411,2935.704074074074,MERGED,19,16,2,6,4,0,False,3,3,3,2420,35,3.0383333333333336,Document
TypeScript,41369,87411,2941.493715277778,MERGED,10,228,9,3,11,111,False,0,3,1,3897,238,272.6911111111111,Document
TypeScript,41369,87411,2935.716134259259,MERGED,9,10,3,0,2,1573,True,0,0,0,2449,19,0.8075,Document
TypeScript,41369,87411,2935.4564814814817,MERGED,15751,22081,3,0,2,1572,True,0,0,0,2476,37832,0.7766666666666666,Document
TypeScript,41369,87411,2935.3480092592595,MERGED,0,52,1,0,1,0,False,0,0,0,2894,52,2.395,Document
TypeScript,178,1359,322.51474537037035,MERGED,30,71,5,4,4,0,False,2,2,2,5725,101,126.61638888888889,Feature
TypeScript,41369,87411,2934.8198495370366,MERGED,1,1,1,0,1,406,True,0,0,0,2184,2,14.612777777777778,Document
TypeScript,7,6,646.2208449074075,MERGED,13,142,8,0,22,10,True,0,0,0,4608,155,113.74444444444444,Feature
Erlang,2054,12122,3796.8515625,MERGED,2,372,8,0,6,137,False,0,0,0,1190,374,146.4272222222222,Document
Go,2083,11769,1516.9797685185185,MERGED,0,28,1,0,1,893,True,0,0,0,3196,28,0.009444444444444445,Document
Erlang,2054,12122,3795.893541666667,MERGED,2,11,1,0,1,233,True,0,0,0,1108,13,0.7288888888888889,Document
Erlang,2054,12122,3795.2128125,MERGED,29,45,20,0,1,39,False,0,0,0,1003,74,186.08944444444444,Document
Starlark,440,286,492.57549768518516,MERGED,9,19,1,3,6,4,False,1,2,1,1235,28,31.829166666666666,Feature
TypeScript,85,722,317.4225578703704,MERGED,723,3489,64,0,5,79,False,0,0,0,6733,4212,19.022222222222222,Document
TypeScript,2147,14722,1474.834224537037,MERGED,38,81,12,0,1,682,False,0,0,0,6291,119,1.5552777777777778,Feature
Erlang,2054,12122,3796.878275462963,CLOSED,0,2301,7,0,2,483,True,0,0,0,1271,2301,90.19638888888889,Document
Java,547,304,232.0282523148148,MERGED,0,13,1,0,1,15,False,0,0,0,1818,13,20.81277777777778,Document
Python,2407,12180,243.1773263888889,MERGED,4,60,3,2,3,130,True,0,2,1,1630,64,20.495277777777776,Document
Java,547,304,230.03590277777778,MERGED,0,12,1,0,2,11,False,0,0,0,1830,12,3.4947222222222223,Document
Starlark,440,286,493.0090046296296,MERGED,15,7,1,0,1,18,False,0,0,0,1400,22,3.9469444444444446,Bug
Starlark,440,286,492.9887615740741,MERGED,3,9,1,0,2,1,False,0,0,0,1242,12,0.09444444444444444,Bug
Starlark,440,286,492.9111574074074,MERGED,1,1,1,2,3,3,False,2,0,0,1522,2,4.552777777777778,Feature
Java,547,304,229.17096064814814,MERGED,0,14,1,0,8,555,False,0,0,0,2000,14,425.96944444444443,Document
Java,547,304,229.10790509259257,MERGED,0,15,1,0,2,8,False,0,0,0,1750,15,1.0669444444444445,Document
TypeScript,58,78,820.7074421296296,MERGED,119,759,14,2,7,117,False,1,1,1,5987,878,15.126666666666667,Feature
Starlark,440,286,492.29321759259255,MERGED,24,14,1,0,1,17,False,0,0,0,1530,38,13.840555555555556,Bug
Java,547,304,229.1135185185185,MERGED,0,9,1,0,2,9,False,0,0,0,1576,9,1.4419444444444445,Document
Java,547,304,230.09184027777778,MERGED,0,27,1,0,3,11,False,0,0,0,1933,27,19.142777777777777,Document
PHP,883,2338,1831.0180208333334,CLOSED,17,321,6,5,1,9,False,1,4,3,5824,338,907.9541666666667,Document
Java,547,304,228.4011689814815,MERGED,0,8,1,0,3,369,False,0,0,0,1536,8,444.4902777777778,Document
JavaScript,34,25,197.73094907407406,MERGED,12,45,9,4,3,6,False,3,1,1,1655,57,197.16305555555556,Feature
C#,80,125,822.6751041666666,MERGED,10373,49039,931,0,56,35,False,0,0,0,1017,59412,95.30361111111111,Document
Java,547,304,228.6317013888889,MERGED,0,13,1,0,2,5,False,0,0,0,1958,13,1.8280555555555555,Document
Erlang,2054,12122,3798.097465277778,MERGED,1,1,1,0,1,364,True,0,0,0,1046,2,0.24416666666666667,Document
Java,547,304,228.63986111111112,MERGED,0,8,1,0,1,6,False,0,0,0,1666,8,12.796388888888888,Document
Java,547,304,229.8047337962963,MERGED,0,5,1,0,1,5,False,0,0,0,1801,5,0.5472222222222223,Document
Erlang,2054,12122,3797.9741319444443,MERGED,8,24,2,2,1,360,True,1,1,1,1170,32,0.4161111111111111,Document
Java,547,304,228.1080902777778,MERGED,0,24,1,0,1,4,False,0,0,0,1668,24,11.812222222222223,Document
Erlang,2054,12122,3797.8510995370366,MERGED,320,9388,186,0,74,362,True,0,0,0,1318,9708,5.8805555555555555,Document
Java,547,304,228.09502314814813,MERGED,0,8,1,0,1,3,False,0,0,0,1734,8,12.099166666666667,Document
Starlark,440,286,491.2128587962963,MERGED,2,2,1,0,1,80,False,0,0,0,1537,4,19.357222222222223,Document
C#,80,125,821.9546643518519,CLOSED,0,23,1,0,1,169,False,0,0,0,1005,23,113.14416666666666,Document
Erlang,2054,12122,3797.6951157407407,MERGED,47,64,19,0,2,358,True,0,0,0,1263,111,3.7130555555555556,Document
Python,2407,12180,241.9874074074074,MERGED,0,5,1,0,8,129,True,0,0,0,1371,5,21.217222222222222,Feature
TypeScript,3392,2334,968.0521875,MERGED,276,2691,7,3,9,450,False,0,3,2,1536,2967,139.38611111111112,Bug
TypeScript,85,722,314.0794907407407,MERGED,247,1062,49,0,14,150,False,0,0,0,6447,1309,97.68027777777777,Document
TypeScript,4,33,766.1478935185186,MERGED,53,282,11,1,8,364,False,0,1,1,1065,335,25.75638888888889,Feature
TypeScript,178,1359,320.42158564814815,MERGED,83,67,8,1,2,34,True,0,1,1,5229,150,5.008611111111111,Feature
Starlark,440,286,492.0300115740741,MERGED,1,1,1,0,1,122,True,0,0,0,1158,2,0.01611111111111111,Bug
C++,363,552,539.2013657407407,MERGED,23,36,5,1,1,95,False,0,1,1,1596,59,72.99527777777777,Document
Java,547,304,228.3956712962963,MERGED,0,6,1,1,3,367,False,0,1,1,1651,6,81.8975,Document
Java,547,304,226.84868055555555,MERGED,0,9,1,0,2,2,False,0,0,0,1715,9,0.2886111111111111,Document
TypeScript,4,33,766.535,MERGED,16,12,1,1,1,178,False,0,1,1,1065,28,0.04583333333333333,Document
Erlang,2054,12122,3796.9296296296293,MERGED,25,99,4,0,4,361,True,0,0,0,1224,124,22.033333333333335,Document
TypeScript,15,34,490.52149305555554,MERGED,74,1417,31,0,57,473,True,0,0,0,1272,1491,209.67027777777778,Feature
Rust,264,5382,404.9005671296297,MERGED,74,26,6,0,1,87,True,0,0,0,3711,100,2.140833333333333,Document
TypeScript,4,33,761.3574768518519,MERGED,293,3439,54,2,89,71,False,0,2,2,1809,3732,561.0211111111112,Document
Java,547,304,228.40392361111114,MERGED,0,6,1,0,2,371,False,0,0,0,1581,6,13.740833333333333,Document
Java,547,304,228.40299768518517,MERGED,0,14,1,0,1,370,False,0,0,0,1732,14,5.4061111111111115,Document
TypeScript,261,3765,678.5146064814815,MERGED,39,193,20,0,1,865,True,0,0,0,4999,232,0.1025,Document
TypeScript,85,722,315.26935185185187,MERGED,60,75,33,0,2,151,False,0,0,0,7130,135,17.6025,Document
Rust,264,5382,404.0211574074074,CLOSED,64,39,4,1,2,84,True,1,0,0,4398,103,21.191666666666666,Document
Java,547,304,224.89842592592592,MERGED,0,9,1,0,18,551,False,0,0,0,1996,9,528.4594444444444,Document
Java,547,304,224.8772337962963,MERGED,0,6,1,0,10,548,False,0,0,0,1718,6,529.1472222222222,Document
Java,547,304,224.88916666666668,MERGED,0,4,1,0,13,549,False,0,0,0,2163,4,528.6511111111112,Document
Java,547,304,224.90836805555557,MERGED,0,19,1,0,3,0,False,0,0,0,2006,19,25.735,Document
Erlang,2054,12122,3796.0255555555555,MERGED,14,28,6,0,2,360,True,0,0,0,1159,42,38.242222222222225,Document
Erlang,2054,12122,3796.836261574074,MERGED,22,30,2,0,1,357,True,0,0,0,1511,52,1.6297222222222223,Document
Starlark,440,286,488.2170601851852,MERGED,0,178,2,1,1,0,False,1,0,0,1515,178,111.49472222222222,Feature
C++,363,552,539.2818287037037,MERGED,177,503,7,0,1,222,False,0,0,0,1695,680,4.675833333333333,Document
Go,30,295,347.0127546296296,MERGED,125,122,77,3,1,98,True,1,2,1,5021,247,0.23222222222222222,Feature
Rust,264,5382,404.04041666666666,MERGED,190,40,24,0,1,85,True,0,0,0,5104,230,1.3830555555555555,Feature
Go,30,295,346.92899305555557,MERGED,0,77,2,2,1,91,True,0,2,1,4906,77,0.105,Document
TypeScript,7,6,643.966400462963,MERGED,24,132,2,0,4,221,False,0,0,0,3612,156,25.034166666666668,Feature
Erlang,2054,12122,3795.1159606481483,MERGED,1,1,1,0,1,323,False,0,0,0,1145,2,55.01555555555556,Document
Starlark,440,286,490.0481712962963,MERGED,1,1,1,0,1,2,False,0,0,0,1141,2,21.585833333333333,Feature
Erlang,2054,12122,3795.916539351852,MERGED,24,47,16,0,2,356,True,0,0,0,1504,71,17.971944444444443,Document
Java,547,304,224.82871527777777,MERGED,0,7,1,0,7,540,False,0,0,0,1967,7,8.62111111111111,Document
Java,547,304,224.8440277777778,MERGED,0,7,1,0,6,542,False,0,0,0,1660,7,217.77388888888888,Document
TypeScript,3392,2334,970.0855439814815,MERGED,0,7,1,1,1,315,False,0,1,1,1201,7,0.08388888888888889,Feature
TypeScript,85,722,315.14091435185185,MERGED,120,382,9,0,2,92,False,0,0,0,5205,502,0.43222222222222223,Document
Rust,264,5382,403.75708333333336,MERGED,96,156,12,0,1,137,False,0,0,0,3364,252,1.7144444444444444,Bug
Rust,264,5382,403.75289351851853,MERGED,18,111,11,0,2,390,False,0,0,0,4458,129,0.5147222222222222,Document
TypeScript,3392,2334,969.9275694444444,MERGED,2,2,1,1,1,692,False,0,1,1,1558,4,0.4111111111111111,Feature
C++,2234,23694,2357.8742361111113,MERGED,93,2,11,1,1,312,False,0,1,1,4515,95,0.8752777777777778,Feature
Erlang,2054,12122,3795.956793981481,MERGED,17,3,3,0,2,40,False,0,0,0,1013,20,3.713888888888889,Document
Java,547,304,224.84988425925926,MERGED,0,7,1,0,11,545,False,0,0,0,1648,7,161.17277777777778,Document
Erlang,2054,12122,3795.9510185185186,MERGED,4,4,2,0,1,136,False,0,0,0,1200,8,2.276666666666667,Document
Rust,264,5382,403.06383101851856,MERGED,24,93,10,0,2,230,True,0,0,0,3410,117,17.405277777777776,Feature
Erlang,2054,12122,3795.8650578703705,MERGED,27,30,3,0,2,359,True,0,0,0,1408,57,1.053611111111111,Document
Rust,413,5117,466.7583912037037,MERGED,75,121,8,3,9,66,False,1,2,2,2251,196,55.16027777777778,Document
TypeScript,4,33,764.4198032407407,MERGED,9,11,1,0,1,176,False,0,0,0,1378,20,0.08194444444444444,Feature
TypeScript,3392,2334,969.2602083333333,MERGED,9,45,1,2,1,265,False,0,2,1,1736,54,15.286111111111111,Feature
Erlang,2054,12122,3795.6567361111115,MERGED,1,14,3,0,1,358,True,0,0,0,1295,15,5.706388888888889,Document
Starlark,440,286,490.02355324074074,MERGED,2,2,1,0,1,69,False,0,0,0,1192,4,0.03222222222222222,Bug
Python,14532,41181,1088.539826388889,MERGED,1,1,1,0,1,1414,True,0,0,0,1600,2,0.12611111111111112,Document
TypeScript,4,33,764.2169560185185,MERGED,14,32,5,2,1,201,True,1,1,1,1043,46,0.04111111111111111,Bug
Starlark,440,286,488.30090277777776,MERGED,1,2,1,0,2,1,False,0,0,0,1219,3,63.455555555555556,Feature
V,2097,34361,1553.7661921296296,MERGED,4,83,9,0,4,184,True,0,0,0,3501,87,25.801666666666666,Bug
Erlang,2054,12122,3794.9937847222222,MERGED,18,28,16,0,2,355,True,0,0,0,1283,46,22.73027777777778,Document
TypeScript,4,33,764.1122453703703,MERGED,281,337,13,3,16,198,True,2,1,1,1576,618,0.2941666666666667,Document
TypeScript,3392,2334,969.1431712962963,MERGED,13,23,2,1,1,102,False,0,1,1,1222,36,0.6319444444444444,Bug
TypeScript,3392,2334,969.0758680555556,MERGED,1,1,1,1,1,314,False,0,1,1,1113,2,0.10611111111111111,Feature
Erlang,2054,12122,3794.1348842592593,MERGED,3,3,3,0,1,320,False,0,0,0,1259,6,42.90777777777778,Document
TypeScript,3392,2334,968.5539467592592,MERGED,5,5,1,2,1,0,False,0,2,1,1201,10,7.371944444444445,Bug
Python,2407,12180,239.39416666666668,MERGED,1,1,1,2,2,16,False,1,1,1,1544,2,16.00888888888889,Document
PHP,0,0,104.28243055555555,MERGED,280,298,14,0,3,33,False,0,0,0,1176,578,0.020833333333333332,Document
TypeScript,4,33,763.5857754629629,MERGED,181,163,5,1,3,174,False,0,1,1,1486,344,0.9458333333333333,Feature
Go,1835,11245,1732.6145717592592,MERGED,1,0,1,0,1,518,False,0,0,0,1433,1,21.328055555555554,Document
Erlang,2054,12122,3794.8684027777776,MERGED,23,32,17,0,2,354,True,0,0,0,1329,55,2.9491666666666667,Document
TypeScript,3392,2334,968.4917013888889,MERGED,0,30,2,1,2,313,False,0,1,1,1433,30,10.789444444444445,Feature
TypeScript,41369,87411,2940.7267824074074,MERGED,10,9,7,1,4,0,False,0,1,1,3844,19,0.5030555555555556,Document
Go,421,1654,1511.1156365740742,MERGED,20,49,2,0,2,83,False,0,0,0,4702,69,2.8802777777777777,Document
Rust,264,5382,402.10620370370367,MERGED,15,121,10,0,2,152,False,0,0,0,4076,136,1.1866666666666668,Document
Erlang,2054,12122,3794.2684375000003,MERGED,2,1,1,0,1,321,False,0,0,0,988,3,2.0527777777777776,Document
TypeScript,3989,23861,2827.23724537037,MERGED,1,4,1,1,1,174,False,0,1,1,1597,5,0.15805555555555556,Document
Erlang,2054,12122,3794.024814814815,MERGED,1,2,2,0,2,37,False,0,0,0,1043,3,2.0413888888888887,Document
TypeScript,3392,2334,967.9145833333333,MERGED,1,1,1,1,1,99,False,0,1,1,1179,2,0.01888888888888889,Feature
JavaScript,34,25,198.44041666666666,MERGED,3,3,1,0,1,73,False,0,0,0,1547,6,0.9138888888888889,Feature
Go,421,1654,1509.9294675925928,MERGED,12,85,8,0,1,428,True,0,0,0,7048,97,24.04361111111111,Bug
TypeScript,41369,87411,2939.6614583333335,MERGED,4,13,5,4,4,576,True,0,4,4,3454,17,2.395277777777778,Document
Java,450,746,4073.0619097222225,MERGED,2,1,1,1,1,32,False,0,1,1,1269,3,0.2633333333333333,Bug
Go,1835,11245,1730.9219560185186,MERGED,52,327,35,0,5,89,False,0,0,0,1531,379,45.19,Document
TypeScript,4,33,761.6620254629629,MERGED,147,157,1,1,1,170,False,0,1,1,1360,304,0.05638888888888889,Document
TypeScript,4,33,761.6316550925926,MERGED,11,142,6,1,1,169,False,0,1,1,1636,153,0.08,Feature
Python,2407,12180,244.04660879629628,CLOSED,0,153,1,6,2,0,False,3,3,2,2052,153,591.9836111111111,Feature
Rust,3808,5430,438.5366550925926,MERGED,507,413,32,5,12,30,False,3,2,2,1824,920,77.0963888888889,Feature
C++,363,552,535.2230671296296,MERGED,1,6,1,0,1,219,False,0,0,0,1796,7,1.4094444444444445,Document
TypeScript,4,33,761.4169097222222,MERGED,110,149,8,2,1,197,True,1,1,1,1519,259,0.18694444444444444,Bug
TypeScript,3392,2334,966.0675462962963,MERGED,8,29,3,1,3,308,False,0,1,1,1564,37,24.170277777777777,Feature
TypeScript,41369,87411,2938.6411111111115,MERGED,3,332,7,0,2,1579,True,0,0,0,3381,335,0.7069444444444445,Document
TypeScript,41369,87411,2938.6292592592595,MERGED,9,29,6,0,2,1,False,0,0,0,4114,38,1.0230555555555556,Document
Go,1835,11245,1730.8028356481482,MERGED,3,47,6,0,1,86,False,0,0,0,1956,50,0.5244444444444445,Feature
TypeScript,41369,87411,2938.4842361111114,MERGED,4,19,2,0,1,5,True,0,0,0,3306,23,0.7555555555555555,Document
TypeScript,4,33,767.2853472222222,MERGED,186,1110,12,1,12,365,False,0,1,1,1909,1296,93.07527777777777,Feature
TypeScript,3392,2334,966.2852546296295,MERGED,11,11,1,1,1,96,False,0,1,1,1377,22,0.20222222222222222,Bug
C#,80,125,818.7583912037038,CLOSED,16632,4321,1320,0,27,73,False,0,0,0,1250,20953,17.930555555555557,Document
Python,137,75,684.1109606481482,MERGED,0,804,8,0,12,3,False,0,0,0,2407,804,235.4463888888889,Feature
TypeScript,41369,87411,2936.8084259259263,MERGED,6,28,2,0,2,30,False,0,0,0,3222,34,62.85777777777778,Document
TypeScript,3392,2334,966.0329745370371,MERGED,1,1,1,1,1,687,False,0,1,1,1305,2,0.47888888888888886,Bug
Starlark,440,286,493.7485300925926,MERGED,9,12,1,0,2,44,False,0,0,0,2200,21,3.6641666666666666,Document
Starlark,440,286,494.769837962963,MERGED,2,4,1,0,1,45,False,0,0,0,1817,6,3.011388888888889,Document
Starlark,440,286,492.13383101851855,MERGED,0,10,1,3,3,0,False,2,1,1,1651,10,110.87805555555556,Feature
Starlark,440,286,493.99751157407405,MERGED,4,4,1,0,1,1,False,0,0,0,1719,8,21.52166666666667,Document
JavaScript,34,25,196.18287037037035,CLOSED,1,8,1,0,2,72,False,0,0,0,1542,9,0.13722222222222222,Feature
Python,2407,12180,242.00312499999998,CLOSED,2,2,1,1,1,246,True,1,0,0,1810,4,127.74972222222222,Document
TypeScript,41369,87411,2937.614270833333,MERGED,2,31,2,0,2,2,False,0,0,0,2867,33,0.5805555555555556,Document
Go,421,1654,1507.9548842592592,MERGED,144,153,4,0,1,421,True,0,0,0,5583,297,2.5327777777777776,Bug
Python,2407,12180,244.46437500000002,MERGED,2,2,1,1,2,0,False,1,0,0,2035,4,14.012222222222222,Document
Python,2407,12180,238.39371527777777,MERGED,45,114,12,9,2,0,False,4,5,2,5244,159,230.37777777777777,Document
Go,1835,11245,1729.889490740741,MERGED,0,6,2,0,1,96,False,0,0,0,1912,6,0.9480555555555555,Document
TypeScript,41369,87411,2937.062106481482,MERGED,5,24,2,0,2,8,False,0,0,0,3639,29,12.589444444444444,Document
Python,2407,12180,241.6108912037037,MERGED,2,57,4,2,7,128,True,0,2,2,2158,59,30.39666666666667,Document
TypeScript,41369,87411,2936.8234722222223,MERGED,13,120,6,2,5,0,False,1,1,1,3618,133,14.951666666666666,Document
TypeScript,41369,87411,2936.412592592593,MERGED,33,34,3,3,6,1,False,1,2,2,3786,67,25.55388888888889,Document
Starlark,440,286,493.25570601851854,MERGED,14,23,1,0,2,51,False,0,0,0,2338,37,15.496944444444445,Document
Go,789,5551,1042.1274074074074,MERGED,0,38,2,1,1,1,False,0,1,1,2110,38,20.262777777777778,Document
TypeScript,1297,21107,420.6645486111111,MERGED,2,2,1,1,1,40,False,0,1,1,1875,4,7.732777777777778,Document
TypeScript,7,6,647.1759490740741,MERGED,10,527,18,2,67,263,False,2,0,0,4782,537,311.19083333333333,Feature
TypeScript,41369,87411,2935.8921412037034,CLOSED,3,64,3,3,2,29,False,0,3,2,3756,67,20.58888888888889,Document
Python,2407,12180,241.89939814814815,MERGED,0,12,1,6,4,17,False,3,3,1,2089,12,23.509722222222223,Document
TypeScript,41369,87411,2935.6586111111114,MERGED,35,35,9,11,7,0,False,3,8,3,4008,70,25.978055555555557,Document
TypeScript,41369,87411,2935.9346412037034,MERGED,1883,1854,61,0,2,1574,True,0,0,0,3780,3737,1.4155555555555555,Document
Python,14532,41181,1090.8493055555557,CLOSED,0,1,1,6,1,0,False,3,3,1,1842,1,0.41888888888888887,Document
TypeScript,41369,87411,2935.6421180555553,MERGED,41,53,3,4,1,574,True,1,3,2,3747,94,0.3958333333333333,Document
Python,2407,12180,242.86474537037034,MERGED,4,9,1,0,2,247,True,0,0,0,1815,13,0.16777777777777778,Document
Erlang,2054,12122,3798.024537037037,MERGED,1,1,1,0,1,361,True,0,0,0,1579,2,1.2544444444444445,Document
Python,14532,41181,1090.7397916666666,MERGED,6,2,1,0,1,1415,True,0,0,0,2275,8,3.0830555555555557,Document
C++,363,552,539.2577546296296,MERGED,33,76,2,0,12,179,False,0,0,0,2012,109,64.77666666666667,Document
TypeScript,4,33,764.3923263888888,MERGED,190,584,10,1,10,57,False,0,1,1,1700,774,90.97472222222223,Document
Erlang,2054,12122,3797.860219907407,MERGED,29,32,5,0,3,363,True,0,0,0,1551,61,0.24888888888888888,Document
Starlark,440,286,492.04100694444446,MERGED,13,4,1,0,1,123,True,0,0,0,1678,17,0.07777777777777778,Feature
Starlark,440,286,491.8690856481482,MERGED,3,4,2,0,2,16,False,0,0,0,1663,7,3.6025,Document
Starlark,440,286,487.90109953703706,MERGED,0,139,2,0,1,2,False,0,0,0,1768,139,119.05694444444444,Feature
Starlark,440,286,489.563900462963,MERGED,6,6,1,1,1,41,False,0,1,1,1872,12,33.093333333333334,Document
Erlang,2054,12122,3794.2879976851855,MERGED,0,22,1,0,1,322,False,0,0,0,1696,22,71.96527777777777,Document
Rust,3808,5430,439.11802083333333,MERGED,523,4812,19,1,17,11,False,1,0,0,2993,5335,1050.4372222222223,Feature
JavaScript,34,25,199.84752314814816,MERGED,21,4,10,1,2,75,False,1,0,0,1936,25,0.13166666666666665,Bug
Starlark,440,286,489.00078703703707,MERGED,4,8,1,0,1,8,False,0,0,0,1809,12,46.624722222222225,Bug
Starlark,440,286,488.9947916666667,MERGED,1,5,1,1,2,7,False,1,0,0,1737,6,46.778888888888886,Bug
Python,14532,41181,1088.5360416666667,MERGED,2,2,1,0,5,1413,True,0,0,0,1558,4,0.2336111111111111,Document
Java,547,304,231.15679398148146,MERGED,0,14,1,0,1,14,False,0,0,0,2341,14,13.715277777777779,Document
Java,547,304,229.1635648148148,MERGED,0,5,1,0,9,554,False,0,0,0,2230,5,426.1616666666667,Document
Java,547,304,229.12232638888887,MERGED,0,11,1,0,1,10,False,0,0,0,2169,11,1.238888888888889,Document
Python,2407,12180,239.1353703703704,MERGED,14,23,1,2,8,237,True,1,1,1,1896,37,1.2272222222222222,Document
Java,547,304,228.60859953703707,MERGED,0,10,1,0,6,553,False,0,0,0,2743,10,439.49361111111114,Document
Vue,293,495,830.9031134259259,MERGED,4262,2910,161,9,271,342,True,4,5,4,1558,7172,0.8586111111111111,Feature
Java,1,10,235.79983796296298,MERGED,690,470,21,0,14,24,True,0,0,0,8402,1160,0.6988888888888889,Document
Python,2407,12180,239.6704513888889,MERGED,7,1,1,2,6,0,False,1,1,1,2014,8,9.445277777777777,Document
Java,547,304,228.65730324074073,MERGED,0,14,1,0,1,7,False,0,0,0,2077,14,12.384444444444444,Document
Java,547,304,228.2511574074074,MERGED,0,12,1,0,1,0,False,0,0,0,2477,12,8.393611111111111,Document
Vue,0,1,247.29218749999998,MERGED,15,21,2,1,6,38,False,0,1,1,2013,36,20.696666666666665,Feature
Erlang,2054,12122,3794.7572453703706,MERGED,0,1,1,0,1,357,True,0,0,0,1888,1,5.565,Document
TypeScript,4,33,763.3000925925926,MERGED,0,31,3,1,3,362,False,0,1,1,1888,31,0.515,Bug
Go,1835,11245,1732.8481944444445,MERGED,18,20,6,0,1,519,False,0,0,0,2410,38,0.9622222222222222,Document
Go,1835,11245,1731.9923032407407,MERGED,2,12,1,0,1,517,False,0,0,0,1688,14,36.24888888888889,Document
TypeScript,4,33,762.5584722222221,MERGED,4,116,10,2,1,596,True,1,1,1,1843,120,14.1125,Feature
TypeScript,3392,2334,967.8810879629629,MERGED,10,21,1,1,4,690,False,0,1,1,2461,31,3.1886111111111113,Bug
Python,137,75,686.1388773148147,MERGED,2,66,5,0,4,20,False,0,0,0,2469,68,366.12888888888887,Bug
TypeScript,3392,2334,967.7528819444445,MERGED,43,1,4,2,1,346,False,0,2,1,2417,44,2.499722222222222,Feature
Erlang,2054,12122,3793.8542129629627,MERGED,30,329,14,0,23,356,True,0,0,0,1875,359,5.410833333333334,Document
TypeScript,7,6,643.2683680555556,MERGED,360,1319,29,1,50,261,False,1,0,0,6495,1679,375.7475,Feature
TypeScript,4,33,762.407662037037,MERGED,3,28,1,0,1,172,False,0,0,0,1833,31,0.021666666666666667,Bug
Java,450,746,4072.216076388889,MERGED,6,7,5,2,2,377,True,0,2,1,2173,13,18.666944444444443,Bug
Java,547,304,224.92995370370372,MERGED,0,13,1,0,4,1,False,0,0,0,2186,13,38.03138888888889,Document
Starlark,440,286,487.89519675925925,CLOSED,0,139,2,1,1,1,False,1,0,0,1838,139,0.05388888888888889,Document
Starlark,440,286,487.8880208333333,CLOSED,0,139,2,0,1,0,False,0,0,0,1765,139,0.15888888888888889,Feature
Python,2407,12180,238.11732638888887,MERGED,1,1,1,3,2,0,False,2,1,1,1911,2,0.6588888888888889,Document
Go,1835,11245,1731.6366666666665,MERGED,0,27,1,0,2,516,False,0,0,0,1710,27,1.3947222222222222,Document
Java,547,304,224.82446759259258,MERGED,0,28,1,0,5,538,False,0,0,0,2019,28,78.06333333333333,Document
Java,547,304,224.82697916666666,MERGED,0,7,1,0,8,539,False,0,0,0,2675,7,78.01416666666667,Document
Java,547,304,224.8315162037037,MERGED,0,11,1,0,7,541,False,0,0,0,2251,11,102.77111111111111,Document
Java,547,304,224.84614583333334,MERGED,0,7,1,0,7,543,False,0,0,0,2203,7,19.459444444444443,Document
Java,547,304,224.84788194444445,MERGED,0,7,1,0,7,544,False,0,0,0,2682,7,137.20833333333334,Document
TypeScript,3392,2334,966.2172569444446,CLOSED,0,22,1,1,1,95,False,0,1,1,1570,22,0.008055555555555555,Feature
JavaScript,34,25,196.33194444444442,MERGED,8,18,1,0,2,3,False,0,0,0,2066,26,0.7413888888888889,Bug
Java,547,304,224.89100694444446,MERGED,0,4,1,0,9,550,False,0,0,0,2444,4,18.276944444444446,Document
Java,547,304,224.87376157407405,MERGED,0,4,1,0,7,547,False,0,0,0,2445,4,7.5633333333333335,Document
Java,547,304,224.85189814814817,MERGED,0,11,1,0,11,546,False,0,0,0,2203,11,305.90722222222223,Document
TypeScript,3392,2334,965.9881134259259,MERGED,5,4,5,1,1,307,False,0,1,1,1890,9,1.6080555555555556,Feature
TypeScript,3392,2334,965.9546296296297,MERGED,6,9,3,1,3,306,False,0,1,1,2246,15,0.5538888888888889,Bug
Erlang,2054,12122,3798.2872569444444,MERGED,16,167,4,2,4,325,False,0,2,1,2865,183,117.09055555555555,Document
TypeScript,261,3765,676.4646643518519,MERGED,723,473,35,0,5,182,False,0,0,0,9283,1196,7.196666666666666,Document
Go,54,353,732.0279861111111,MERGED,69,121,13,2,6,207,True,1,1,1,8402,190,21.94638888888889,Feature
TypeScript,184,377,1912.9960648148146,MERGED,0,36,3,0,1,22,False,0,0,0,6085,36,122.17194444444445,Document
TypeScript,41369,87411,2940.9371180555554,MERGED,89,1281,10,3,11,110,False,0,3,1,7127,1370,307.3880555555556,Document
TypeScript,261,3765,675.5142592592592,MERGED,34,3006,34,0,4,152,False,0,0,0,9342,3040,3.002222222222222,Document
TypeScript,41369,87411,2938.6897569444445,CLOSED,5,92,5,2,3,575,True,1,1,1,4666,97,288.7630555555556,Document
Rust,264,5382,405.0956481481482,MERGED,129,97,2,0,1,89,True,0,0,0,7758,226,16.013333333333332,Bug
TypeScript,261,3765,674.9853819444444,MERGED,808,530,127,0,4,250,True,0,0,0,9420,1338,16.143055555555556,Document
Go,1835,11245,1728.6792476851851,MERGED,1,8,2,0,1,82,False,0,0,0,1743,9,0.12305555555555556,Bug
TypeScript,261,3765,678.5183796296296,MERGED,213,414,15,1,3,9,True,0,1,1,4217,627,0.3402777777777778,Document
Starlark,440,286,492.7785300925926,MERGED,19,41,2,0,4,1,False,0,0,0,2812,60,148.025,Document
TypeScript,307,2556,538.7184027777778,MERGED,122,806,17,0,3,177,True,0,0,0,7109,928,117.97555555555556,Bug
TypeScript,1297,21107,417.7456134259259,MERGED,1182,2660,26,1,27,934,True,0,1,1,6841,3842,197.85111111111112,Document
TypeScript,1297,21107,414.10359953703704,CLOSED,189,465,336,1,4,924,True,0,1,1,7956,654,0.8444444444444444,Document
Python,2407,12180,244.7396527777778,MERGED,6,6,1,1,2,1,False,0,1,1,2552,12,7.471111111111111,Document
Python,2407,12180,244.2357291666667,MERGED,16,76,1,2,10,252,True,2,0,0,2759,92,19.61277777777778,Feature
Python,2407,12180,243.80824074074076,MERGED,3,6,2,2,4,249,True,1,1,1,2336,9,29.81861111111111,Document
Python,2407,12180,238.80743055555556,MERGED,13,18,3,6,9,3,False,3,3,1,2658,31,8.751944444444444,Document
Go,789,5551,1043.308402777778,MERGED,2,1,2,0,1,35,True,0,0,0,2643,3,1.0711111111111111,Document
TypeScript,41369,87411,2941.996226851852,MERGED,37,635,10,1,9,113,False,0,1,1,5285,672,89.015,Document
Rust,264,5382,405.0255208333333,MERGED,47,147,13,0,1,138,False,0,0,0,7357,194,0.5777777777777777,Document
Go,1835,11245,1727.7393865740742,MERGED,30,23,4,0,1,95,False,0,0,0,2913,53,0.32611111111111113,Feature
Python,2407,12180,242.8657986111111,MERGED,52,486,19,2,13,248,True,2,0,0,2450,538,3.1175,Document
Vue,0,1,247.28841435185186,CLOSED,7,23,4,1,2,185,True,1,0,0,2960,30,20.739722222222223,Bug
Java,450,746,4072.0270949074074,MERGED,6,56,4,1,2,582,False,0,1,1,2722,62,216.5536111111111,Feature
Rust,264,5382,403.92281249999996,MERGED,286,15,4,0,1,83,True,0,0,0,6668,301,4.524166666666667,Bug
TypeScript,3392,2334,968.1263078703704,MERGED,34,24,5,1,7,311,False,0,1,1,2641,58,117.15,Feature
TypeScript,41369,87411,2935.6164814814815,CLOSED,37306,19417,344,3,14,14,False,1,2,1,7298,56723,260.99694444444447,Document
TypeScript,1297,21107,418.12298611111106,MERGED,56,93,8,2,1,935,True,0,2,2,5558,149,0.15361111111111111,Document
TypeScript,149,2900,381.8430902777778,MERGED,210,708,14,3,10,89,False,2,1,1,4890,918,87.06694444444445,Feature
TypeScript,41369,87411,2941.1116898148152,MERGED,27,31,10,1,1,416,True,0,1,1,5408,58,9.48,Document
Go,789,5551,1039.2388888888888,MERGED,1,294,4,1,1,12,False,1,0,0,2467,295,38.471111111111114,Document
TypeScript,2071,16638,1241.4194560185185,MERGED,1,24,2,0,1,0,False,0,0,0,4289,25,16.999444444444446,Bug
TypeScript,307,2556,537.7584375,MERGED,212,17,21,0,3,562,True,0,0,0,7561,229,141.83833333333334,Feature
TypeScript,41369,87411,2940.9076388888893,MERGED,59,49,10,1,3,415,True,0,1,1,6367,108,1.683888888888889,Document
Python,2407,12180,241.02502314814816,MERGED,14,20,2,0,6,245,True,0,0,0,2759,34,1.0947222222222222,Document
Starlark,440,286,490.2094675925926,MERGED,7,21,1,0,1,79,False,0,0,0,2384,28,17.7475,Feature
Python,547,7160,2239.6283680555557,MERGED,1,62,2,0,3,16,False,0,0,0,2927,63,4.588333333333333,Bug
TypeScript,1297,21107,416.96221064814813,CLOSED,9142,3567,141,1,29,0,False,0,1,1,6110,12709,0.33,Document
TypeScript,4,33,764.1295833333334,MERGED,21,53,3,4,4,363,False,0,4,2,2814,74,0.04722222222222222,Feature
TypeScript,3392,2334,971.8629861111111,MERGED,28,60,5,2,2,0,False,0,2,1,4601,88,601.9780555555556,Document
TypeScript,3392,2334,969.1855555555557,MERGED,3,24,1,1,2,103,False,0,1,1,2941,27,0.9341666666666667,Feature
TypeScript,3392,2334,967.950775462963,MERGED,7,14,4,2,4,449,False,0,2,1,3229,21,46.85055555555556,Document
Python,2407,12180,239.74150462962962,MERGED,4,4,2,2,2,68,True,0,2,2,2735,8,6.788055555555555,Document
TypeScript,41369,87411,2939.748078703704,CLOSED,14,168,11,1,3,1,False,0,1,1,5651,182,0.2683333333333333,Document
Go,1835,11245,1733.0267708333333,MERGED,31,20,3,0,1,91,False,0,0,0,2708,51,14.19138888888889,Bug
Rust,413,5117,466.60312500000003,MERGED,11,6,1,2,13,129,False,0,2,1,5359,17,29.1425,Document
JavaScript,34,25,199.13707175925924,MERGED,15,13,6,0,1,74,False,0,0,0,2936,28,1.2519444444444445,Feature
Java,450,746,4072.99505787037,MERGED,134,469,13,1,1,143,False,0,1,1,6133,603,1.5594444444444444,Bug
Python,2407,12180,239.14003472222223,MERGED,3,9,1,2,3,0,False,1,1,1,2300,12,0.7625,Document
TypeScript,41369,87411,2938.799097222222,MERGED,105,69,19,0,2,1898,True,0,0,0,6316,174,1.198611111111111,Document
TypeScript,139,827,747.1340393518518,MERGED,18,141,4,2,4,25,False,0,2,2,2686,159,50.19694444444445,Feature
Rust,413,5117,466.83537037037036,MERGED,525,570,3,0,6,116,False,0,0,0,2517,1095,22.11916666666667,Document
TypeScript,307,2556,537.7468634259259,MERGED,2,2,2,6,1,561,True,1,5,2,6892,4,17.710555555555555,Bug
TypeScript,3392,2334,967.1291550925926,MERGED,6,19,3,1,1,98,False,0,1,1,2736,25,0.5747222222222222,Bug
TypeScript,3392,2334,966.9265162037037,MERGED,2,13,1,1,1,97,False,0,1,1,2628,15,2.8938888888888887,Feature
TypeScript,3392,2334,966.9289120370371,MERGED,6,6,1,1,1,689,False,0,1,1,2747,12,0.13916666666666666,Bug
Python,14532,41181,1085.7272337962963,MERGED,12,14,2,0,3,1412,True,0,0,0,2505,26,0.03138888888888889,Document
Rust,591,3260,549.129988425926,MERGED,158,301,15,1,1,76,False,1,0,0,3318,459,21.500555555555554,Document
TypeScript,41369,87411,2936.485324074074,MERGED,1,49,6,0,2,1576,True,0,0,0,5152,50,7.885,Document
Go,1835,11245,1726.929212962963,CLOSED,0,144,33,4,15,79,False,2,2,1,2564,144,95.84277777777778,Bug
TypeScript,15,31,462.9450231481481,MERGED,472,2240,51,1,25,101,False,1,0,0,8491,2712,265.99,Document
Java,547,304,228.08243055555556,MERGED,0,0,0,0,6,552,False,0,0,0,3176,0,452.19166666666666,Document
Java,547,304,228.2879050925926,MERGED,0,16,1,0,3,1,False,0,0,0,3082,16,7.5680555555555555,Document
Go,1835,11245,1726.9297685185186,MERGED,6,48,4,0,1,80,False,0,0,0,2938,54,0.3983333333333333,Document
Starlark,440,286,492.11263888888885,MERGED,0,85,2,1,3,1,False,1,0,0,3369,85,165.99388888888888,Bug
Starlark,440,286,489.32618055555554,MERGED,0,220,2,1,5,0,False,1,0,0,3931,220,230.855,Document
Starlark,440,286,494.3240162037037,MERGED,30,43,1,0,1,53,False,0,0,0,3721,73,13.706388888888888,Bug
TypeScript,41369,87411,2940.0326041666667,MERGED,337,880,88,0,27,414,True,0,0,0,9336,1217,0.5202777777777777,Document
TypeScript,307,2556,539.6239814814815,MERGED,305,352,80,0,14,564,True,0,0,0,8311,657,0.3327777777777778,Bug
Starlark,440,286,492.44416666666666,MERGED,95,32,6,0,7,50,False,0,0,0,4665,127,10.206666666666667,Bug
TypeScript,1297,21107,414.84460648148143,MERGED,553,651,40,2,15,928,True,0,2,2,10870,1204,28.654444444444444,Document
Starlark,440,286,492.08589120370374,CLOSED,0,85,2,1,4,0,False,1,0,0,3350,85,0.35333333333333333,Bug
Python,137,75,686.234375,MERGED,6,20,8,0,1,234,False,0,0,0,3442,26,0.18444444444444444,Bug
TypeScript,3392,2334,968.1503240740741,MERGED,31,41,4,1,1,312,False,0,1,1,3372,72,116.58027777777778,Feature
TypeScript,1297,21107,414.7432175925926,MERGED,55,207,22,2,2,927,True,0,2,2,10457,262,0.28,Document
TypeScript,4,33,765.117650462963,MERGED,93,232,7,2,11,202,True,1,1,1,3820,325,3.2005555555555554,Bug
Go,54,353,734.9200347222222,MERGED,363,762,15,0,1,209,True,0,0,0,17312,1125,366.48805555555555,Feature
TypeScript,1297,21107,413.86836805555555,MERGED,70,65,3,2,2,923,True,0,2,2,10405,135,0.1802777777777778,Document
V,2097,34361,1549.4975115740742,MERGED,109,541,13,0,24,20,True,0,0,0,9642,650,15.634722222222223,Document
TypeScript,3392,2334,968.8749768518519,MERGED,20,147,11,1,2,101,False,0,1,1,3988,167,4.065555555555555,Bug
Starlark,440,286,488.12508101851853,MERGED,101,158,1,1,3,0,False,1,0,0,3811,259,68.22527777777778,Feature
Python,2407,12180,239.69657407407408,MERGED,806,2137,29,30,57,67,True,10,20,6,6267,2943,32.98694444444445,Feature
TypeScript,139,827,748.0683101851852,MERGED,15,169,2,2,14,27,False,0,2,2,3440,184,35.146388888888886,Document
TypeScript,41369,87411,2935.796099537037,MERGED,13940,20514,21,3,13,195,False,1,2,2,8780,34454,0.5347222222222222,Document
TypeScript,3392,2334,968.0628009259259,MERGED,272,1277,40,3,91,310,False,2,1,1,6097,1549,1011.7125,Bug
TypeScript,4,33,761.1145023148148,MERGED,377,1674,21,2,79,194,True,1,1,1,3253,2051,53.61555555555555,Feature
Python,2407,12180,237.8508912037037,MERGED,81,948,51,0,23,236,True,0,0,0,5082,1029,10.903055555555556,Document
TypeScript,4,33,761.867650462963,MERGED,100,178,13,1,3,171,False,0,1,1,4099,278,0.08555555555555555,Document
Python,2407,12180,237.73618055555553,MERGED,24,36,6,0,7,235,True,0,0,0,3999,60,3.2822222222222224,Document
Vue,0,1,245.01399305555557,MERGED,45,179,6,0,5,183,True,0,0,0,4018,224,4.437777777777778,Feature
TypeScript,3392,2334,965.4691782407408,MERGED,113,65,29,1,3,685,False,0,1,1,3869,178,9.455,Feature
TypeScript,3392,2334,969.8130671296295,CLOSED,49477,37326,611,2,108,104,False,0,2,2,4907,86803,680.2722222222222,Feature
Go,1835,11245,1726.9676736111112,MERGED,16170,8480,240,1,4,53,False,0,1,1,4619,24650,91.47277777777778,Document
Go,1835,11245,1727.787488425926,MERGED,65,47,3,0,7,81,False,0,0,0,4245,112,2.6180555555555554,Document
Rust,413,5117,466.6496064814815,MERGED,3,1922,14,0,14,15,False,0,0,0,9038,1925,713.9327777777778,Document
Rust,264,5382,402.07142361111113,MERGED,32,215,11,0,11,325,False,0,0,0,12964,247,332.71944444444443,Bug
TypeScript,2147,14722,1474.2368402777777,MERGED,130,234,16,0,3,49,False,0,0,0,17249,364,0.1175,Document
Rust,264,5382,406.14640046296296,MERGED,537,692,47,0,6,156,False,0,0,0,10059,1229,113.66944444444445,Bug
Rust,591,3260,549.2862037037037,MERGED,86,2253,20,3,8,77,False,0,3,2,7474,2339,192.35722222222222,Document
Rust,264,5382,403.7638888888889,MERGED,228,362,35,0,5,153,False,0,0,0,11138,590,4.1025,Bug
TypeScript,41369,87411,2942.020289351852,MERGED,107,107,27,1,7,417,True,0,1,1,11040,214,0.43722222222222223,Document
Python,1912,12140,66.97297453703703,MERGED,0,355,4,5,4,1,False,1,4,2,4619,355,73.32777777777778,Feature
Go,421,1654,1508.9342245370372,MERGED,182,213,21,0,1,423,True,0,0,0,18670,395,8.321111111111112,Document
Go,2083,11769,1522.079837962963,MERGED,15,160,14,13,2,0,False,5,8,2,12416,175,104.31444444444445,Document
TypeScript,41369,87411,2938.7948032407407,MERGED,182,178,28,1,7,411,True,1,0,0,10507,360,20.198055555555555,Document
V,2097,34361,1550.5768055555554,MERGED,40,199,6,1,1,32,True,0,1,1,11961,239,4.566944444444444,Document
TypeScript,41369,87411,2936.4330555555553,CLOSED,30257,28741,136,3,46,1893,True,1,2,2,12601,58998,0.36694444444444446,Document
TypeScript,184,377,1911.086574074074,MERGED,4,20,2,0,2,21,False,0,0,0,5464,24,168.04333333333332,Document
Go,789,5551,1045.0511458333333,MERGED,0,232,5,0,1,0,False,0,0,0,4845,232,18.397777777777776,Document
Starlark,440,286,494.2251388888889,MERGED,85,287,8,0,10,52,False,0,0,0,7697,372,16.073333333333334,Bug
Go,789,5551,1041.2240856481483,MERGED,16,79,2,0,3,13,False,0,0,0,4795,95,42.81333333333333,Document
Starlark,440,286,492.65935185185185,MERGED,131,47,12,0,1,43,False,0,0,0,7339,178,5.0697222222222225,Feature
Vue,0,1,250.39766203703707,MERGED,148,937,32,0,10,187,True,0,0,0,7217,1085,13.139722222222222,Feature
TypeScript,4,33,764.4829398148148,MERGED,483,1265,39,2,6,598,True,1,1,1,6877,1748,88.41888888888889,Document
Python,2407,12180,241.69856481481483,CLOSED,28554,370,190,4,22,0,False,1,3,1,5888,28924,28.020833333333332,Document
Python,14532,41181,1089.6360300925926,CLOSED,8,19,2,0,2,0,False,0,0,0,5594,27,0.08833333333333333,Document
Python,2407,12180,241.0245486111111,MERGED,834,2172,33,0,6,244,True,0,0,0,4971,3006,6.003888888888889,Document
Vue,0,1,245.33517361111112,MERGED,78,120,23,1,7,57,False,0,1,1,6159,198,137.5088888888889,Document
TypeScript,4,33,764.2387731481481,MERGED,103,1476,22,2,7,597,True,1,1,1,7357,1579,2.9030555555555555,Document
TypeScript,4,33,764.1295138888889,MERGED,40,68,13,2,22,200,True,1,1,1,5308,108,0.4841666666666667,Document
Python,2407,12180,240.01052083333332,CLOSED,250,1560,177,0,1,241,True,0,0,0,5892,1810,0.13444444444444445,Document
Python,2407,12180,239.95016203703702,CLOSED,0,0,0,0,0,240,True,0,0,0,7064,0,1.3888888888888888,Document
TypeScript,7,6,646.1246643518518,MERGED,582,2246,58,8,58,208,False,4,4,3,18744,2828,359.06388888888887,Document
TypeScript,3392,2334,968.0957523148148,MERGED,19,110,12,1,1,100,False,0,1,1,7207,129,22.788055555555555,Feature
Python,2407,12180,239.18721064814815,MERGED,53,163,13,0,8,238,True,0,0,0,5423,216,0.5352777777777777,Document
Python,2407,12180,239.18839120370373,MERGED,22,104,5,0,16,239,True,0,0,0,4870,126,0.16166666666666665,Document
TypeScript,4,33,761.2466435185185,MERGED,192,1013,21,2,42,196,True,1,1,1,7051,1205,20.750833333333333,Bug
Go,30,295,352.0815046296296,MERGED,26,149,14,20,25,92,True,4,16,3,18449,175,101.28138888888888,Feature
TypeScript,3392,2334,965.9735300925926,MERGED,103,158,6,1,4,94,False,0,1,1,6692,261,6.039444444444444,Bug
Go,1835,11245,1727.9495138888888,MERGED,85,101,5,0,1,515,False,0,0,0,6421,186,18.43888888888889,Document
Go,789,5551,1045.1052546296296,MERGED,46,37,18,1,1,1,False,1,0,0,8350,83,43.868611111111115,Document
Go,54,353,733.7016782407408,MERGED,295,551,22,3,8,208,True,3,0,0,14540,846,25.570555555555554,Document
TypeScript,3392,2334,966.7366550925926,MERGED,267,293,88,2,3,0,False,0,2,1,8988,560,175.5713888888889,Bug
Java,450,746,4071.269525462963,MERGED,123195,123573,121,4,37,373,True,1,3,1,14674,246768,1073.4558333333334,Document
TypeScript,4,33,764.7390046296296,MERGED,534,1072,34,1,11,177,False,0,1,1,9239,1606,21.7625,Document
Python,2407,12180,240.0741550925926,MERGED,354,747,138,0,9,243,True,0,0,0,8717,1101,0.9005555555555556,Document
Python,2407,12180,240.02357638888887,MERGED,335,730,133,0,8,242,True,0,0,0,10488,1065,1.1575,Document
TypeScript,153,730,230.91104166666665,MERGED,33,33,30,3,5,11,True,0,3,2,9199,66,2.897777777777778,Feature
Java,450,746,4072.29537037037,MERGED,186,536,35,2,8,73,True,0,2,1,9802,722,67.435,Bug
Go,1835,11245,1727.5936921296297,MERGED,673,300,16,0,1,514,False,0,0,0,9946,973,52.41138888888889,Document
TypeScript,4,33,763.7724652777778,MERGED,302,378,15,1,3,175,False,0,1,1,13838,680,0.3113888888888889,Bug
TypeScript,3392,2334,966.1855324074073,MERGED,257,253,15,1,3,688,False,0,1,1,12901,510,22.460277777777776,Bug
Java,450,746,4072.1190509259263,MERGED,262,274,11,1,23,376,True,0,1,1,11602,536,1.3286111111111112,Bug
Vue,0,1,247.09993055555557,MERGED,166,326,27,0,8,184,True,0,0,0,16049,492,4.2347222222222225,Bug
Python,19248,70257,2470.490127314815,CLOSED,0,79,2,9,1,40,True,6,3,1,136,79,4.19,Document
V,2097,34361,1559.990127314815,MERGED,2,3,1,2,1,14,True,1,1,1,1384,5,34.7525,Document
Vue,293,495,836.875798611111,MERGED,1,11,3,6,10,17,False,3,3,3,1674,12,552.8358333333333,Bug
Vue,293,495,838.153425925926,MERGED,0,1,1,5,1,376,False,0,5,3,1392,1,17.555833333333332,Bug
TypeScript,2071,16638,1254.0460185185186,CLOSED,1,3,1,1,1,3,False,0,1,1,2611,4,2312.340833333333,Bug
Python,19248,70257,2469.8180671296295,CLOSED,2,6,1,1,2,1593,False,1,0,0,240,8,16.33388888888889,Feature
Vue,293,495,840.7795370370371,MERGED,16,61,8,18,18,54,False,5,13,7,1690,77,601.8036111111111,Bug
TypeScript,2147,14722,1480.187673611111,MERGED,4,6,1,0,1,691,False,0,0,0,604,10,17.99277777777778,Bug
TypeScript,2147,14722,1478.258564814815,MERGED,1,5,1,0,1,687,False,0,0,0,674,6,0.2683333333333333,Bug
TypeScript,2147,14722,1477.960300925926,MERGED,8,15,3,0,4,685,False,0,0,0,632,23,5.138055555555556,Bug
TypeScript,2147,14722,1483.045,CLOSED,11,12,1,0,1,699,False,0,0,0,809,23,0.10777777777777778,Feature
TypeScript,2147,14722,1482.7546180555555,MERGED,7,9,1,0,1,698,False,0,0,0,1126,16,49.04833333333333,Bug
TypeScript,41369,87411,2942.119664351852,CLOSED,1,2,2,3,1,7,False,0,3,3,1826,3,39.093333333333334,Document
TypeScript,2147,14722,1481.2302893518518,MERGED,4,7,1,0,1,695,False,0,0,0,1469,11,15.165833333333333,Feature
TypeScript,2147,14722,1480.9887847222224,MERGED,10,38,2,0,1,692,False,0,0,0,1832,48,20.273055555555555,Document
TypeScript,2147,14722,1480.0569791666667,MERGED,10,14,3,0,2,690,False,0,0,0,1263,24,0.4722222222222222,Feature
TypeScript,2147,14722,1479.077962962963,MERGED,3,3,1,0,1,688,False,0,0,0,1308,6,0.48277777777777775,Feature
JavaScript,5139,7050,1212.2025462962963,MERGED,4,8,1,1,1,96,False,0,1,1,751,12,996.4413888888889,Document
Python,547,7160,2247.6175810185186,CLOSED,4,57,1,0,4,9,False,0,0,0,455,61,1461.431388888889,Bug
TypeScript,2147,14722,1481.1643287037039,MERGED,2,14,2,0,1,694,False,0,0,0,2405,16,16.81222222222222,Document
JavaScript,5139,7050,1213.3893055555557,CLOSED,0,129,2,4,6,0,False,1,3,2,1111,129,1132.0536111111112,Feature
TypeScript,2147,14722,1481.7710300925926,MERGED,55,56,3,0,1,696,False,0,0,0,3143,111,2.1819444444444445,Feature
TypeScript,261,3765,683.8661574074075,CLOSED,5,18,4,0,1,99,False,0,0,0,1462,23,1.3902777777777777,Document
JavaScript,5139,7050,1209.7062268518519,MERGED,145,290,78,10,11,0,False,2,8,4,293,435,219.38222222222223,Document
Rust,264,5382,414.30834490740745,MERGED,44,42,18,0,9,0,False,0,0,0,1265,86,112.67611111111111,Bug
Rust,264,5382,411.99899305555556,MERGED,3,43,5,1,2,0,False,0,1,1,1637,46,125.86888888888889,Bug
,0,0,57.715937499999995,CLOSED,1,95962,119,0,2,2,True,0,0,0,382,95963,293.9786111111111,Feature
Python,137,75,695.0761689814814,MERGED,0,59,5,0,23,0,False,0,0,0,1159,59,1900.066111111111,Document
TypeScript,2071,16638,1249.397974537037,MERGED,3,10,1,2,2,0,False,0,2,1,3001,13,2016.463888888889,Bug
TypeScript,2147,14722,1482.2667939814817,MERGED,4,5,1,0,3,168,False,0,0,0,676,9,0.4988888888888889,Bug
TypeScript,178,1359,328.4054976851852,CLOSED,1,16,4,2,3,10,True,0,2,2,1740,17,477.0941666666667,Bug
TypeScript,2147,14722,1479.0896874999999,MERGED,1,25,1,0,4,167,False,0,0,0,660,26,0.2336111111111111,Bug
V,2097,34361,1562.7264699074074,MERGED,9,28,9,2,5,215,True,1,1,1,1979,37,16.97888888888889,Document
TypeScript,2147,14722,1481.9100694444444,CLOSED,8,8,2,5,1,0,False,3,2,1,963,16,92.48611111111111,Bug
PHP,1334,2960,4217.003831018518,MERGED,1,1,1,0,1,156,False,0,0,0,727,2,140.53833333333333,Bug
PHP,1334,2960,4215.078043981482,MERGED,4,17,1,2,3,2,False,1,1,1,742,21,195.46555555555557,Bug
TypeScript,7,6,652.2069560185186,CLOSED,0,8,1,0,3,222,False,0,0,0,1091,8,472.98055555555555,Bug
TypeScript,2147,14722,1480.1883217592592,MERGED,0,9,1,0,1,100,False,0,0,0,599,9,0.5725,Feature
TypeScript,2147,14722,1481.062222222222,MERGED,46,188,6,0,1,693,False,0,0,0,4123,234,19.274722222222223,Document
Go,395,660,1273.116238425926,MERGED,15,15,5,1,12,6,False,1,0,0,219,30,210.19916666666666,Feature
Rust,264,5382,410.7953356481482,CLOSED,9,1184,9,3,1,3,False,0,3,2,3057,1193,1295.4591666666668,Feature
C++,2234,23694,2368.720729166667,MERGED,4,28,1,1,2,208,False,0,1,1,913,32,311.43083333333334,Bug
TypeScript,178,1359,330.5740162037037,MERGED,2,2,1,1,1,38,True,0,1,1,1008,4,1.5988888888888888,Bug
TypeScript,2147,14722,1482.0727430555555,MERGED,26,31,1,0,2,77,False,0,0,0,820,57,4.411111111111111,Bug
TypeScript,2147,14722,1479.1750810185185,MERGED,1,2,1,1,1,76,False,1,0,0,688,3,0.26555555555555554,Feature
Python,19248,70257,2469.116087962963,CLOSED,30,45,4,9,7,109,False,9,0,0,664,75,968.0575,Feature
C++,2234,23694,2366.786597222222,CLOSED,1,1,1,5,1,191,True,3,2,2,492,2,99.09,Bug
TypeScript,2147,14722,1481.781435185185,MERGED,1,6,2,0,1,289,False,0,0,0,890,7,2.0605555555555557,Document
JavaScript,8844,63474,4088.364016203704,MERGED,43,360,19,3,18,96,True,2,1,1,648,403,91.43027777777777,Bug
C++,2234,23694,2363.9913310185184,MERGED,16,160,3,1,12,16,False,0,1,1,562,176,189.7161111111111,Feature
TypeScript,2147,14722,1477.7904282407408,MERGED,1,0,1,0,1,45,False,0,0,0,602,1,1.561388888888889,Bug
JavaScript,5139,7050,1213.145925925926,CLOSED,0,2,2,1,2,0,False,0,1,1,494,2,0.03666666666666667,Feature
TypeScript,85,722,323.201724537037,MERGED,4,4,2,0,4,160,False,0,0,0,1147,8,18.285833333333333,Document
,0,0,57.87859953703704,CLOSED,0,74445,76,2,3,3,True,2,0,0,2542,74445,290.0725,Feature
TypeScript,178,1359,332.7749074074074,MERGED,5,9,2,2,2,16,True,0,2,2,1399,14,46.468333333333334,Bug
TypeScript,7,6,653.1099537037037,MERGED,1,0,1,0,1,284,False,0,0,0,598,1,0.31333333333333335,Feature
TypeScript,85,722,322.1338773148148,MERGED,2,2,1,0,1,158,False,0,0,0,1134,4,0.5475,Document
JavaScript,5139,7050,1215.0238657407408,MERGED,22,933,22,2,4,54,False,0,2,2,4358,955,1115.8930555555555,Feature
Go,421,1654,1517.2298726851852,MERGED,51,18,2,0,1,238,False,0,0,0,919,69,113.4036111111111,Bug
TypeScript,178,1359,332.2059027777778,MERGED,599,379,2,1,1,20,True,0,1,1,1254,978,0.016666666666666666,Bug
Rust,264,5382,412.85640046296294,MERGED,1,2,1,0,1,65,False,0,0,0,837,3,0.7672222222222222,Feature
PHP,1334,2960,4214.006782407408,MERGED,2,0,1,1,1,155,False,1,0,0,602,2,1.1394444444444445,Document
TypeScript,2147,14722,1477.8980671296297,MERGED,2,12,1,0,1,670,False,0,0,0,1011,14,6.602222222222222,Document
TypeScript,85,722,320.47246527777776,MERGED,1,1,1,0,2,5,False,0,0,0,1104,2,12.214166666666667,Document
TypeScript,261,3765,685.7129861111111,MERGED,2,7,2,0,1,592,True,0,0,0,1555,9,0.5275,Document
PHP,1334,2960,4213.279988425926,MERGED,4,6,1,0,1,866,False,0,0,0,652,10,16.157777777777778,Bug
TypeScript,261,3765,685.5158333333334,MERGED,0,14,2,0,2,96,True,0,0,0,1534,14,0.6869444444444445,Document
PHP,1334,2960,4213.091157407408,MERGED,29,38,1,0,1,865,False,0,0,0,708,67,17.989166666666666,Document
Java,450,746,4080.2559375,MERGED,302,704,13,1,14,374,False,0,1,1,1256,1006,665.7538888888889,Document
Rust,264,5382,412.0205787037037,MERGED,3,5,1,0,1,237,True,0,0,0,745,8,0.5772222222222222,Feature
Rust,264,5382,413.66996527777775,MERGED,1,143,9,0,11,0,False,0,0,0,2825,144,59.599444444444444,Feature
Rust,264,5382,411.9793865740741,MERGED,1,1,1,0,1,333,False,0,0,0,768,2,0.4936111111111111,Bug
PHP,1334,2960,4214.996203703704,MERGED,1,1,1,7,1,199,False,3,4,2,907,2,47.3475,Document
TypeScript,261,3765,684.8004861111111,MERGED,2,2,2,0,1,19,True,0,0,0,1271,4,16.659166666666668,Document
TypeScript,2147,14722,1478.1677314814815,MERGED,15,12,5,0,1,165,False,0,0,0,1349,27,0.1897222222222222,Feature
Vue,293,495,840.7684027777777,MERGED,59,135,3,8,9,165,True,2,6,4,965,194,97.40444444444445,Bug
Go,421,1654,1518.9811689814815,MERGED,504,831,17,0,1,239,False,0,0,0,1254,1335,150.93055555555554,Bug
Rust,264,5382,411.26149305555555,MERGED,2,3,1,0,1,406,False,0,0,0,693,5,0.4525,Feature
TypeScript,2147,14722,1481.7942476851852,MERGED,5,6,2,0,1,290,False,0,0,0,1209,11,1.7602777777777778,Bug
TypeScript,178,1359,332.7434259259259,MERGED,7,7,3,3,3,15,True,1,2,2,2100,14,49.443333333333335,Bug
Rust,264,5382,410.91928240740737,MERGED,0,4,1,0,2,15,False,0,0,0,677,4,1.7225,Feature
Rust,264,5382,410.75239583333337,MERGED,1,4,1,0,1,402,False,0,0,0,652,5,4.7219444444444445,Feature
Rust,264,5382,410.7989930555555,MERGED,1,1,1,0,1,331,False,0,0,0,665,2,0.8733333333333333,Bug
PHP,1334,2960,4215.066979166667,MERGED,0,46,2,0,1,147,False,0,0,0,1041,46,0.5566666666666666,Bug
TypeScript,7,6,651.1745949074074,MERGED,14,30,7,0,4,12,True,0,0,0,756,44,21.607222222222223,Feature
TypeScript,2147,14722,1480.977199074074,MERGED,166,369,12,0,3,70,False,0,0,0,1430,535,0.7363888888888889,Feature
C++,2234,23694,2363.0325578703705,MERGED,23,4,3,2,1,540,False,1,1,1,735,27,39.297222222222224,Bug
TypeScript,178,1359,328.8078935185185,MERGED,8,7,1,2,1,12,True,0,2,2,1602,15,0.17333333333333334,Bug
TypeScript,261,3765,683.519375,MERGED,4,4,1,0,1,874,True,0,0,0,1064,8,0.11027777777777778,Document
Python,19248,70257,2468.2542245370373,CLOSED,4,15,2,0,5,108,False,0,0,0,871,19,988.7419444444445,Feature
PHP,1334,2960,4214.297071759259,MERGED,1,1,1,0,1,868,False,0,0,0,1126,2,0.7783333333333333,Feature
TypeScript,85,722,323.02769675925924,MERGED,33,238,13,0,8,159,False,0,0,0,1374,271,23.195555555555554,Document
TypeScript,2147,14722,1480.2205324074075,MERGED,2,3,1,0,1,101,False,0,0,0,1181,5,17.169444444444444,Feature
Rust,264,5382,412.0433912037037,MERGED,3,4,1,0,1,16,False,0,0,0,878,7,89.65777777777778,Feature
PHP,1334,2960,4214.111990740741,MERGED,4,2,4,0,6,867,False,0,0,0,983,6,1.2697222222222222,Feature
TypeScript,261,3765,682.857962962963,MERGED,89,96,3,0,1,158,False,0,0,0,1331,185,14.757222222222222,Document
PHP,1334,2960,4214.078414351851,MERGED,3,2,1,0,1,146,False,0,0,0,966,5,0.4125,Bug
TypeScript,2147,14722,1484.083564814815,MERGED,18,37,2,0,2,169,False,0,0,0,2551,55,17.150277777777777,Document
PHP,1334,2960,4213.986724537037,MERGED,2,3,1,1,1,154,False,0,1,1,1126,5,0.5863888888888888,Feature
,0,0,57.89995370370371,CLOSED,0,773,12,0,1,4,True,0,0,0,3220,773,289.5572222222222,Feature
TypeScript,261,3765,682.5995949074074,MERGED,1,2,2,0,2,589,True,0,0,0,1120,3,1.1813888888888888,Document
TypeScript,261,3765,682.5500000000001,MERGED,1,14,2,0,2,187,False,0,0,0,1530,15,1.3269444444444445,Document
TypeScript,261,3765,682.535625,MERGED,8,15,2,0,1,871,True,0,0,0,1091,23,0.31194444444444447,Document
V,2097,34361,1561.8545023148147,MERGED,6,56,5,0,6,191,True,0,0,0,963,62,121.41944444444445,Bug
PHP,1334,2960,4213.050648148148,MERGED,0,2,1,0,1,864,False,0,0,0,963,2,4.733888888888889,Document
C++,2234,23694,2363.281840277778,MERGED,1,1,1,1,1,190,True,0,1,1,639,2,9.650555555555556,Bug
Rust,264,5382,412.94265046296294,MERGED,0,16,1,0,1,99,True,0,0,0,745,16,1.0122222222222221,Feature
Rust,264,5382,412.7802546296296,MERGED,1,1,1,0,1,97,True,0,0,0,804,2,3.023888888888889,Bug
Rust,264,5382,412.798900462963,MERGED,1,1,1,0,1,335,False,0,0,0,859,2,1.8297222222222222,Feature
JavaScript,5139,7050,1213.7156712962963,MERGED,4,17,3,2,5,82,False,1,1,1,1364,21,120.35861111111112,Bug
TypeScript,2147,14722,1478.8125462962962,MERGED,0,3,2,0,2,68,False,0,0,0,1170,3,9.116666666666667,Feature
Rust,264,5382,412.03853009259257,MERGED,29,27,2,0,1,238,True,0,0,0,1098,56,18.516111111111112,Document
TypeScript,149,2900,390.6811921296296,MERGED,18,31,2,1,1,94,False,0,1,1,75,49,0.05583333333333333,Feature
Rust,264,5382,413.3299768518518,MERGED,1,15,1,0,1,3,False,0,0,0,1667,16,256.81805555555553,Feature
Rust,264,5382,411.9816087962963,MERGED,0,33,1,0,1,96,True,0,0,0,905,33,2.3505555555555557,Document
Rust,264,5382,411.9741898148148,CLOSED,0,34,1,0,1,95,True,0,0,0,824,34,0.09194444444444444,Document
TypeScript,7,6,653.1863194444444,MERGED,3,6,1,0,1,22,False,0,0,0,990,9,0.2088888888888889,Feature
TypeScript,202,107,1152.9513078703703,MERGED,40,40,1,4,7,1,False,0,4,4,1134,80,133.46333333333334,Bug
JavaScript,8844,63474,4085.3611805555556,MERGED,1,93,8,1,3,93,True,1,0,0,1150,94,1.5102777777777778,Document
TypeScript,178,1359,330.636712962963,MERGED,10,87,3,3,2,39,True,1,2,2,1920,97,5.518611111111111,Feature
TypeScript,2147,14722,1477.8739699074074,MERGED,2,4,1,0,1,669,False,0,0,0,1068,6,7.190277777777778,Document
Java,1,10,239.03259259259258,MERGED,16,21,1,0,7,26,True,0,0,0,1556,37,240.97861111111112,Document
TypeScript,7046,76149,2636.5119097222223,MERGED,25,0,2,3,1,103,False,0,3,2,685,25,0.4091666666666667,Document
TypeScript,2147,14722,1481.797511574074,MERGED,3,17,1,0,1,291,False,0,0,0,2019,20,1.6866666666666668,Feature
Rust,264,5382,411.1250694444445,MERGED,2,13,2,0,1,404,False,0,0,0,987,15,0.9486111111111111,Feature
Rust,264,5382,411.0714120370371,MERGED,2,11,1,0,1,94,True,0,0,0,1054,13,0.5119444444444444,Bug
C++,2234,23694,2365.0420833333333,MERGED,5,2,2,2,1,542,False,1,1,1,734,7,38.86333333333334,Bug
JavaScript,8844,63474,4085.053738425926,MERGED,5,5,2,0,1,91,True,0,0,0,934,10,2.7794444444444446,Feature
V,2097,34361,1562.4944097222224,MERGED,0,4,1,0,1,1,False,0,0,0,957,4,22.578055555555554,Bug
TypeScript,307,2556,545.8016550925926,MERGED,5,10,2,6,1,0,False,1,5,2,1028,15,483.0391666666667,Bug
Rust,264,5382,409.97400462962963,MERGED,17,62,4,0,6,329,False,0,0,0,1071,79,22.70888888888889,Bug
TypeScript,261,3765,682.9629166666667,MERGED,2,6,2,0,2,251,True,0,0,0,1191,8,17.9575,Document
JavaScript,8844,63474,4084.518391203704,MERGED,1,11,2,1,1,107,True,1,0,0,935,12,0.5944444444444444,Document
JavaScript,8844,63474,4084.48287037037,MERGED,0,2,2,2,1,106,True,2,0,0,907,2,0.6088888888888889,Document
Python,19248,70257,2470.5442939814816,CLOSED,0,2,1,6,2,43,True,4,2,1,134,2,2.984722222222222,Document
TypeScript,85,722,325.0894328703704,CLOSED,41,1952,26,0,7,162,False,0,0,0,4895,1993,308.62638888888887,Document
TypeScript,7,6,649.9241203703704,MERGED,1,3,1,0,7,11,True,0,0,0,815,4,70.25972222222222,Feature
Rust,264,5382,408.9368865740741,CLOSED,2,3,1,0,1,14,False,0,0,0,1072,5,0.24722222222222223,Bug
Python,547,7160,2247.645902777778,MERGED,0,188,2,1,4,276,True,1,0,0,862,188,0.3236111111111111,Bug
C++,2234,23694,2365.937326388889,CLOSED,13,38,3,1,10,280,False,0,1,1,1973,51,258.01722222222224,Bug
TypeScript,2147,14722,1480.2263078703702,MERGED,1,37,4,0,2,165,False,0,0,0,1957,38,17.738055555555555,Bug
JavaScript,8844,63474,4083.787534722222,MERGED,2,2,2,0,1,105,True,0,0,0,996,4,9.692777777777778,Feature
Rust,264,5382,409.7724074074074,CLOSED,1,1,1,0,1,400,False,0,0,0,744,2,2.4033333333333333,Bug
Vue,293,495,837.922199074074,MERGED,2,11,1,4,3,18,False,0,4,4,992,13,28.357777777777777,Bug
TypeScript,178,1359,328.85506944444444,MERGED,4,8,1,2,1,13,True,0,2,2,1915,12,0.020833333333333332,Feature
Go,421,1654,1517.1519907407408,MERGED,7,11,2,0,1,237,False,0,0,0,1372,18,0.8080555555555555,Bug
TypeScript,7,6,650.9649421296297,MERGED,2,2,1,0,2,14,False,0,0,0,964,4,0.19972222222222222,Feature
TypeScript,261,3765,683.7616435185186,MERGED,76,91,6,0,2,877,True,0,0,0,1812,167,0.5427777777777778,Document
TypeScript,261,3765,683.7064236111111,MERGED,12,32,2,0,1,876,True,0,0,0,2118,44,0.5047222222222222,Document
TypeScript,2147,14722,1480.1477199074072,MERGED,3,29,1,0,1,34,False,0,0,0,2146,32,1.6527777777777777,Feature
V,2097,34361,1561.407951388889,MERGED,23,4,1,0,1,35,False,0,0,0,892,27,5.663888888888889,Feature
TypeScript,261,3765,683.6514930555555,MERGED,0,12,3,0,2,95,True,0,0,0,1715,12,0.7413888888888889,Document
C++,2234,23694,2364.7082986111113,CLOSED,10,67,3,1,7,278,False,0,1,1,1707,77,287.3066666666667,Feature
TypeScript,41368,87411,2942.0621180555554,CLOSED,47,103,4,2,1,3,False,0,2,2,5914,150,2290.0755555555556,Document
Python,19248,70257,2470.5173148148147,CLOSED,0,116,2,3,4,42,True,3,0,0,142,116,3.8647222222222224,Feature
Python,19248,70257,2470.498622685185,CLOSED,0,172,2,3,3,41,True,3,0,0,128,172,4.25,Feature
Go,421,1654,1515.109097222222,MERGED,673,323,15,0,2,435,True,0,0,0,709,996,19.046944444444446,Document
Vue,293,495,837.8802777777778,MERGED,11,3,2,5,2,384,True,1,4,3,1009,14,0.7841666666666667,Bug
JavaScript,8844,63474,4087.9559143518522,MERGED,2,51,2,4,4,0,False,1,3,3,1783,53,83.90611111111112,Feature
Go,421,1654,1516.201886574074,MERGED,3,3,2,0,1,2,False,0,0,0,1255,6,0.17916666666666667,Document
Go,421,1654,1516.1996412037035,MERGED,8,8,1,1,1,0,False,0,1,1,1729,16,0.22555555555555556,Bug
TypeScript,178,1359,327.36100694444445,MERGED,9,22,5,2,2,11,True,0,2,2,2239,31,10.002222222222223,Bug
TypeScript,261,3765,682.6989351851852,MERGED,0,8,3,0,1,98,False,0,0,0,1703,8,0.25166666666666665,Document
TypeScript,261,3765,682.6396643518518,MERGED,4,46,2,0,1,872,True,0,0,0,1971,50,0.16527777777777777,Document
TypeScript,202,107,1152.5449768518517,MERGED,1,1,1,3,1,0,False,0,3,3,990,2,1.1269444444444445,Document
JavaScript,8844,63474,4087.3048726851853,MERGED,5,35,6,0,1,95,True,0,0,0,1592,40,99.50277777777778,Bug
Rust,264,5382,413.22555555555556,MERGED,2,7,1,0,1,1,False,0,0,0,1631,9,95.81222222222222,Feature
PHP,1334,2960,4215.1608564814815,MERGED,1,4,1,0,1,86,False,0,0,0,1677,5,121.81833333333333,Document
Vue,293,495,836.8258680555556,MERGED,1,185,2,3,4,383,True,0,3,3,784,186,1.2683333333333333,Feature
Vue,293,495,835.7946643518518,MERGED,11,230,6,4,5,163,True,1,3,2,1052,241,44.98,Document
Vue,293,495,836.7449652777777,MERGED,0,14,1,3,1,382,True,0,3,2,785,14,1.3052777777777778,Bug
PHP,1334,2960,4213.120439814815,MERGED,2,1,1,0,1,46,False,0,0,0,1433,3,20.654166666666665,Document
JavaScript,5139,7050,1210.6810416666667,MERGED,9,261,9,1,17,104,False,0,1,1,1499,270,50.1675,Document
TypeScript,15,34,498.80925925925925,MERGED,9679,2966,325,0,62,314,False,0,0,0,389,12645,339.0261111111111,Feature
Rust,3808,5430,449.58872685185185,MERGED,3066,3051,46,0,3,58,False,0,0,0,260,6117,3.6905555555555556,Feature
V,2097,34361,1559.3936689814816,MERGED,1,26,2,0,1,189,True,0,0,0,1052,27,21.002222222222223,Bug
Vue,293,495,836.0761689814814,MERGED,3,5,1,5,4,381,True,1,4,3,1092,8,21.089444444444446,Bug
TypeScript,149,2900,387.0021180555555,MERGED,1,2,1,1,1,93,False,0,1,1,126,3,0.7202777777777778,Document
F#,153,337,2929.5212847222224,MERGED,2,2,2,1,2,1,False,0,1,1,1825,4,3.7730555555555556,Document
Vue,293,495,836.0256250000001,MERGED,59,53,5,4,4,380,True,0,4,3,1011,112,16.513333333333332,Bug
Go,54,353,740.0602199074074,MERGED,0,7,1,0,1,73,True,0,0,0,984,7,12.9675,Document
PHP,1334,2960,4213.19238425926,CLOSED,4,5,1,0,1,1,False,0,0,0,1504,9,0.010833333333333334,Document
TypeScript,2147,14722,1478.243136574074,MERGED,15,29,2,0,1,686,False,0,0,0,2012,44,0.6305555555555555,Bug
Rust,264,5382,411.97973379629633,MERGED,81,72,1,0,1,236,True,0,0,0,1808,153,119.53611111111111,Feature
TypeScript,261,3765,681.7141550925926,MERGED,1,43,2,0,1,870,True,0,0,0,2001,44,0.12666666666666668,Document
Vue,293,495,835.6758101851851,CLOSED,2,6,2,4,1,162,True,1,3,3,790,8,24.641666666666666,Bug
Erlang,2054,12122,3802.0231018518516,MERGED,27,85,9,2,5,53,False,0,2,1,798,112,9.261666666666667,Document
Rust,433,2229,245.0641087962963,MERGED,65,29,1,1,1,147,False,0,1,1,179,94,8.71,Feature
Vue,293,495,839.5132060185184,MERGED,1,10,1,9,1,260,True,2,7,4,1479,11,56.070277777777775,Bug
JavaScript,5139,7050,1210.616701388889,MERGED,7,12,8,1,5,256,False,0,1,1,1779,19,20.663888888888888,Bug
TypeScript,2147,14722,1482.335787037037,MERGED,52,196,10,0,2,697,False,0,0,0,6441,248,64.26638888888888,Feature
,0,1,51.81321759259259,CLOSED,0,56,1,0,1,4,False,0,0,0,228,56,0.011111111111111112,Feature
Rust,433,2229,242.63532407407408,MERGED,240,95,15,1,4,267,False,0,1,1,880,335,6.064166666666667,Feature
Vue,293,495,838.0191203703704,MERGED,23,40,6,13,8,386,True,3,10,6,1065,63,143.38194444444446,Bug
TypeScript,4,33,769.226875,MERGED,176,234,1,2,3,204,True,1,1,1,75,410,0.08166666666666667,Feature
TypeScript,4,33,769.2153587962963,MERGED,138,321,1,2,1,203,True,1,1,1,75,459,0.25583333333333336,Feature
Go,30,295,356.92528935185186,MERGED,0,29,1,0,1,94,True,0,0,0,1460,29,0.08527777777777777,Feature
C++,2234,23694,2366.8653125,MERGED,5,19,3,2,4,282,False,1,1,1,1737,24,66.92777777777778,Bug
Python,19248,70257,2468.666550925926,CLOSED,10,10,4,2,1,1590,False,2,0,0,224,20,0.3422222222222222,Feature
Python,19248,70257,2469.462002314815,CLOSED,9,12,1,1,2,94,False,1,0,0,210,21,3.8305555555555557,Feature
,0,0,57.686956018518515,CLOSED,0,773,12,0,1,1,True,0,0,0,3222,773,5.103611111111111,Feature
Rust,417,2801,932.2674768518518,MERGED,149,684,9,4,1,15,False,2,2,2,646,833,352.8883333333333,Bug
Python,547,7160,2246.708449074074,MERGED,0,5,1,0,6,19,False,0,0,0,468,5,186.03277777777777,Document
Python,137,75,695.0142824074073,MERGED,8,141840,31,0,29,0,False,0,0,0,2170,141848,1390.285,Document
JavaScript,5139,7050,1209.7715856481482,MERGED,3,9,3,1,3,91,False,0,1,1,1655,12,0.4488888888888889,Document
TypeScript,15,34,498.46875,MERGED,0,95,1,0,5,313,False,0,0,0,323,95,264.3675,Feature
Rust,264,5382,412.7796064814815,CLOSED,1,2,1,0,2,334,False,0,0,0,1343,3,1.6030555555555555,Feature
TypeScript,2147,14722,1479.0172569444446,CLOSED,31,33,4,0,1,166,False,0,0,0,2359,64,46.72277777777778,Bug
Python,19248,70257,2468.742569444444,CLOSED,3,3,1,1,2,1591,False,1,0,0,241,6,0.6958333333333333,Bug
TypeScript,7,6,653.1642939814815,MERGED,2,10,2,1,2,285,False,0,1,1,1306,12,0.17694444444444443,Bug
Go,395,660,1272.8475925925925,MERGED,1,7,1,0,1,93,False,0,0,0,201,8,127.975,Bug
Rust,264,5382,411.9582175925926,MERGED,3,8,5,1,1,407,False,1,0,0,1774,11,0.6511111111111111,Bug
Rust,264,5382,411.88334490740743,MERGED,6,36,7,0,4,158,False,0,0,0,1661,42,2.631111111111111,Feature
TypeScript,261,3765,684.9175694444444,MERGED,106,73,7,0,8,66,False,0,0,0,2473,179,18.80638888888889,Document
TypeScript,178,1359,328.40177083333333,MERGED,6,35,5,2,1,1,False,0,2,2,3228,41,53.35333333333333,Feature
Rust,264,5382,411.17179398148147,MERGED,12,40,2,2,3,157,False,0,2,1,1571,52,14.108333333333333,Feature
Rust,264,5382,410.9184375,MERGED,19,73,7,0,5,332,False,0,0,0,1583,92,25.090833333333332,Feature
Rust,433,2229,246.35820601851853,MERGED,2,8,2,1,1,836,False,0,1,1,290,10,50.36083333333333,Document
JavaScript,5139,7050,1211.967037037037,MERGED,0,29,2,1,2,4,False,0,1,1,2466,29,18.121666666666666,Document
JavaScript,5139,7050,1211.503425925926,MERGED,12,25,3,2,4,81,False,0,2,2,2024,37,33.59388888888889,Bug
Rust,433,2229,243.8600347222222,MERGED,2,0,1,1,1,828,False,0,1,1,210,2,1.2375,Feature
Rust,264,5382,411.14386574074075,MERGED,2,15,3,0,2,405,False,0,0,0,1372,17,0.5308333333333334,Bug
Rust,264,5382,411.02545138888894,MERGED,1,5,3,0,1,3,False,0,0,0,1552,6,1.0138888888888888,Bug
Rust,264,5382,409.97414351851853,MERGED,192,72,14,0,1,93,True,0,0,0,1351,264,43.691944444444445,Feature
TypeScript,261,3765,684.5451504629629,MERGED,71,103,8,0,3,160,False,0,0,0,2847,174,2.703333333333333,Document
Rust,264,5382,410.88540509259263,MERGED,1,11,5,0,2,0,False,0,0,0,1258,12,2.0519444444444446,Feature
Vue,293,495,837.7905787037038,MERGED,16,196,3,27,11,164,True,8,19,7,1327,212,75.77388888888889,Bug
TypeScript,2147,14722,1478.8363773148149,MERGED,11,340,6,2,3,0,False,1,1,1,2597,351,71.565,Bug
TypeScript,7,6,654.0134722222223,MERGED,1,99,3,0,8,211,False,0,0,0,2433,100,147.19027777777777,Document
PHP,1334,2960,4213.190914351852,CLOSED,4,5,1,1,1,0,False,0,1,1,1659,9,0.2972222222222222,Document
TypeScript,2147,14722,1480.1596990740743,MERGED,38,28,2,0,1,164,False,0,0,0,2634,66,1.3483333333333334,Feature
PHP,1334,2960,4213.077696759259,MERGED,3,4,1,0,1,45,False,0,0,0,1625,7,2.6261111111111113,Document
C++,2234,23694,2364.6752430555557,MERGED,6,41,3,1,1,276,False,0,1,1,1446,47,23.74888888888889,Feature
JavaScript,5139,7050,1213.8963888888889,MERGED,21,966,17,6,9,0,False,2,4,3,529,987,280.71777777777777,Feature
TypeScript,15,34,499.5870717592593,MERGED,2,4,2,0,2,935,False,0,0,0,288,6,100.5338888888889,Bug
PHP,883,2338,1840.1177430555556,CLOSED,2,11,3,2,1,65,False,0,2,2,1775,13,41.835277777777776,Document
Go,421,1654,1517.235335648148,CLOSED,0,0,0,2,0,13,False,0,2,1,2663,0,116.1525,Bug
TypeScript,261,3765,683.6801157407408,MERGED,2,9,2,0,2,188,False,0,0,0,2266,11,0.9055555555555556,Document
TypeScript,7,6,651.1236111111111,MERGED,6,15,1,0,2,15,False,0,0,0,1568,21,1.215,Feature
Vue,293,495,838.0845486111111,MERGED,1,1,1,2,2,375,False,0,2,2,1226,2,24.440833333333334,Bug
TypeScript,7,6,652.1771412037037,MERGED,14,59,5,0,61,13,True,0,0,0,2263,73,191.2447222222222,Feature
Python,547,7160,2247.662766203704,MERGED,1,1,1,2,1,277,True,1,1,1,456,2,0.07416666666666667,Bug
TypeScript,2071,16638,1252.9300578703703,MERGED,1,1,1,0,1,0,False,0,0,0,2610,2,423.5047222222222,Document
TypeScript,7046,76149,2638.836516203704,MERGED,6983,9,151,3,1,105,False,0,3,2,1871,6992,0.12916666666666668,Feature
TypeScript,1416,21916,291.48868055555556,MERGED,33,97,6,3,3,68,False,0,3,3,439,130,0.6347222222222222,Feature
V,2097,34361,1561.2779166666667,MERGED,13,5,1,2,1,34,False,1,1,1,1216,18,3.685,Feature
JavaScript,8844,63474,4085.288240740741,MERGED,1,303,10,6,4,92,True,2,4,2,3772,304,337.39472222222224,Feature
Java,450,746,4082.0560532407403,MERGED,11,20,1,1,2,28,False,0,1,1,604,31,0.5586111111111111,Document
Java,450,746,4081.2682175925925,MERGED,6,3,2,1,3,145,False,0,1,1,1404,9,19.476111111111113,Bug
TypeScript,307,2556,544.7084375000001,MERGED,1,3,1,1,1,179,True,0,1,1,1094,4,1.3233333333333333,Feature
Python,547,7160,2246.7986458333335,MERGED,27,172,8,0,4,275,True,0,0,0,1158,199,0.3527777777777778,Bug
Go,395,660,1273.0157291666667,MERGED,1,5,1,0,1,45,False,0,0,0,199,6,0.26694444444444443,Feature
TypeScript,15,34,500.6540625,MERGED,22,42,4,0,4,167,False,0,0,0,264,64,2.721111111111111,Feature
TypeScript,261,3765,682.737650462963,MERGED,64,159,4,0,4,94,True,0,0,0,2643,223,2.839166666666667,Document
TypeScript,261,3765,682.7222453703704,MERGED,8,8,8,0,1,214,True,0,0,0,2470,16,0.3111111111111111,Document
Rust,264,5382,408.9520949074074,MERGED,249,240,3,0,1,397,False,0,0,0,1435,489,0.47805555555555557,Bug
TypeScript,15,34,499.47815972222224,CLOSED,1417,74,31,0,2,476,True,0,0,0,296,1491,44.83888888888889,Feature
Go,1835,11245,1734.8166087962964,MERGED,59,57,8,0,2,97,False,0,0,0,353,116,20.043333333333333,Feature
Rust,264,5382,411.77125,MERGED,2,2,1,3,2,0,False,1,2,2,492,4,5.049166666666666,Feature
TypeScript,58,78,828.1750462962963,MERGED,190,149,15,1,6,120,False,0,1,1,3819,339,289.3836111111111,Feature
Go,395,660,1271.932488425926,MERGED,3,4,3,0,1,5,False,0,0,0,251,7,23.409444444444443,Document
C++,2234,23694,2362.8406828703705,CLOSED,33,84,3,1,10,274,False,0,1,1,1898,117,23.43,Feature
TypeScript,42,46,779.0500231481482,MERGED,2,1,1,1,1,84,False,0,1,1,386,3,0.0625,Feature
Go,395,660,1271.9107291666667,MERGED,3,20,4,1,2,90,False,1,0,0,314,23,170.72194444444443,Bug
TypeScript,15,34,496.42365740740746,CLOSED,1,1,1,1,1,312,False,1,0,0,235,2,10.327222222222222,Feature
Go,30,295,357.35925925925926,MERGED,13,18,2,0,1,106,True,0,0,0,1989,31,0.10416666666666667,Bug
TypeScript,2147,14722,1477.861539351852,MERGED,25,92,3,0,1,668,False,0,0,0,3239,117,7.5744444444444445,Document
Vue,293,495,837.0645717592593,MERGED,0,2,1,3,1,374,False,0,3,3,1546,2,0.1297222222222222,Bug
Go,30,295,357.13886574074075,MERGED,32,22,2,1,1,104,True,0,1,1,1805,54,0.1338888888888889,Feature
Go,395,660,1272.0677083333333,MERGED,6,11,3,0,1,92,False,0,0,0,387,17,146.64333333333335,Bug
Vue,293,495,836.8414467592593,MERGED,6,9,1,3,1,373,False,0,3,3,1609,15,0.2936111111111111,Bug
Go,395,660,1271.9149421296295,MERGED,2,2,1,0,1,91,False,0,0,0,242,4,0.11555555555555555,Feature
V,2097,34361,1559.745300925926,MERGED,1,0,1,0,1,1,False,0,0,0,1367,1,12.555,Document
TypeScript,202,107,1155.6495023148148,MERGED,1,58,2,4,2,149,True,0,4,4,2182,59,91.67722222222223,Document
Go,395,660,1271.8230092592592,MERGED,49,50,1,0,2,89,False,0,0,0,239,99,2.3425,Feature
TypeScript,202,107,1155.6237962962962,MERGED,4,28,4,6,6,0,False,0,6,5,1879,32,92.25138888888888,Document
TypeScript,7,6,652.0727430555555,MERGED,5,86,4,0,2,16,False,0,0,0,2577,91,118.19944444444444,Feature
TypeScript,15,34,499.49362268518513,MERGED,31,20,6,0,1,934,False,0,0,0,387,51,0.045,Bug
Go,54,353,739.8736689814815,MERGED,57,189,14,3,1,210,True,2,1,1,1258,246,24.30388888888889,Feature
TypeScript,261,3765,681.4886342592592,MERGED,5,20,7,0,1,869,True,0,0,0,2692,25,0.2427777777777778,Document
TypeScript,15,34,499.09611111111116,MERGED,29,23,2,0,6,931,False,0,0,0,423,52,10.591111111111111,Bug
Vue,293,495,836.0989699074074,MERGED,3,11,1,4,1,372,False,0,4,3,1540,14,17.025555555555556,Bug
Vue,293,495,835.971863425926,MERGED,203,16,5,3,2,378,True,0,3,3,989,219,17.752777777777776,Bug
Starlark,440,286,498.07177083333335,MERGED,38,91,1,1,1,127,True,1,0,0,452,129,0.020833333333333332,Feature
TypeScript,15,34,496.46719907407413,MERGED,187,525,36,0,47,165,False,0,0,0,440,712,233.40944444444443,Bug
Go,395,660,1271.1438194444445,MERGED,3,13,1,0,1,337,False,0,0,0,206,16,0.1738888888888889,Feature
Go,395,660,1271.0408217592592,MERGED,1,13,1,0,3,88,False,0,0,0,198,14,0.8119444444444445,Feature
TypeScript,41368,87412,2946.023391203704,MERGED,1,1,1,0,1,0,False,0,0,0,1200,2,1.341388888888889,Document
Go,395,660,1276.3217824074075,MERGED,30,28,9,0,3,119,False,0,0,0,473,58,42.31777777777778,Feature
Vue,293,495,839.7704282407408,MERGED,41,92,11,7,5,0,False,0,7,5,1885,133,75.11944444444444,Bug
TypeScript,307,2556,545.4863541666667,MERGED,4,0,1,7,1,181,True,2,5,2,1018,4,28.015,Bug
C++,2234,23694,2364.0195833333332,MERGED,62,142,10,2,6,275,False,1,1,1,2517,204,135.03944444444446,Bug
Go,395,660,1273.1665856481482,MERGED,248,473,10,0,9,50,False,0,0,0,572,721,336.4838888888889,Bug
TypeScript,202,107,1150.3691550925926,MERGED,34,48,1,4,2,148,True,0,4,4,1891,82,12.135833333333334,Document
TypeScript,7,6,653.1103125,MERGED,21,55,6,5,3,210,False,1,4,2,2530,76,0.29083333333333333,Feature
TypeScript,15,34,497.0431018518518,MERGED,19,118,7,0,13,927,False,0,0,0,378,137,34.93527777777778,Feature
TypeScript,202,107,1149.8311574074075,CLOSED,30662,48,2,5,4,147,True,1,4,4,1645,30710,12.924166666666666,Document
Erlang,2054,12122,3802.2180902777777,MERGED,1,3,1,0,1,54,False,0,0,0,486,4,16.422777777777778,Feature
Rust,264,5382,411.19184027777777,CLOSED,1,22,3,5,2,235,True,2,3,2,2195,23,21.775555555555556,Bug
C++,2234,23694,2365.9336458333332,CLOSED,15,40,3,1,8,279,False,0,1,1,2228,55,16.941388888888888,Bug
TypeScript,307,2556,544.8234606481482,MERGED,1,1,1,1,1,17,False,0,1,1,1009,2,15.573611111111111,Bug
JavaScript,5139,7050,1212.5071180555556,MERGED,4,56,5,3,4,257,False,1,2,2,3214,60,31.008055555555554,Document
Rust,264,5382,411.1080787037037,MERGED,20,11,3,3,1,140,False,3,0,0,2259,31,16.676944444444445,Feature
TypeScript,2071,16638,1250.2999421296297,CLOSED,115,128,3,0,4,1,False,0,0,0,4684,243,1614.0572222222222,Document
Go,395,660,1273.0947685185185,MERGED,19,61,3,0,1,81,False,0,0,0,263,80,0.16527777777777777,Feature
TypeScript,58,78,830.3596759259259,MERGED,7,166,9,1,6,185,True,0,1,1,4226,173,65.96111111111111,Feature
Vue,293,495,836.5683796296297,MERGED,3,6,2,7,6,258,True,0,7,4,1690,9,152.2761111111111,Bug
Rust,433,2229,241.7844675925926,MERGED,153,315,3,1,3,815,False,0,1,1,356,468,2.698611111111111,Bug
TypeScript,41368,87412,2946.8291435185183,MERGED,1,1,1,2,1,0,False,0,2,1,2086,2,0.5019444444444444,Document
TypeScript,15,34,497.52888888888884,CLOSED,173,2014,39,0,40,131,False,0,0,0,671,2187,286.9213888888889,Bug
C++,2234,23694,2364.707060185185,MERGED,10,10,2,1,4,277,False,0,1,1,2451,20,46.35888888888889,Bug
PHP,1334,2960,4213.84869212963,MERGED,12,12,4,2,3,47,False,1,1,1,3013,24,4.376944444444445,Document
Erlang,2054,12122,3805.144722222222,MERGED,1007,1054,26,5,17,58,False,1,4,2,1324,2061,270.8672222222222,Document
Go,395,660,1271.8794444444445,MERGED,20,18,3,0,4,4,False,0,0,0,340,38,27.65222222222222,Bug
Go,395,660,1271.9176273148148,MERGED,33,22,2,0,1,25,False,0,0,0,267,55,23.18111111111111,Bug
TypeScript,2147,14722,1481.9909837962962,CLOSED,38,44,2,1,1,292,False,0,1,1,3778,82,95.17694444444444,Document
TypeScript,15,34,495.5967708333333,CLOSED,684,819,544,1,4,926,False,0,1,1,323,1503,47.7925,Feature
TypeScript,69,2215,319.74274305555554,CLOSED,265,516,9,2,32,25,False,2,0,0,775,781,332.1430555555556,Document
Python,547,7160,2245.727476851852,MERGED,4,17,5,0,3,273,True,0,0,0,470,21,0.050833333333333335,Bug
Go,395,660,1271.469675925926,MERGED,0,6,1,0,1,80,False,0,0,0,248,6,35.6725,Document
TypeScript,1297,21107,425.5933564814815,MERGED,0,16,1,1,1,952,True,0,1,1,1564,16,0.008888888888888889,Document
JavaScript,5139,7050,1212.617002314815,MERGED,20,880,15,5,8,0,False,2,3,2,493,900,99.03861111111111,Feature
Rust,433,2229,247.42231481481483,MERGED,7,72,6,1,1,839,False,0,1,1,530,79,28.26527777777778,Feature
TypeScript,15,34,499.14800925925925,MERGED,3,3,2,0,1,933,False,0,0,0,448,6,6.664444444444444,Feature
TypeScript,15,34,495.91489583333333,MERGED,0,18,1,0,4,45,False,0,0,0,318,18,18.664166666666667,Document
V,2097,34361,1561.5107523148147,MERGED,5,5,1,0,1,19,False,0,0,0,1908,10,32.56027777777778,Document
TypeScript,15,34,499.1182523148148,MERGED,13,20,1,0,2,932,False,0,0,0,454,33,0.6441666666666667,Bug
JavaScript,5139,7050,1211.1800578703703,MERGED,42,88,24,3,8,55,False,0,3,3,3638,130,34.7625,Bug
Rust,433,2229,243.57731481481483,MERGED,246,306,49,1,1,827,False,0,1,1,396,552,0.4083333333333333,Feature
JavaScript,5139,7050,1210.980787037037,MERGED,72,127,6,4,4,80,False,1,3,3,2906,199,38.07222222222222,Feature
Rust,433,2229,246.48431712962963,MERGED,46,127,8,1,1,838,False,0,1,1,687,173,50.780833333333334,Feature
C++,2234,23694,2364.985671296296,CLOSED,23,83,12,2,2,541,False,1,1,1,2546,106,333.7472222222222,Feature
Python,547,7160,2244.0969097222223,MERGED,70,86,4,0,28,8,False,0,0,0,549,156,33.7925,Bug
Go,395,660,1271.0552199074075,MERGED,6,11,3,0,1,24,False,0,0,0,307,17,20.124444444444446,Feature
TypeScript,41368,87412,2942.8872453703702,MERGED,5,0,1,0,1,44,True,0,0,0,1509,5,0.47,Document
C#,80,125,829.9586574074074,MERGED,1656,11060,295,0,18,196,False,0,0,0,531,12716,66.71527777777777,Document
TypeScript,85,722,323.4462962962963,MERGED,5,49,4,0,6,6,False,0,0,0,4540,54,109.61638888888889,Document
JavaScript,5139,7050,1209.5826041666667,MERGED,4,148,8,3,8,95,False,1,2,2,3390,152,73.77083333333333,Bug
Go,395,660,1271.0215393518517,MERGED,6,22,3,0,2,87,False,0,0,0,305,28,1.7230555555555556,Feature
Erlang,2054,12122,3800.89099537037,MERGED,70,151,9,3,2,365,True,1,2,1,1635,221,66.49222222222222,Document
TypeScript,41368,87412,2943.652685185185,MERGED,1,1,1,3,1,1591,True,1,2,1,1976,2,0.5705555555555556,Document
Vue,293,495,837.8405208333334,MERGED,9,24,2,4,4,299,True,0,4,3,1748,33,0.8194444444444444,Bug
Vue,293,495,837.5488773148148,MERGED,4,53,6,5,2,259,True,0,5,4,1683,57,8.568055555555556,Bug
JavaScript,9664,43889,3663.1315509259257,MERGED,157,134,16,0,1,81,False,0,0,0,442,291,21.971666666666668,Feature
Erlang,2054,12122,3800.838912037037,MERGED,22,23,15,2,2,162,False,0,2,1,1396,45,6.553055555555556,Document
Rust,264,5382,408.7562962962963,MERGED,10,10,2,0,1,396,False,0,0,0,2272,20,0.5808333333333333,Bug
Erlang,2054,12122,3800.41880787037,MERGED,38,91,11,2,4,139,False,0,2,1,1096,129,179.45583333333335,Document
Rust,433,2229,241.89019675925928,MERGED,43,110,8,1,5,816,False,0,1,1,470,153,0.5641666666666667,Bug
Python,547,7160,2247.740347222222,MERGED,43,34,1,0,1,279,True,0,0,0,639,77,0.012222222222222223,Bug
TypeScript,58,78,827.1364699074074,MERGED,24,265,13,1,6,182,True,0,1,1,3368,289,74.76861111111111,Bug
Python,547,7160,2247.679849537037,MERGED,6,18,1,0,3,278,True,0,0,0,640,24,0.45916666666666667,Bug
TypeScript,85,722,324.0460185185185,MERGED,2,11,2,1,2,1,False,1,0,0,4434,13,23.135833333333334,Document
JavaScript,9664,43889,3663.0090625,MERGED,22,32,4,0,2,80,False,0,0,0,378,54,1.888611111111111,Feature
JavaScript,9664,43889,3667.239710648148,MERGED,3,108,3,0,1,627,False,0,0,0,557,111,0.3025,Bug
Rust,433,2229,245.42256944444443,MERGED,65,141,7,0,1,833,False,0,0,0,602,206,8.344166666666666,Feature
TypeScript,15,34,496.3903356481481,MERGED,804,1216,556,0,16,311,False,0,0,0,395,2020,12.030833333333334,Bug
Rust,433,2229,245.0835532407407,MERGED,241,270,10,1,1,149,False,0,1,1,486,511,7.123611111111111,Bug
Java,547,304,235.82546296296297,MERGED,0,15,1,0,7,4,False,0,0,0,1085,15,30.169444444444444,Feature
Go,182,37,1716.0255671296297,MERGED,0,767,8,7,10,445,False,7,0,0,2622,767,126.54472222222222,Document
JavaScript,9664,43889,3664.830821759259,MERGED,16,774,12,0,10,310,True,0,0,0,585,790,54.61944444444445,Feature
TypeScript,58,78,826.1089699074074,MERGED,51,18,7,1,3,119,False,0,1,1,3789,69,59.721944444444446,Bug
JavaScript,9664,43889,3664.155405092593,MERGED,35,13,4,0,2,190,True,0,0,0,519,48,71.095,Feature
Starlark,440,286,497.9669791666667,CLOSED,1,1,1,1,1,31,False,0,1,1,935,2,214.21194444444444,Bug
TypeScript,41368,87412,2945.6633333333334,MERGED,0,1,1,0,1,1596,True,0,0,0,1907,1,1.3727777777777779,Document
TypeScript,41368,87412,2945.619456018518,CLOSED,1,0,1,2,1,32,False,1,1,1,2104,1,1.7125,Document
Go,1835,11245,1734.741909722222,MERGED,4,25,1,0,1,94,False,0,0,0,1684,29,115.7775,Document
TypeScript,17,33,724.9126157407408,MERGED,24,93,11,1,2,39,False,0,1,1,443,117,47.14194444444445,Bug
TypeScript,1297,21107,425.82005787037036,MERGED,262,222,49,1,25,953,True,0,1,1,3343,484,170.52416666666667,Document
TypeScript,15,34,499.48763888888885,MERGED,1,6,2,0,1,315,False,0,0,0,581,7,1.2161111111111111,Bug
TypeScript,2147,14722,1480.0444212962964,MERGED,64,183,10,0,1,689,False,0,0,0,4953,247,0.5888888888888889,Document
TypeScript,15,34,499.0584143518518,MERGED,31,52,4,0,1,930,False,0,0,0,633,83,8.556944444444444,Feature
Rust,264,5382,413.08769675925925,CLOSED,8,13,2,2,1,142,False,2,0,0,2484,21,64.68222222222222,Document
Rust,433,2229,243.37767361111113,MERGED,98,64,13,1,1,823,False,0,1,1,713,162,0.8519444444444444,Bug
Rust,264,5382,411.0177430555555,MERGED,95,823,6,6,1,403,False,6,0,0,2549,918,150.5825,Feature
Go,30,295,357.3460648148148,MERGED,4,142,4,0,1,105,True,0,0,0,2615,146,0.08611111111111111,Bug
Rust,264,5382,410.7688773148148,MERGED,11,165,10,0,3,330,False,0,0,0,3303,176,151.72444444444446,Bug
TypeScript,4,33,773.4261458333334,MERGED,509,3507,111,2,74,387,True,0,2,2,1148,4016,592.9491666666667,Document
Starlark,440,286,495.8966087962963,CLOSED,0,309,6,2,3,0,False,1,1,1,2390,309,1495.4105555555554,Document
JavaScript,9664,43889,3663.704571759259,MERGED,0,286,11,0,1,309,True,0,0,0,663,286,1.2952777777777778,Document
TypeScript,15,34,497.7509953703704,MERGED,18,75,6,0,3,166,False,0,0,0,553,93,33.812777777777775,Feature
TypeScript,41368,87412,2944.0939930555555,MERGED,1,1,1,0,1,424,True,0,0,0,2113,2,8.0825,Document
TypeScript,2147,14722,1478.8257986111112,CLOSED,33,87,5,0,1,69,False,0,0,0,3988,120,8.8225,Bug
TypeScript,202,107,1155.1493287037038,MERGED,3,6,2,5,4,127,False,1,4,4,1098,9,103.13027777777778,Document
TypeScript,41368,87412,2943.7170138888887,MERGED,4,2,1,0,1,0,False,0,0,0,2114,6,0.4363888888888889,Document
TypeScript,15,34,497.577962962963,MERGED,14,20,7,0,3,928,False,0,0,0,561,34,0.9441666666666667,Feature
JavaScript,9664,43889,3667.447210648148,MERGED,0,86,2,0,2,0,False,0,0,0,709,86,107.34861111111111,Feature
TypeScript,307,2556,546.6272453703704,MERGED,5,67,5,6,4,182,True,3,3,2,5274,72,168.825,Feature
V,2097,34361,1560.5940972222222,MERGED,1,28,1,2,5,0,False,1,1,1,2620,29,151.58972222222224,Document
Rust,433,2229,241.5410300925926,MERGED,89,101,7,0,1,812,False,0,0,0,644,190,0.3725,Document
TypeScript,261,3765,685.792349537037,MERGED,14,36,13,0,2,880,True,0,0,0,3474,50,65.23083333333334,Document
TypeScript,41368,87412,2942.739212962963,MERGED,1,1,1,0,2,1900,True,0,0,0,2070,2,3.450833333333333,Document
Go,30,295,355.14195601851856,MERGED,272,17,5,0,2,102,True,0,0,0,2865,289,0.09027777777777778,Feature
JavaScript,5139,7050,1212.8521296296296,MERGED,15,206,13,2,7,182,False,0,2,2,3653,221,87.26388888888889,Document
TypeScript,41368,87412,2948.1031944444444,CLOSED,2,2,1,7,3,197,False,3,4,3,2536,4,11.499444444444444,Document
TypeScript,41368,87412,2942.4954976851855,MERGED,0,5,1,0,2,43,True,0,0,0,1840,5,0.9525,Document
JavaScript,5139,7050,1214.586574074074,CLOSED,33,4185,5,1,5,0,False,0,1,1,5198,4218,2.0705555555555555,Document
TypeScript,2071,16639,1253.8692824074074,MERGED,4,33,3,0,2,75,True,0,0,0,3042,37,400.9886111111111,Document
TypeScript,2071,16639,1250.7168518518517,CLOSED,3375,3437,5,1,3,0,False,0,1,1,2472,6812,9.5275,Document
Go,30,295,355.0554050925926,MERGED,1,2,1,3,1,101,True,1,2,1,1068,3,0.35833333333333334,Bug
Erlang,2054,12122,3805.022916666667,MERGED,2,2,1,0,1,56,False,0,0,0,852,4,1.8458333333333334,Document
TypeScript,15,34,495.5573611111111,MERGED,19,17,2,0,3,925,False,0,0,0,475,36,27.217222222222222,Bug
V,2097,34361,1561.818425925926,MERGED,4,50,7,2,6,190,True,1,1,1,3077,54,38.78388888888889,Bug
TypeScript,3989,23861,2836.0956828703706,MERGED,0,81,2,1,6,61,False,0,1,1,734,81,75.40555555555555,Feature
Starlark,440,286,498.80623842592587,MERGED,1,1,1,0,1,128,True,0,0,0,952,2,0.017222222222222222,Bug
V,2097,34361,1561.5674768518518,MERGED,26,45,2,2,5,35,True,1,1,1,1992,71,44.840833333333336,Document
TypeScript,1297,21107,425.95859953703706,MERGED,214,336,19,2,1,954,True,0,2,2,3142,550,0.16194444444444445,Document
TypeScript,7,6,650.0739699074074,MERGED,7,107,4,0,10,13,False,0,0,0,2960,114,73.43138888888889,Feature
TypeScript,41368,87412,2944.457662037037,MERGED,15,727,9,0,34,114,False,0,0,0,4252,742,695.7644444444444,Document
JavaScript,5139,7050,1212.6124189814816,MERGED,4,407,9,2,2,53,False,1,1,1,3503,411,24.511388888888888,Feature
TypeScript,0,0,162.99156250000001,MERGED,26,239,14,2,18,5,False,1,1,1,5232,265,217.44833333333332,Document
TypeScript,41368,87412,2944.8046527777774,MERGED,143,144,26,0,7,1904,True,0,0,0,2530,287,14.734444444444444,Document
Erlang,2054,12122,3803.9246527777777,MERGED,28,60,5,2,4,486,True,0,2,1,1533,88,16.99972222222222,Document
TypeScript,2071,16639,1249.0113078703705,MERGED,1,1,1,0,1,0,False,0,0,0,2184,2,1.9483333333333333,Document
JavaScript,5139,7050,1211.8508449074075,MERGED,16,519,10,3,2,52,False,1,2,2,5027,535,42.676944444444445,Feature
Rust,264,5382,409.89929398148143,MERGED,4,74,4,1,2,401,False,1,0,0,3162,78,3.863611111111111,Feature
Rust,433,2229,245.06273148148148,MERGED,26,26,4,1,1,145,False,0,1,1,1194,52,7.621111111111111,Bug
TypeScript,41368,87412,2946.771643518519,MERGED,28,98,6,5,8,0,False,1,4,2,2482,126,65.92305555555555,Document
TypeScript,307,2556,546.4858912037038,MERGED,7,9,3,3,2,566,True,0,3,3,2095,16,94.88138888888889,Bug
TypeScript,4,33,771.5111111111111,MERGED,0,3,1,1,1,58,False,0,1,1,933,3,11.001388888888888,Feature
TypeScript,41368,87412,2946.5738888888886,MERGED,5,5,3,2,8,10,False,1,1,1,2966,10,72.46333333333334,Document
JavaScript,9664,43889,3665.9535300925927,MERGED,11,152,3,0,7,311,True,0,0,0,856,163,24.918333333333333,Document
Erlang,2054,12122,3802.9883449074073,MERGED,6,83,1,0,1,55,False,0,0,0,697,89,0.22444444444444445,Document
TypeScript,41368,87412,2945.498182870371,MERGED,2,6,2,6,11,3,False,2,4,4,2221,8,103.22805555555556,Document
TypeScript,41368,87412,2944.4930439814816,MERGED,35,6465,9,3,17,115,False,2,1,1,4434,6500,383.7375,Document
Erlang,2054,12122,3802.246539351852,MERGED,1,7,2,0,1,132,False,0,0,0,796,8,14.307222222222222,Document
TypeScript,41368,87412,2945.040115740741,MERGED,26,19,2,0,9,9,False,0,0,0,2876,45,105.40555555555555,Document
TypeScript,41368,87412,2942.9166550925925,CLOSED,38,7,1,1,1,1901,True,0,1,1,3059,45,21.976111111111113,Document
C++,2234,23694,2362.802835648148,MERGED,17,1,3,2,8,10,False,1,1,1,922,18,22.335277777777776,Feature
TypeScript,41368,87412,2946.827094907407,MERGED,4,4,2,0,2,1905,True,0,0,0,2432,8,4.486666666666666,Document
Java,450,746,4081.1584259259257,MERGED,3,2,1,0,1,378,True,0,0,0,1045,5,0.03611111111111111,Feature
Rust,433,2229,243.48569444444445,MERGED,41,83,6,1,6,826,False,0,1,1,668,124,0.6211111111111111,Document
TypeScript,184,377,1920.1168055555556,MERGED,0,3,2,1,4,28,False,0,1,1,4332,3,282.02166666666665,Document
Erlang,2054,12122,3801.1856944444444,MERGED,2,3,2,0,2,42,False,0,0,0,821,5,18.566666666666666,Document
TypeScript,1297,21107,422.6696064814815,MERGED,5,7,1,1,1,42,False,0,1,1,2231,12,0.29138888888888886,Document
TypeScript,41368,87412,2946.0738657407405,MERGED,94,79,1,2,5,428,True,1,1,1,2459,173,13.099444444444444,Document
Python,2407,12180,245.6109837962963,MERGED,1,1,1,1,1,70,True,0,1,1,1198,2,2.8333333333333335,Bug
TypeScript,41368,87412,2945.639328703704,MERGED,121,32,3,2,5,426,True,2,0,0,2372,153,5.618888888888889,Document
TypeScript,41368,87412,2945.80943287037,MERGED,2,2,1,0,2,427,True,0,0,0,2271,4,0.6269444444444444,Document
TypeScript,1297,21107,421.99940972222225,MERGED,91,128,19,1,3,940,True,0,1,1,2693,219,0.8566666666666667,Document
Java,450,746,4078.969652777778,MERGED,32,155,5,1,4,144,False,0,1,1,2912,187,30.284166666666668,Bug
TypeScript,149,2900,385.4907638888889,MERGED,12,205,5,1,7,174,True,0,1,1,1506,217,20.020833333333332,Document
C#,80,125,827.5086921296296,MERGED,274,29,20,0,1,159,True,0,0,0,780,303,2.7691666666666666,Document
Java,450,746,4078.007789351852,MERGED,23,38,4,1,5,27,False,0,1,1,995,61,77.22527777777778,Bug
TypeScript,41368,87412,2945.023587962963,MERGED,1,3,1,0,2,48,False,0,0,0,2601,4,19.51361111111111,Document
TypeScript,85,722,322.1416435185185,MERGED,7527,66060,590,0,48,94,False,0,0,0,6047,73587,353.67,Document
TypeScript,1297,21107,421.6239004629629,MERGED,27,71,12,1,8,939,True,0,1,1,2904,98,1.2508333333333332,Document
TypeScript,1297,21107,421.5805671296296,MERGED,14,141,6,1,2,938,True,0,1,1,2665,155,0.041944444444444444,Document
C#,80,125,825.7387384259259,MERGED,10,12,2,0,1,79,False,0,0,0,938,22,66.71888888888888,Document
TypeScript,41368,87412,2943.590127314815,CLOSED,202,117,8,2,12,1,False,0,2,1,2519,319,73.11527777777778,Document
Vue,0,1,253.00704861111112,MERGED,0,6,1,0,1,62,False,0,0,0,997,6,0.5005555555555555,Bug
JavaScript,5139,7050,1209.5746643518519,CLOSED,8,171,6,1,19,94,False,0,1,1,4695,179,0.18055555555555555,Bug
C#,80,125,825.9803587962964,MERGED,321,975,165,0,17,80,False,0,0,0,902,1296,40.49055555555555,Document
Rust,433,2229,241.58020833333333,MERGED,33,67,4,1,1,813,False,0,1,1,719,100,0.7036111111111111,Feature
TypeScript,41368,87412,2944.4391550925925,MERGED,2,2,2,0,1,82,True,0,0,0,2260,4,0.4975,Document
TypeScript,41368,87412,2944.0723032407404,MERGED,0,2,2,3,11,423,True,2,1,1,2366,2,10.296666666666667,Document
TypeScript,41368,87412,2943.977175925926,MERGED,143,140,1,0,1,422,True,0,0,0,2718,283,11.036944444444444,Document
TypeScript,41368,87412,2943.7814930555555,MERGED,1,2,1,0,3,81,True,0,0,0,2628,3,5.1594444444444445,Document
TypeScript,41368,87412,2943.7677430555555,MERGED,12,21,4,0,4,79,True,0,0,0,2590,33,15.928888888888888,Document
TypeScript,15,34,495.5476157407407,MERGED,104,46769,16,0,6,924,False,0,0,0,848,46873,48.98,Feature
TypeScript,41368,87412,2943.8421875,MERGED,0,3,1,0,1,1594,True,0,0,0,2122,3,2.578888888888889,Document
Python,137,75,691.2083796296297,MERGED,0,252,9,0,11,0,False,0,0,0,2095,252,665.4805555555556,Document
Starlark,440,286,499.20732638888893,MERGED,0,221,2,0,1,1,False,0,0,0,1608,221,184.4897222222222,Feature
TypeScript,41368,87412,2943.7978356481485,MERGED,2,2,2,0,2,421,True,0,0,0,2482,4,0.11555555555555555,Document
TypeScript,41368,87412,2943.726006944444,MERGED,2,38,2,0,2,1592,True,0,0,0,2662,40,0.6691666666666667,Document
TypeScript,41368,87412,2943.5875462962963,MERGED,0,2,2,3,6,420,True,2,1,1,2302,2,2.3605555555555555,Document
TypeScript,41368,87412,2943.6596180555553,MERGED,2,2,1,0,1,0,False,0,0,0,2457,4,0.8666666666666667,Document
TypeScript,41368,87412,2942.503402777778,MERGED,2,12,2,2,1,29,False,1,1,1,2856,14,46.42444444444445,Document
Java,547,304,235.22030092592593,MERGED,0,35,1,0,11,3,False,0,0,0,1202,35,10.226666666666667,Feature
Java,547,304,235.2725810185185,MERGED,0,14,1,0,1,0,False,0,0,0,1273,14,8.9775,Feature
Java,547,304,235.28221064814815,MERGED,0,44,1,0,2,0,False,0,0,0,1609,44,8.771944444444445,Document
TypeScript,41368,87412,2943.4199421296294,MERGED,2,2,1,4,2,31,False,1,3,3,2435,4,0.5588888888888889,Document
TypeScript,2147,14722,1481.9466203703705,MERGED,243,332,12,0,4,166,False,0,0,0,5247,575,73.93777777777778,Bug
Erlang,2054,12122,3805.574722222222,MERGED,28,55,12,0,1,8,False,0,0,0,1324,83,145.21583333333334,Document
TypeScript,41368,87412,2943.0310532407407,MERGED,1,55,3,0,2,1588,True,0,0,0,3131,56,8.336666666666666,Document
Java,547,304,234.73611111111111,MERGED,0,30,1,0,4,0,False,0,0,0,1276,30,21.816111111111113,Document
C#,80,125,826.495949074074,MERGED,13,1135,54,1,33,36,False,1,0,0,1064,1148,383.8561111111111,Document
TypeScript,41368,87412,2942.7736574074074,MERGED,2,2,2,0,3,77,True,0,0,0,2966,4,0.5552777777777778,Document
Java,547,304,235.92202546296298,MERGED,0,3,1,0,6,5,False,0,0,0,1072,3,40.484722222222224,Feature
TypeScript,41368,87412,2942.722974537037,MERGED,1,1,1,0,1,76,True,0,0,0,2323,2,0.3975,Document
TypeScript,41368,87412,2942.614548611111,MERGED,4,4,2,0,2,1587,True,0,0,0,2869,8,0.5419444444444445,Document
TypeScript,41368,87412,2942.485243055555,MERGED,9,13,2,4,2,1586,True,1,3,2,2823,22,1.9202777777777778,Document
Go,54,353,742.9253703703704,MERGED,140,251,14,0,4,212,True,0,0,0,6372,391,172.90805555555556,Feature
TypeScript,41368,87412,2942.445162037037,MERGED,1,2,1,0,1,1585,True,0,0,0,2364,3,0.49944444444444447,Document
Erlang,2054,12122,3806.8378240740744,CLOSED,13,70,5,1,5,0,False,1,0,0,1504,83,61.76722222222222,Document
Erlang,2054,12122,3805.339606481481,MERGED,114,239,22,0,4,1004,True,0,0,0,1533,353,68.66805555555555,Document
Starlark,440,286,501.09858796296294,MERGED,0,455,3,0,2,1,False,0,0,0,1299,455,41.765,Document
TypeScript,178,1359,330.32958333333335,MERGED,110,212,7,3,2,37,True,1,2,2,6522,322,7.443611111111111,Bug
Erlang,2054,12122,3804.124548611111,MERGED,6,5,4,0,1,7,False,0,0,0,1188,11,149.39888888888888,Document
TypeScript,7,6,654.2306365740741,MERGED,126,206,3,0,8,17,False,0,0,0,5383,332,69.51194444444444,Feature
Erlang,2054,12122,3805.3788078703706,MERGED,4,49,6,1,3,335,False,1,0,0,1363,53,91.40166666666667,Document
Erlang,2054,12122,3804.270219907407,MERGED,12,14,8,0,1,133,False,0,0,0,937,26,134.73416666666665,Document
Starlark,440,286,500.0705208333333,MERGED,3,3,2,0,4,6,False,0,0,0,1435,6,66.34833333333333,Document
Erlang,2054,12122,3805.001400462963,MERGED,46,490,4,1,2,367,True,1,0,0,1092,536,74.71,Document
TypeScript,178,1359,330.7275925925926,MERGED,37,327,13,5,6,14,True,2,3,2,6485,364,25.4675,Feature
Erlang,2054,12122,3806.1129282407405,MERGED,20,247,6,0,2,370,True,0,0,0,1343,267,41.44444444444444,Document
Erlang,2054,12122,3805.419236111111,MERGED,17,9,5,0,1,59,False,0,0,0,1005,26,59.99722222222222,Document
Erlang,2054,12122,3805.107395833333,MERGED,21,46,2,0,2,57,False,0,0,0,931,67,73.30638888888889,Document
TypeScript,3392,2334,978.8227546296297,MERGED,38,106,3,2,3,0,False,0,2,1,2327,144,409.9486111111111,Feature
Erlang,2054,12122,3804.844780092593,MERGED,1,289,3,2,3,366,True,1,1,1,1142,290,78.43055555555556,Document
Erlang,2054,12122,3802.2027430555554,MERGED,0,6,1,0,1,368,True,0,0,0,1127,6,9.908611111111112,Document
Erlang,2054,12122,3804.1152777777775,MERGED,277,408,7,1,4,332,False,1,0,0,1338,685,97.79944444444445,Document
Starlark,440,286,500.16803240740745,CLOSED,0,455,3,3,1,0,False,3,0,0,1221,455,21.03472222222222,Document
TypeScript,7,6,654.2095833333334,MERGED,63,63,8,0,2,287,False,0,0,0,5093,126,0.8713888888888889,Feature
Go,30,295,355.33001157407404,MERGED,31,275,3,0,7,103,True,0,0,0,4429,306,43.16583333333333,Document
HTML,11809,87637,162.65637731481482,CLOSED,0,1,1,0,1,1,False,0,0,0,1058,1,87.30388888888889,Feature
HTML,11809,87637,162.63979166666667,CLOSED,1,1,1,0,1,0,False,0,0,0,965,2,87.70166666666667,Bug
Go,30,295,355.95372685185185,MERGED,24,40,3,1,1,93,True,0,1,1,4124,64,0.3352777777777778,Feature
Starlark,440,286,499.3252777777778,MERGED,1,1,1,1,1,12,False,1,0,0,1371,2,11.953333333333333,Bug
TypeScript,2147,14722,1480.8420833333332,MERGED,30,61,3,0,1,51,False,0,0,0,7390,91,2.3536111111111113,Bug
TypeScript,85,722,323.4092824074074,MERGED,84,627,45,0,2,82,False,0,0,0,7048,711,14.979722222222222,Document
TypeScript,261,3765,685.7500694444444,MERGED,1055,3403,34,0,3,189,False,0,0,0,5663,4458,3.825,Document
Erlang,2054,12122,3804.1888078703705,MERGED,4,94,4,1,1,333,False,0,1,1,1217,98,21.462777777777777,Document
Go,421,1654,1516.0876273148149,MERGED,173,472,12,0,1,436,True,0,0,0,5910,645,216.44083333333333,Document
C#,80,125,826.9044097222222,MERGED,134,359,6,1,9,181,False,1,0,0,1256,493,184.33416666666668,Document
Erlang,2054,12122,3803.955613425926,MERGED,64,303,6,0,4,365,True,0,0,0,1181,367,27.63388888888889,Document
Starlark,440,286,498.2950231481482,CLOSED,1,5,1,0,1,55,False,0,0,0,1474,6,8.220833333333333,Bug
Starlark,440,286,497.9640625,MERGED,3,2,1,0,2,11,False,0,0,0,1489,5,25.633333333333333,Feature
Starlark,440,286,497.8915509259259,MERGED,15,15,2,0,4,8,False,0,0,0,1113,30,27.365,Bug
TypeScript,4,33,772.6018171296296,MERGED,45,92,11,1,2,194,False,0,1,1,1577,137,0.3811111111111111,Feature
Erlang,2054,12122,3802.266875,MERGED,107,871,48,0,1,43,False,0,0,0,1299,978,65.56083333333333,Document
Erlang,2054,12122,3803.3216435185186,MERGED,151,226,35,0,28,331,False,0,0,0,1553,377,12.566666666666666,Document
JavaScript,0,0,0.019872685185185184,CLOSED,2,14,3,1,3,0,False,1,0,0,1331,16,96.02416666666667,Document
TypeScript,85,722,322.15075231481484,MERGED,289,653,58,0,2,81,False,0,0,0,6845,942,17.508055555555554,Document
Erlang,2054,12122,3802.4886111111114,MERGED,0,35,2,0,1,6,False,0,0,0,1247,35,48.56777777777778,Document
TypeScript,4,33,772.146087962963,MERGED,35,43,4,2,4,209,True,1,1,1,1117,78,0.18333333333333332,Bug
TypeScript,4,33,772.1041898148147,MERGED,4,4,1,2,1,208,True,1,1,1,1425,8,0.058611111111111114,Bug
Rust,264,5382,410.9931828703704,MERGED,19,56,16,0,1,178,False,0,0,0,3536,75,2.1355555555555554,Feature
Erlang,2054,12122,3802.8380787037036,MERGED,49,109,6,0,4,478,False,0,0,0,1249,158,27.065,Document
TypeScript,3392,2334,977.2179166666666,MERGED,1,1,1,1,1,323,False,0,1,1,1326,2,0.11666666666666667,Bug
TypeScript,3392,2334,977.1892129629629,MERGED,1,194,3,1,4,322,False,0,1,1,1781,195,0.6127777777777778,Feature
Erlang,2054,12122,3802.4449074074073,MERGED,3,3,3,1,1,329,False,1,0,0,1041,6,40.82833333333333,Document
TypeScript,3392,2334,977.1294675925925,MERGED,5,2,1,1,1,114,False,0,1,1,1848,7,0.125,Feature
TypeScript,3392,2334,977.0946527777778,MERGED,4,52,5,2,3,455,False,0,2,1,1868,56,0.5913888888888889,Feature
JavaScript,34,25,204.90364583333334,MERGED,4,10,1,4,2,7,False,2,2,2,1715,14,98.11833333333334,Feature
Python,2407,12180,247.78553240740743,MERGED,2,76,1,1,3,132,True,0,1,1,1582,78,4.894722222222223,Document
TypeScript,1297,21107,422.9016550925926,CLOSED,348,2574,10,2,3,2,False,0,2,2,4057,2922,45.94916666666666,Document
Rust,264,5382,408.9860185185185,MERGED,19,71,10,2,4,328,False,2,0,0,3584,90,73.1575,Bug
TypeScript,85,722,321.9345138888889,MERGED,73,76,11,0,2,156,False,0,0,0,7231,149,2.2058333333333335,Document
TypeScript,7046,76149,2638.8072337962963,MERGED,34,7248,146,3,1,104,False,0,3,2,5112,7282,0.29777777777777775,Document
Go,54,353,741.3447569444444,MERGED,18,96,3,1,3,22,False,0,1,1,3943,114,30.04388888888889,Feature
Erlang,2054,12122,3802.7014467592594,MERGED,5,24,4,0,2,364,True,0,0,0,1236,29,0.8077777777777778,Document
Python,2407,12180,246.72114583333334,MERGED,69,50,2,0,11,131,True,0,0,0,1598,119,30.46472222222222,Feature
TypeScript,261,3765,683.7525347222222,MERGED,47,47,31,0,2,590,True,0,0,0,5660,94,0.33194444444444443,Document
TypeScript,85,722,321.01479166666667,MERGED,25,713,15,0,10,155,False,0,0,0,6649,738,23.221666666666668,Document
Python,137,75,691.4529282407407,MERGED,11,21,3,0,1,214,False,0,0,0,1395,32,0.2941666666666667,Bug
JavaScript,8844,63474,4083.201597222222,MERGED,13,14,2,0,3,2,True,0,0,0,4283,27,24.106944444444444,Feature
TypeScript,307,2556,544.7164351851852,MERGED,14,174,6,1,1,180,True,0,1,1,4061,188,42.513333333333335,Bug
Erlang,2054,12122,3802.1647569444444,MERGED,0,3,1,0,1,367,True,0,0,0,1067,3,10.830277777777777,Document
TypeScript,3392,2334,976.161238425926,MERGED,8,16,2,2,2,453,False,0,2,1,1532,24,0.48305555555555557,Feature
Python,2407,12180,246.6950347222222,MERGED,1,1,1,0,2,259,True,0,0,0,1591,2,14.587222222222222,Document
Erlang,2054,12122,3800.6377662037034,MERGED,0,4476,12,3,4,484,True,1,2,2,1256,4476,72.2,Document
Erlang,2054,12122,3801.813773148148,MERGED,3,23,4,0,2,363,True,0,0,0,1340,26,21.023611111111112,Document
Rust,433,2229,243.4407175925926,MERGED,126,401,10,1,11,825,False,0,1,1,975,527,27.336944444444445,Document
TypeScript,3392,2334,976.0744212962964,MERGED,1,1,1,1,1,321,False,0,1,1,1199,2,0.5433333333333333,Feature
Erlang,2054,12122,3802.0769444444445,MERGED,2,2,2,0,1,327,False,0,0,0,1200,4,7.323333333333333,Document
TypeScript,41368,87412,2948.107928240741,MERGED,4,7,2,1,1,11,False,0,1,1,3732,11,0.7838888888888889,Document
TypeScript,3392,2334,976.0239583333333,MERGED,0,7,1,1,1,320,False,0,1,1,1340,7,1.4605555555555556,Feature
Python,2407,12180,246.3675115740741,MERGED,4,2,1,0,3,71,True,0,0,0,1137,6,22.554166666666667,Feature
TypeScript,3392,2334,975.9521180555556,MERGED,2,0,1,2,1,452,False,0,2,1,1497,2,0.19166666666666668,Feature
TypeScript,2071,16639,1248.1052546296296,CLOSED,3,12,3,1,1,0,False,0,1,1,3615,15,25.80361111111111,Bug
TypeScript,140,827,754.2524884259259,MERGED,0,39,1,2,1,101,False,0,2,2,1214,39,1.0294444444444444,Document
TypeScript,202,107,1152.004826388889,MERGED,2268,78,26,5,3,120,True,1,4,4,4829,2346,36.85861111111111,Document
Java,547,304,237.09406249999998,CLOSED,0,0,0,1,4,9,False,1,0,0,2157,0,12.35,Document
TypeScript,149,2900,386.91425925925927,MERGED,2,2,2,1,1,91,False,0,1,1,1652,4,0.07,Document
Rust,264,5382,409.0282060185186,MERGED,2,75,6,0,1,398,False,0,0,0,3931,77,17.525555555555556,Feature
TypeScript,3392,2334,974.2095023148148,CLOSED,1,5,1,4,1,0,False,1,3,2,1764,6,54.96,Bug
Go,54,353,740.8594212962963,MERGED,2,1547,11,0,2,211,True,0,0,0,4432,1549,0.48138888888888887,Feature
Go,421,1654,1517.061064814815,MERGED,219,45,10,0,2,438,True,0,0,0,6601,264,45.084722222222226,Document
Python,2407,12180,246.2136226851852,MERGED,13,7,6,0,8,257,True,0,0,0,1234,20,1.875,Document
Java,547,304,236.14670138888889,MERGED,0,28,1,0,2,8,False,0,0,0,2157,28,11.828333333333333,Document
TypeScript,3392,2334,975.2878935185186,MERGED,11,11,1,1,1,112,False,0,1,1,1398,22,0.1947222222222222,Feature
TypeScript,3989,23861,2834.2883101851853,MERGED,71,510,25,3,10,243,True,0,3,3,4188,581,1508.695,Document
TypeScript,4,33,769.2456365740741,MERGED,29,109,13,2,20,205,True,1,1,1,1379,138,22.306944444444444,Feature
TypeScript,3392,2334,975.0993518518518,MERGED,0,7,1,1,2,319,False,0,1,1,1383,7,0.5447222222222222,Feature
Erlang,2054,12122,3801.0825,MERGED,1,1,1,0,1,326,False,0,0,0,1110,2,2.808333333333333,Document
Erlang,2054,12122,3801.002951388889,MERGED,1,1,1,0,1,362,True,0,0,0,1113,2,0.2997222222222222,Document
TypeScript,149,2900,385.48050925925924,MERGED,0,2,1,2,2,173,True,0,2,1,1632,2,20.771944444444443,Feature
Python,2407,12180,245.60277777777776,MERGED,1,2,1,0,2,69,True,0,0,0,1125,3,3.025,Bug
TypeScript,3392,2334,973.4849421296295,MERGED,7,15,4,2,1,0,False,0,2,1,2366,22,334.46166666666664,Bug
TypeScript,7046,76149,2636.5005439814818,MERGED,19905,12685,25,3,1,102,False,0,3,2,5537,32590,0.13972222222222222,Document
Java,547,304,234.1571990740741,MERGED,0,9,1,0,10,562,False,0,0,0,1632,9,306.3644444444444,Document
TypeScript,41368,87412,2946.1015277777774,MERGED,46,73,6,0,6,10,False,0,0,0,3792,119,16.29861111111111,Document
Java,547,304,234.18723379629628,MERGED,0,17,1,0,3,1,False,0,0,0,1792,17,97.50527777777778,Document
Java,547,304,235.0445138888889,MERGED,0,11,1,0,1,18,False,0,0,0,1792,11,14.439444444444444,Document
TypeScript,3392,2334,974.0959722222223,MERGED,0,7,1,1,1,318,False,0,1,1,1180,7,1.0186111111111111,Feature
Java,547,304,234.86474537037034,MERGED,0,28,1,1,3,1,False,1,0,0,1652,28,18.73638888888889,Document
Java,547,304,233.13953703703703,MERGED,0,5,1,0,12,561,False,0,0,0,1730,5,330.61944444444447,Document
Java,547,304,233.13387731481484,MERGED,0,4,1,0,10,559,False,0,0,0,1759,4,330.83472222222224,Document
TypeScript,41368,87412,2946.036053240741,CLOSED,126,57,11,4,5,9,False,2,2,1,3977,183,1.461111111111111,Document
Java,450,746,4079.215081018519,MERGED,3,1,2,0,1,35,False,0,0,0,1585,4,1.113611111111111,Feature
TypeScript,41368,87412,2944.7120601851852,MERGED,11,29,4,11,4,9,True,5,6,3,3236,40,49.028333333333336,Document
TypeScript,4,33,768.3065856481481,MERGED,9,15,7,2,1,599,True,1,1,1,1541,24,0.07611111111111112,Bug
Java,547,304,234.05511574074072,MERGED,0,16,1,0,1,17,False,0,0,0,1530,16,2.5108333333333333,Document
Java,547,304,232.26952546296297,MERGED,0,46,1,0,1,0,False,0,0,0,1644,46,15.05861111111111,Document
Starlark,440,286,501.4943055555555,MERGED,1,8,1,0,1,56,False,0,0,0,1814,9,32.27611111111111,Document
Java,547,304,232.93831018518517,MERGED,0,11,1,0,2,0,False,0,0,0,1582,11,15.463888888888889,Feature
Java,547,304,233.14724537037037,MERGED,0,17,1,0,1,16,False,0,0,0,1703,17,0.34055555555555556,Document
TypeScript,3392,2334,978.1867824074075,CLOSED,5,7,1,3,1,0,False,0,3,2,2286,12,1.041111111111111,Feature
Java,547,304,233.13590277777777,MERGED,0,4,1,0,13,560,False,0,0,0,1770,4,35.680277777777775,Document
Java,547,304,232.14518518518517,MERGED,0,5,1,1,7,557,False,0,1,1,1737,5,0.25166666666666665,Document
TypeScript,41368,87412,2944.838946759259,MERGED,16,20,4,3,3,10,True,1,2,2,3377,36,17.810277777777777,Document
Vue,0,1,252.09238425925926,MERGED,5,19,1,0,2,59,False,0,0,0,1505,24,0.2816666666666667,Feature
Java,547,304,232.15542824074075,MERGED,0,8,1,0,15,558,False,0,0,0,1746,8,7.135833333333333,Document
TypeScript,3392,2334,972.9455092592593,MERGED,36,0,1,1,1,108,False,0,1,1,1345,36,0.2891666666666667,Feature
TypeScript,3392,2334,977.4423958333333,MERGED,15,0,2,3,1,0,False,0,3,2,2013,15,107.495,Bug
TypeScript,4,33,767.4987268518518,MERGED,21,25,1,1,2,180,False,0,1,1,1503,46,0.4116666666666667,Bug
TypeScript,41368,87412,2944.694837962963,MERGED,17,17,1,0,1,0,False,0,0,0,3478,34,2.201111111111111,Document
TypeScript,41368,87412,2944.4728356481482,MERGED,16,240,7,1,2,1902,True,1,0,0,3746,256,1.0425,Document
Python,2407,12180,247.58962962962963,CLOSED,2,3,1,10,3,21,False,5,5,1,1790,5,149.43722222222223,Document
TypeScript,41368,87412,2943.829178240741,MERGED,26,314,10,0,2,1593,True,0,0,0,4162,340,2.8880555555555554,Document
Python,2407,12180,249.00878472222223,MERGED,4,16,2,13,4,0,False,5,8,2,1711,20,89.55555555555556,Document
Starlark,440,286,500.3747685185185,CLOSED,0,166,2,1,2,0,False,1,0,0,1881,166,0.13722222222222222,Feature
Python,2407,12180,248.96258101851853,MERGED,44,1053,24,10,26,267,True,10,0,0,1910,1097,90.77388888888889,Document
TypeScript,41368,87412,2943.5823263888888,MERGED,274,298,4,3,2,78,True,2,1,1,3677,572,0.7041666666666667,Document
HTML,11809,87637,162.65894675925927,CLOSED,0,5,1,0,1,2,False,0,0,0,1399,5,87.24222222222222,Feature
Erlang,2054,12122,3804.151284722222,MERGED,24,141,10,0,3,369,True,0,0,0,1629,165,88.49555555555555,Document
TypeScript,41368,87412,2943.631724537037,MERGED,2,10,3,0,1,1590,True,0,0,0,3208,12,0.5430555555555555,Document
TypeScript,41368,87412,2943.4540856481485,MERGED,16,429,8,0,1,419,True,0,0,0,3706,445,3.3116666666666665,Document
Go,2083,11769,1525.3237615740743,CLOSED,1,258,3,1,1,2,False,0,1,1,1669,259,0.003611111111111111,Document
TypeScript,149,2900,390.808287037037,MERGED,4,15,1,1,1,98,False,0,1,1,2014,19,0.059166666666666666,Feature
Erlang,2054,12122,3805.235717592592,MERGED,19,63,8,0,7,1003,True,0,0,0,1771,82,12.537777777777778,Document
Go,1835,11245,1734.7032291666667,MERGED,4,6,5,0,6,93,False,0,0,0,1800,10,0.20527777777777778,Bug
TypeScript,41368,87412,2942.490636574074,MERGED,4,23,2,0,2,8,True,0,0,0,3566,27,2.5433333333333334,Document
TypeScript,41368,87412,2942.4335185185187,MERGED,16,41,2,1,1,1584,True,0,1,1,3498,57,1.4288888888888889,Document
JavaScript,5139,7050,1208.967349537037,MERGED,14,1077,10,3,22,54,False,1,2,2,5717,1091,40.37555555555556,Feature
TypeScript,85,722,324.14993055555556,MERGED,96,92,12,0,5,161,False,0,0,0,10356,188,92.73388888888888,Document
JavaScript,8844,63474,4084.562847222222,MERGED,32,342,20,10,25,1,False,3,7,3,8264,374,355.00694444444446,Bug
Java,547,304,234.16543981481482,CLOSED,0,17,1,0,1,0,False,0,0,0,1748,17,0.19583333333333333,Document
Starlark,440,286,498.17249999999996,MERGED,3,4,1,0,1,24,False,0,0,0,1747,7,20.650833333333335,Feature
Go,789,5551,1046.3569791666666,CLOSED,7,1,1,3,1,2,False,1,2,2,2162,8,64.65277777777777,Document
Starlark,440,286,498.0502314814815,MERGED,25,10,1,0,2,46,False,0,0,0,2297,35,23.578333333333333,Feature
Erlang,2054,12122,3803.1974537037036,MERGED,35,98,5,0,4,330,False,0,0,0,1983,133,22.385,Document
TypeScript,202,107,1152.5230671296297,CLOSED,58,431,14,3,1,253,True,0,3,3,6638,489,526.1491666666667,Document
Starlark,440,286,497.9620370370371,MERGED,22,2,1,1,1,125,True,0,1,1,2134,24,0.018055555555555554,Feature
TypeScript,4,33,772.0521527777778,MERGED,6,4,1,2,1,207,True,1,1,1,1730,10,0.03722222222222222,Bug
TypeScript,3392,2334,977.1805092592593,MERGED,15,8,4,2,2,456,False,0,2,1,2086,23,1.0569444444444445,Bug
TypeScript,3392,2334,977.0799305555556,MERGED,1,28,2,2,3,454,False,0,2,1,2053,29,2.8330555555555557,Feature
TypeScript,4,33,771.194837962963,MERGED,187,303,26,1,9,367,False,0,1,1,2348,490,23.54222222222222,Feature
TypeScript,1073,11366,1103.7500578703705,MERGED,2,2,1,1,1,29,True,0,1,1,1933,4,0.06055555555555556,Document
TypeScript,4,33,771.5016203703703,MERGED,16,30,6,0,4,192,False,0,0,0,1960,46,0.04694444444444444,Document
TypeScript,21,40,2293.8975925925924,MERGED,21,124,3,1,3,52,False,0,1,1,1675,145,0.9183333333333333,Document
Go,421,1654,1518.8921180555556,MERGED,56,229,9,1,4,85,False,0,1,1,9562,285,121.94833333333334,Document
TypeScript,4,33,771.1554861111111,MERGED,4,15,1,2,2,206,True,1,1,1,1921,19,0.07333333333333333,Document
Python,2407,12180,245.90949074074072,MERGED,1,1,1,4,3,1,False,2,2,1,1793,2,8.165833333333333,Document
TypeScript,3392,2334,974.3864467592592,MERGED,17,17,1,3,1,266,False,0,3,2,1906,34,34.20944444444444,Feature
Python,2407,12180,245.76528935185183,CLOSED,1,1,1,1,1,0,False,0,1,1,1839,2,0.10722222222222222,Document
Python,2407,12180,246.21311342592594,MERGED,1,1,1,0,2,256,True,0,0,0,1960,2,0.3236111111111111,Document
Python,2407,12180,246.21162037037038,MERGED,5,0,1,0,5,255,True,0,0,0,1710,5,0.3725,Document
TypeScript,4,33,770.5526388888889,MERGED,67,102,3,1,1,189,False,0,1,1,1744,169,0.04888888888888889,Feature
Vue,293,495,836.8156828703704,MERGED,8854,6739,216,4,345,346,True,0,4,3,1743,15593,0.2577777777777778,Document
Python,2407,12180,245.67370370370372,MERGED,0,2,1,2,2,19,False,1,1,1,1819,2,1.361388888888889,Document
TypeScript,149,2900,385.4506712962963,MERGED,23,155,3,2,3,171,True,1,1,1,1998,178,36.89194444444445,Feature
Python,2407,12180,245.3086111111111,MERGED,11,277,8,1,9,254,True,1,0,0,1989,288,10.140277777777778,Document
TypeScript,3392,2334,974.2283680555556,MERGED,9,62,2,1,3,111,False,0,1,1,1970,71,0.10694444444444444,Bug
TypeScript,4,33,769.6259837962963,MERGED,8,30,4,1,6,186,False,0,1,1,1715,38,0.06111111111111111,Document
TypeScript,4,33,769.5988310185185,MERGED,4,4,1,1,3,185,False,0,1,1,1741,8,0.2247222222222222,Document
TypeScript,4,33,769.4829166666667,MERGED,20,19,11,1,1,184,False,0,1,1,2057,39,0.06333333333333334,Bug
TypeScript,3392,2334,973.9134259259259,MERGED,9,34,3,1,1,110,False,0,1,1,2338,43,0.1786111111111111,Feature
TypeScript,4,33,768.5613078703703,MERGED,27,82,9,1,4,181,False,0,1,1,1810,109,0.1386111111111111,Document
TypeScript,261,3765,683.755011574074,MERGED,791,215,66,0,3,159,False,0,0,0,7339,1006,17.343055555555555,Document
TypeScript,1073,11366,1100.9940509259259,MERGED,34,138,8,1,11,746,True,0,1,1,12970,172,67.96111111111111,Feature
TypeScript,3392,2334,972.9083912037037,MERGED,1,13,1,1,1,107,False,0,1,1,1897,14,0.08694444444444445,Feature
TypeScript,3392,2334,972.8838425925925,MERGED,9,9,1,1,1,106,False,0,1,1,2155,18,0.03888888888888889,Bug
TypeScript,3392,2334,972.8531597222222,MERGED,4,10,1,1,1,105,False,0,1,1,2342,14,0.21805555555555556,Feature
Rust,591,3260,554.3081365740741,MERGED,27,19,1,1,1,78,False,1,0,0,2137,46,17.74388888888889,Document
Erlang,2054,12122,3801.8130092592596,MERGED,22,44,5,0,2,477,False,0,0,0,2206,66,31.676666666666666,Document
TypeScript,3392,2334,977.3891898148148,MERGED,52,0,2,3,1,0,False,0,3,2,2989,52,240.65333333333334,Feature
Java,547,304,236.16136574074073,MERGED,24,45,1,0,6,2,True,0,0,0,2306,69,258.0775,Document
JavaScript,8844,63474,4087.248449074074,MERGED,67,68,30,3,3,3,True,2,1,1,6586,135,118.17583333333333,Bug
JavaScript,8844,63474,4087.2900810185183,MERGED,174,526,9,0,8,94,True,0,0,0,5999,700,99.97694444444444,Document
TypeScript,218,1201,2935.145243055556,MERGED,5,6,3,4,2,168,True,4,0,0,1651,11,1.1205555555555555,Feature
Python,137,75,695.2095949074073,MERGED,0,358,8,0,35,7,False,0,0,0,3226,358,821.1422222222222,Document
Java,547,304,234.60444444444445,MERGED,0,8,1,0,11,563,False,0,0,0,2598,8,13.575,Document
TypeScript,261,3765,685.7046412037038,MERGED,20015,2642,177,0,11,879,True,0,0,0,4490,22657,0.9466666666666667,Document
Rust,264,5382,413.24901620370366,MERGED,0,62,8,0,1,2,False,0,0,0,7369,62,70.04833333333333,Feature
TypeScript,184,377,1917.0651851851853,MERGED,2,12,3,0,3,23,False,0,0,0,5432,14,65.13444444444444,Document
TypeScript,3392,2334,977.3532407407407,MERGED,56,19,5,3,1,0,False,0,3,2,2743,75,60.995555555555555,Bug
Go,30,295,356.9353472222222,MERGED,84,106,6,1,1,38,True,0,1,1,6264,190,0.10444444444444445,Document
TypeScript,3392,2334,977.1958101851851,MERGED,31,27,7,2,1,0,False,0,2,1,2684,58,113.43833333333333,Bug
TypeScript,184,377,1919.8893518518519,MERGED,11,28,4,0,2,27,False,0,0,0,5873,39,30.295555555555556,Document
Python,2407,12180,251.76846064814814,MERGED,20,53,4,1,5,268,True,1,0,0,2949,73,23.41638888888889,Document
TypeScript,184,377,1919.8478009259259,MERGED,16,36,4,0,1,26,False,0,0,0,4981,52,26.45777777777778,Document
TypeScript,7,6,654.1751273148149,MERGED,9,180,8,0,1,286,False,0,0,0,5711,189,0.22916666666666666,Feature
Starlark,440,286,500.0551041666667,MERGED,0,134,4,3,1,0,False,3,0,0,2758,134,66.71222222222222,Document
Python,968,6759,66.01030092592593,MERGED,11,14,2,0,2,109,False,0,0,0,2496,25,0.018333333333333333,Document
Python,1912,12140,76.81534722222223,CLOSED,22,57,2,3,2,0,False,0,3,2,3724,79,1662.5269444444446,Feature
TypeScript,1297,21107,427.84872685185184,MERGED,71,79,11,1,1,959,True,0,1,1,5501,150,2.116111111111111,Document
Python,137,75,693.2603356481482,MERGED,0,88,7,0,4,14,False,0,0,0,2767,88,75.2713888888889,Bug
TypeScript,3392,2334,977.3916203703703,MERGED,7,11,3,1,2,324,False,0,1,1,2465,18,85.7675,Bug
V,2097,34361,1562.7189583333331,MERGED,203,807,7,2,4,10,True,0,2,2,5461,1010,2.731388888888889,Document
TypeScript,184,377,1918.1302777777776,MERGED,11,5,1,0,1,24,False,0,0,0,4852,16,18.494722222222222,Document
Starlark,440,286,500.11590277777776,CLOSED,0,103,2,2,1,0,False,2,0,0,2506,103,1.4213888888888888,Feature
TypeScript,41368,87412,2944.7760300925925,MERGED,15,582,10,2,9,15,False,0,2,2,7639,597,39.522777777777776,Document
Erlang,2054,12122,3805.127025462963,MERGED,2,5,1,0,1,334,False,0,0,0,2064,7,6.607222222222222,Document
Starlark,440,286,499.2890277777778,MERGED,0,244,2,0,5,5,False,0,0,0,3103,244,12.97861111111111,Document
TypeScript,1073,11366,1105.105150462963,MERGED,0,21,2,1,1,131,False,0,1,1,2540,21,12.230277777777777,Bug
JavaScript,8844,63474,4083.2384837962964,MERGED,22,82,12,0,4,90,True,0,0,0,5002,104,47.180277777777775,Document
V,2097,34361,1560.7783912037037,MERGED,57,108,1,0,1,34,True,0,0,0,5298,165,25.775277777777777,Document
Starlark,440,286,497.81697916666667,MERGED,51,30,1,0,2,9,False,0,0,0,2609,81,29.137777777777778,Feature
TypeScript,1073,11366,1104.468298611111,MERGED,0,12,5,1,1,749,True,0,1,1,2702,12,12.854444444444445,Feature
Starlark,440,286,497.68249999999995,MERGED,15,29,2,0,2,54,False,0,0,0,2395,44,32.35777777777778,Feature
Starlark,440,286,496.2646990740741,MERGED,0,691,4,1,6,0,False,1,0,0,2591,691,87.49166666666666,Document
Starlark,440,286,497.4320138888889,MERGED,28,31,2,0,2,23,False,0,0,0,2561,59,38.3525,Bug
Rust,264,5382,409.91473379629633,MERGED,19,19,19,0,1,257,True,0,0,0,4561,38,0.48388888888888887,Bug
Rust,264,5382,409.76528935185183,MERGED,188,15,20,0,1,92,True,0,0,0,7335,203,1.7180555555555554,Feature
TypeScript,41368,87412,2948.146377314815,MERGED,219,138,13,1,8,198,False,0,1,1,7695,357,0.3636111111111111,Document
Starlark,440,286,498.0232523148148,MERGED,91,38,1,0,1,126,True,0,0,0,3412,129,0.07166666666666667,Bug
TypeScript,41368,87412,2946.520694444445,MERGED,44,251,9,0,15,16,False,0,0,0,6360,295,69.48388888888888,Document
Go,789,5551,1046.1745717592592,MERGED,8,25,2,1,3,10,False,0,1,1,2335,33,45.125277777777775,Document
Erlang,2054,12122,3802.1131597222225,MERGED,54,60,4,0,2,328,False,0,0,0,2053,114,28.97972222222222,Document
Python,14532,41182,1092.5455092592592,MERGED,1,3,1,10,4,2,False,4,6,2,2629,4,163.35777777777778,Document
Starlark,440,286,497.2816203703704,MERGED,48,22,1,0,21,3,False,0,0,0,3161,70,0.15944444444444444,Document
TypeScript,4,33,771.6848495370369,MERGED,114,83,5,1,6,193,False,0,1,1,2997,197,17.720277777777778,Feature
TypeScript,307,2556,547.7226388888889,MERGED,47,174,8,0,2,183,True,0,0,0,5280,221,0.5616666666666666,Bug
Starlark,440,286,496.97071759259256,MERGED,20,19,1,3,2,70,False,2,1,1,2653,39,0.11055555555555556,Bug
TypeScript,1073,11366,1103.8202430555555,MERGED,3,3,1,1,1,150,False,0,1,1,2279,6,0.12694444444444444,Bug
Python,137,75,691.411099537037,MERGED,540795,540746,71,0,5,213,False,0,0,0,3087,1081541,0.10138888888888889,Document
Go,789,5551,1046.1543055555555,MERGED,4,6,2,0,1,1,False,0,0,0,2270,10,16.91638888888889,Document
Python,2407,12180,246.76086805555556,MERGED,4,6,1,6,3,261,True,3,3,1,2293,10,13.222222222222221,Document
C++,2234,23694,2362.7386111111114,MERGED,43,60,6,0,7,8,False,0,0,0,3591,103,23.875555555555554,Feature
Go,789,5551,1045.5257986111112,MERGED,4,10,6,1,5,0,False,0,1,1,2798,14,14.464722222222223,Document
TypeScript,140,827,754.1690972222223,MERGED,3,818,15,4,26,31,False,1,3,3,5308,821,68.46111111111111,Feature
Python,2407,12180,246.19193287037038,MERGED,2,2,1,2,5,0,False,1,1,1,2122,4,0.9022222222222223,Document
TypeScript,1297,21107,422.6594097222223,MERGED,8,99,8,1,3,945,True,0,1,1,5491,107,0.015555555555555555,Document
Go,2083,11769,1528.7525694444446,MERGED,50,162,4,2,2,1,False,0,2,2,5828,212,31.73138888888889,Document
TypeScript,178,1359,330.97886574074073,MERGED,779,466,16,1,4,19,True,0,1,1,12046,1245,3.4205555555555556,Feature
TypeScript,41368,87412,2945.3035300925926,CLOSED,5,9,4,7,15,2,False,3,4,2,5413,14,4.421111111111111,Document
TypeScript,149,2900,385.4508564814815,MERGED,10,49,8,3,12,172,True,0,3,1,3037,59,22.637777777777778,Bug
TypeScript,41368,87412,2944.4974537037037,MERGED,20,162,6,2,4,1595,True,0,2,2,5381,182,9.751944444444444,Document
TypeScript,3392,2334,973.3142476851853,MERGED,22,37,2,1,1,317,False,0,1,1,3049,59,26.078333333333333,Feature
TypeScript,307,2556,544.6644212962963,MERGED,12,43,12,1,3,16,False,0,1,1,5482,55,19.36111111111111,Bug
TypeScript,3392,2334,973.0636111111112,MERGED,22,55,3,1,2,109,False,0,1,1,3093,77,19.438333333333333,Feature
TypeScript,41368,87412,2944.510555555555,MERGED,374,858,10,0,7,1903,True,0,0,0,5411,1232,2.9516666666666667,Document
Python,14532,41182,1092.5404861111112,CLOSED,1,3,1,0,2,1,False,0,0,0,2483,4,0.0075,Document
Python,14532,41182,1092.1827199074075,CLOSED,1,3,1,6,2,0,False,3,3,1,2498,4,8.530833333333334,Document
Java,450,746,4078.2483796296297,MERGED,16,23,3,1,5,34,False,0,1,1,2989,39,0.43527777777777776,Feature
TypeScript,41368,87412,2943.6252314814815,MERGED,13,39,2,0,3,1589,True,0,0,0,5761,52,1.0425,Document
TypeScript,2147,14722,1479.9269560185185,MERGED,18,78,10,0,2,3,False,0,0,0,9727,96,24.939722222222223,Feature
Python,4515,54980,937.0143518518518,MERGED,74,283,3,5,20,140,False,1,4,1,3806,357,146.37722222222223,Document
Python,14532,41182,1091.5769791666667,MERGED,55,5,5,0,6,1416,True,0,0,0,2889,60,2.147777777777778,Document
TypeScript,261,3765,681.7053009259259,MERGED,1161,283,37,0,9,157,False,0,0,0,10712,1444,210.94861111111112,Document
TypeScript,261,3765,683.7669328703704,MERGED,0,377,18,0,5,252,True,0,0,0,843,377,2.0330555555555554,Document
TypeScript,261,3765,684.8587962962962,MERGED,64,88,17,0,1,878,True,0,0,0,11282,152,14.814166666666667,Document
Starlark,440,286,500.3819675925926,MERGED,0,153,2,0,5,1,False,0,0,0,4356,153,321.3438888888889,Document
Rust,264,5382,412.1110416666667,MERGED,217,3200,59,2,1,141,False,1,1,1,9948,3417,164.0425,Bug
Rust,264,5382,412.9421990740741,MERGED,55,17,5,0,1,98,True,0,0,0,10183,72,120.14083333333333,Bug
Go,421,1654,1517.133310185185,MERGED,886,714,62,0,2,439,True,0,0,0,12923,1600,49.74583333333333,Document
TypeScript,7,6,652.2600810185185,MERGED,58,1486,38,0,40,283,False,0,0,0,8665,1544,133.91222222222223,Feature
TypeScript,261,3765,683.694988425926,MERGED,213,219,34,0,5,875,True,0,0,0,13825,432,0.5730555555555555,Document
Go,421,1654,1516.9335300925925,MERGED,39,211,16,0,3,60,False,0,0,0,10860,250,28.54111111111111,Feature
Python,547,7160,2247.02099537037,MERGED,24,567,26,5,30,2,False,3,2,1,3127,591,327.2161111111111,Bug
Go,421,1654,1515.259039351852,MERGED,237,217,5,0,3,59,False,0,0,0,10726,454,24.461388888888887,Bug
Python,137,75,693.3006134259259,MERGED,0,110,8,0,7,15,False,0,0,0,5080,110,221.84055555555557,Bug
Rust,264,5382,412.13710648148145,MERGED,173,420,38,0,3,159,False,0,0,0,9913,593,21.14,Bug
TypeScript,7,6,652.2365162037037,MERGED,6,866,25,2,7,282,False,1,1,1,8533,872,20.596666666666668,Feature
Rust,264,5382,411.0090277777778,MERGED,66,215,22,0,1,139,False,0,0,0,8235,281,2.633611111111111,Document
Python,968,6759,66.07413194444445,MERGED,14,53,2,0,1,110,False,0,0,0,4114,67,0.013333333333333334,Document
Go,789,5551,1050.0762962962963,MERGED,11,11,1,4,1,4,False,4,0,0,4811,22,47.265,Document
Python,968,6759,66.00131944444445,MERGED,35,139,10,0,3,108,False,0,0,0,4081,174,0.13583333333333333,Document
Rust,264,5382,409.3554398148148,MERGED,62,120,4,0,1,0,False,0,0,0,9112,182,9.700833333333334,Bug
TypeScript,4,33,772.6087847222221,MERGED,645,923,41,1,12,195,False,0,1,1,4176,1568,75.655,Document
JavaScript,3618,9017,2292.571886574074,MERGED,373,936,23,17,25,343,False,7,10,3,12444,1309,306.55083333333334,Bug
TypeScript,140,827,757.3997685185185,MERGED,2,424,5,2,12,32,False,0,2,2,3619,426,110.22833333333334,Feature
TypeScript,149,2900,389.1794791666667,MERGED,41,28,3,1,1,179,True,0,1,1,3499,69,68.63027777777778,Document
Go,789,5551,1049.0621759259259,MERGED,0,104,1,1,1,3,False,1,0,0,2979,104,2.087222222222222,Document
Go,30,295,354.99811342592596,MERGED,41,23,7,1,1,100,True,0,1,1,4095,64,0.13527777777777777,Feature
Starlark,440,286,499.2700115740741,MERGED,2,132,1,0,1,25,False,0,0,0,3290,134,13.285277777777777,Feature
TypeScript,1073,11366,1104.9146759259258,MERGED,8,144,3,1,9,130,False,0,1,1,4179,152,37.299166666666665,Document
Python,14532,41182,1097.7666203703704,MERGED,9,9,8,0,1,1417,True,0,0,0,3623,18,0.15138888888888888,Document
Rust,591,3260,554.341412037037,MERGED,11,52,9,0,2,77,False,0,0,0,4015,63,20.87361111111111,Document
TypeScript,4,33,773.3781250000001,CLOSED,22,2165,48,1,44,385,True,0,1,1,4254,2187,0.48277777777777775,Document
TypeScript,41368,87412,2945.755995370371,MERGED,39,105,19,0,8,1598,True,0,0,0,9172,144,6.1258333333333335,Document
TypeScript,1073,11366,1104.5126967592594,MERGED,8,53,15,1,2,751,True,0,1,1,4720,61,11.798333333333334,Bug
TypeScript,140,827,757.1789351851852,MERGED,12,103,4,2,4,121,False,0,2,2,3626,115,3.7269444444444444,Document
Starlark,440,286,497.8884027777778,MERGED,0,169,2,1,11,10,False,1,0,0,3158,169,27.435,Document
Python,2407,12180,247.9887962962963,MERGED,206,378,92,0,11,266,True,0,0,0,5154,584,0.7786111111111111,Document
Python,2407,12180,247.96871527777776,MERGED,16,49,4,0,3,265,True,0,0,0,4111,65,0.36944444444444446,Document
Starlark,440,286,497.2763078703704,CLOSED,45,25,1,0,18,2,False,0,0,0,3304,70,0.08166666666666667,Document
Python,2407,12180,247.01439814814816,MERGED,6,14,4,2,3,0,False,1,1,1,3950,20,6.914722222222222,Document
Python,2407,12180,246.7341203703704,MERGED,0,20,2,0,6,260,True,0,0,0,4045,20,13.748333333333333,Document
TypeScript,1073,11366,1102.5791435185185,MERGED,8,19,4,1,3,129,False,0,1,1,3026,27,2.063888888888889,Bug
TypeScript,202,107,1155.5728356481482,MERGED,62,62,19,3,1,13,True,0,3,3,7564,124,871.6919444444444,Document
Vue,0,1,253.06140046296298,MERGED,83,166,9,1,4,63,False,1,0,0,3377,249,30.531111111111112,Bug
Go,1835,11245,1736.212071759259,MERGED,4,4008,51,1,1,137,False,0,1,1,5020,4012,155.1025,Document
TypeScript,261,3765,682.7462962962964,MERGED,74,127,6,0,1,873,True,0,0,0,5241,201,1.9466666666666668,Document
TypeScript,149,2900,385.50313657407406,MERGED,94,160,73,1,1,175,True,0,1,1,4501,254,20.211666666666666,Bug
Vue,0,1,252.43680555555557,MERGED,112,108,11,0,13,39,False,0,0,0,3465,220,10.50611111111111,Feature
TypeScript,184,377,1921.145798611111,MERGED,25,16,3,2,2,29,False,0,2,2,11471,41,138.96944444444443,Document
Go,1835,11245,1735.6965046296298,MERGED,14,14,3,0,1,521,False,0,0,0,2994,28,0.8233333333333334,Document
Go,421,1654,1516.2870717592593,MERGED,167,198,10,0,1,437,True,0,0,0,18847,365,18.840833333333332,Document
Rust,264,5382,410.22061342592593,MERGED,52,688,25,0,3,234,True,0,0,0,11383,740,18.860277777777778,Bug
TypeScript,184,377,1919.1480902777778,MERGED,56,75,5,1,9,25,False,1,0,0,6588,131,288.0072222222222,Document
TypeScript,41368,87412,2945.4344791666667,MERGED,686,1403,53,1,10,425,True,1,0,0,11221,2089,0.5625,Document
TypeScript,41368,87412,2944.4019907407405,MERGED,1021,1442,41,0,26,196,False,0,0,0,12767,2463,0.5108333333333334,Document
Python,4515,54980,936.8658333333333,MERGED,2,49,4,0,3,139,False,0,0,0,5119,51,150.12916666666666,Document
Python,4515,54980,936.8139467592592,MERGED,137,157,6,3,5,138,False,1,2,2,6561,294,151.22194444444443,Document
TypeScript,41368,87412,2942.4328472222223,MERGED,597,400,11,5,4,7,True,1,4,3,11164,997,5.173055555555556,Document
Starlark,440,286,500.77697916666665,MERGED,51,86,1,0,1,1,False,0,0,0,5090,137,49.46055555555556,Document
C++,2234,23694,2366.0283912037034,CLOSED,168,15,15,1,6,23,False,1,0,0,7052,183,88.76194444444444,Feature
TypeScript,149,2900,390.81576388888885,MERGED,2666,10105,388,1,119,99,False,0,1,1,5848,12771,1.5841666666666667,Document
Go,789,5551,1048.1934837962963,MERGED,36,133,6,0,1,14,False,0,0,0,5560,169,15.147777777777778,Document
Starlark,440,286,497.36716435185184,CLOSED,0,197,3,3,3,0,False,2,1,1,4831,197,44.81361111111111,Feature
Java,450,746,4081.2310648148145,MERGED,104637,105168,21,1,35,37,False,0,1,1,7942,209805,93.6775,Document
TypeScript,149,2900,386.95503472222225,MERGED,257,646,15,3,5,92,False,1,2,2,5524,903,89.17083333333333,Bug
TypeScript,1073,11366,1104.4961458333335,MERGED,16,64,10,1,1,750,True,0,1,1,6916,80,12.190555555555555,Feature
TypeScript,3392,2334,976.9420949074074,MERGED,177,268,12,1,4,113,False,0,1,1,5555,445,3.102222222222222,Feature
Python,2407,12179,247.31226851851852,MERGED,27,132,13,0,7,263,True,0,0,0,5434,159,0.27694444444444444,Document
TypeScript,1073,11366,1103.7303703703703,MERGED,44,72,5,1,2,28,True,0,1,1,5077,116,0.17722222222222223,Bug
TypeScript,4,33,770.4398263888888,MERGED,52,144,14,0,2,188,False,0,0,0,4562,196,0.09222222222222222,Bug
Vue,0,1,254.31356481481484,MERGED,70,170,12,0,2,194,True,0,0,0,5579,240,0.3488888888888889,Bug
Vue,0,1,254.15322916666665,MERGED,53,92,37,0,1,191,True,0,0,0,5308,145,0.2388888888888889,Bug
Vue,0,1,253.6955671296296,MERGED,99,356,24,0,12,41,False,0,0,0,6611,455,11.243055555555555,Bug
TypeScript,4,33,769.7374189814815,MERGED,58,207,15,1,6,187,False,0,1,1,6000,265,2.4944444444444445,Bug
Python,2407,12179,245.0475810185185,MERGED,64,351,23,1,24,253,True,1,0,0,6872,415,0.9219444444444445,Document
TypeScript,4,33,768.7705439814814,MERGED,185,343,27,1,6,384,True,0,1,1,5624,528,0.17722222222222223,Document
Go,1835,11245,1739.1568634259258,MERGED,115,109,13,0,2,138,False,0,0,0,7279,224,0.7041666666666667,Bug
TypeScript,1297,21107,421.64472222222224,MERGED,14,69,13,3,5,41,False,1,2,2,5754,83,10.452777777777778,Document
Vue,0,1,252.1119097222222,MERGED,89,48,16,0,2,189,True,0,0,0,6432,137,0.17722222222222223,Bug
Vue,0,1,252.04072916666667,MERGED,46,238,18,0,7,188,True,0,0,0,7378,284,1.5255555555555556,Bug
TypeScript,218,1201,2933.3645601851854,MERGED,134,395,9,1,4,86,True,0,1,1,7527,529,49.285833333333336,Document
Rust,264,5382,414.12820601851854,MERGED,255,563,40,1,1,160,False,1,0,0,14305,818,40.423611111111114,Bug
TypeScript,3392,2334,975.9493981481481,MERGED,49707,37637,613,3,105,693,False,1,2,2,11159,87344,261.0397222222222,Bug
Python,4515,54980,936.7131828703704,MERGED,444,480,8,0,5,137,False,0,0,0,7392,924,0.4413888888888889,Document
Starlark,440,286,497.5411458333333,MERGED,162,60,6,0,2,42,False,0,0,0,9303,222,35.74444444444445,Bug
Starlark,440,286,497.2022569444444,MERGED,277,142,8,1,3,81,False,1,0,0,8718,419,42.041666666666664,Feature
Starlark,440,286,497.2679398148148,MERGED,4,843,272,0,2,124,True,0,0,0,7754,847,0.18694444444444444,Feature
C,5529,39706,67.98243055555555,MERGED,102,109,6,17,5,39,True,1,16,11,10531,211,48.743611111111115,Bug
TypeScript,41368,87412,2947.7508564814816,MERGED,3666,3577,454,10,83,21,False,3,7,4,24328,7243,426.2702777777778,Document
TypeScript,1073,11366,1105.005162037037,MERGED,69,459,54,1,26,752,True,0,1,1,14633,528,65.19833333333334,Document
TypeScript,1073,11366,1104.4524421296296,MERGED,0,142,24,1,3,748,True,0,1,1,12564,142,13.231111111111112,Feature
V,2097,34361,1569.679513888889,MERGED,0,10,2,3,3,21,True,2,1,1,495,10,26.249166666666667,Feature
V,2097,34361,1569.8087615740742,CLOSED,0,4,1,4,1,22,True,2,2,1,733,4,25.811666666666667,Bug
Vue,293,495,843.6839004629629,CLOSED,11,121,5,10,6,166,True,4,6,5,1300,132,820.5338888888889,Bug
Python,547,7160,2250.4761574074073,CLOSED,129,51,5,2,4,145,False,2,0,0,501,180,2381.1905555555554,Bug
V,2097,34361,1568.1478240740742,MERGED,0,26,3,0,4,19,True,0,0,0,1163,26,16.42111111111111,Feature
C#,80,125,832.5664236111111,CLOSED,0,4,2,1,3,160,True,0,1,1,406,4,2089.176388888889,Document
V,2097,34361,1569.6333796296296,MERGED,2,2,1,0,1,20,True,0,0,0,508,4,9.543333333333333,Bug
TypeScript,15,34,504.8313425925926,CLOSED,14,144,5,0,2,317,False,0,0,0,549,158,2224.9069444444444,Feature
Vue,293,495,843.5582291666666,MERGED,8,8,2,5,1,378,False,0,5,3,1431,16,30.029722222222222,Bug
TypeScript,2147,14722,1488.1824768518518,MERGED,1,1,1,0,1,709,False,0,0,0,687,2,0.0636111111111111,Bug
TypeScript,2147,14722,1486.9412384259258,MERGED,2,6,1,0,1,707,False,0,0,0,666,8,3.7491666666666665,Bug
TypeScript,2147,14722,1485.8470833333333,MERGED,1,1,1,0,1,701,False,0,0,0,614,2,9.008055555555556,Feature
Vue,293,495,843.8772453703704,MERGED,8,25,3,8,2,57,False,1,7,4,1537,33,22.458333333333332,Bug
Vue,293,495,841.9451967592591,MERGED,2,14,2,6,2,56,False,1,5,3,1552,16,68.75638888888889,Bug
PHP,1334,2960,4219.203842592592,MERGED,4,7,1,3,2,201,False,2,1,1,1196,11,1410.7016666666666,Bug
TypeScript,15,34,504.14980324074077,CLOSED,34577,370,17,1,4,945,False,1,0,0,637,34947,10.139444444444445,Bug
PHP,1334,2960,4219.202141203704,MERGED,20,3,1,3,1,200,False,1,2,2,839,23,1025.9016666666666,Feature
TypeScript,2147,14722,1486.8504976851852,MERGED,1,5,2,0,1,705,False,0,0,0,1296,6,5.9127777777777775,Bug
C#,80,125,832.437488425926,CLOSED,35,5719,21,0,11,175,True,0,0,0,897,5754,2092.2536111111112,Document
TypeScript,2147,14722,1485.9729282407407,MERGED,3,7,2,0,2,703,False,0,0,0,1268,10,6.003611111111111,Bug
Python,137,75,700.9930555555555,MERGED,0,51,4,0,21,2,False,0,0,0,969,51,1782.141388888889,Document
Go,1835,11245,1744.9057407407408,MERGED,20,39,14,0,1,103,False,0,0,0,534,59,0.54,Feature
PHP,1334,2960,4222.971400462963,MERGED,1,1,1,5,1,870,False,0,5,2,844,2,0.2936111111111111,Feature
PHP,1334,2960,4220.146261574074,MERGED,36,41,1,2,8,157,False,1,1,1,765,77,573.9975,Feature
V,2097,34361,1563.842152777778,MERGED,35,50,2,0,5,15,True,0,0,0,3673,85,52.68277777777778,Document
TypeScript,2147,14722,1486.2039930555557,MERGED,13,31,7,0,2,704,False,0,0,0,2570,44,0.5052777777777778,Bug
TypeScript,2147,14722,1485.9354166666665,MERGED,1,7,1,0,1,702,False,0,0,0,644,8,6.852777777777778,Bug
TypeScript,178,1359,338.5800925925926,MERGED,3,5,1,2,1,41,True,0,2,2,765,8,117.39805555555556,Feature
TypeScript,2147,14722,1488.164814814815,MERGED,1,3,1,0,1,171,False,0,0,0,654,4,19.120555555555555,Bug
TypeScript,2147,14722,1488.2222453703705,MERGED,8,0,1,0,1,79,False,0,0,0,719,8,12.045,Feature
TypeScript,3393,2334,980.2565625000001,CLOSED,11,17,2,2,4,268,False,0,2,1,2552,28,2270.1283333333336,Feature
TypeScript,178,1359,337.9238310185185,MERGED,1,1,1,1,1,19,True,0,1,1,779,2,2.43,Bug
TypeScript,2147,14722,1487.0775115740742,MERGED,2,2,1,0,1,170,False,0,0,0,645,4,0.8586111111111111,Feature
TypeScript,2147,14722,1486.8928935185186,MERGED,0,3,1,0,1,671,False,0,0,0,614,3,4.885277777777778,Bug
Go,421,1654,1526.1804050925928,MERGED,387,414,3,0,1,242,False,0,0,0,840,801,164.79444444444445,Bug
TypeScript,178,1359,337.57457175925924,MERGED,1,1,1,1,1,3,False,0,1,1,747,2,0.03361111111111111,Feature
TypeScript,178,1359,337.5024652777778,MERGED,1,6,1,1,1,2,False,0,1,1,931,7,0.0325,Feature
TypeScript,178,1359,337.3334722222222,MERGED,9,3,1,2,1,40,True,0,2,2,974,12,5.737222222222222,Document
TypeScript,2147,14722,1485.1825694444444,MERGED,1,1,1,0,1,171,False,0,0,0,931,2,0.4116666666666667,Bug
Go,421,1654,1523.930821759259,MERGED,1,11,2,0,2,444,True,0,0,0,782,12,224.0236111111111,Bug
TypeScript,41368,87412,2952.8832291666663,MERGED,15,278,9,5,12,30,False,1,4,3,3751,293,1864.9083333333333,Document
TypeScript,2147,14722,1488.0858680555557,MERGED,11,18,3,0,3,53,False,0,0,0,1025,29,1.8127777777777778,Bug
TypeScript,2147,14722,1485.1454745370372,MERGED,5,17,1,0,4,78,False,0,0,0,639,22,0.5236111111111111,Bug
TypeScript,178,1359,335.57009259259263,MERGED,3,3,1,2,1,18,True,0,2,2,1016,6,2.8922222222222222,Bug
Rust,264,5382,418.9039583333333,MERGED,3,5,4,0,2,241,True,0,0,0,999,8,26.484444444444446,Feature
Rust,264,5382,419.0237037037037,MERGED,22,0,1,0,1,108,True,0,0,0,560,22,5.3052777777777775,Feature
TypeScript,7,6,660.8686689814815,MERGED,18,21,3,2,4,26,False,2,0,0,1161,39,261.67083333333335,Feature
Rust,264,5382,419.2509953703704,MERGED,28,13,5,1,2,418,False,1,0,0,736,41,87.48694444444445,Feature
Go,421,1654,1525.2432407407407,MERGED,18,16,1,0,1,62,False,0,0,0,905,34,20.04361111111111,Bug
PHP,1334,2960,4224.469143518519,MERGED,46,70,4,1,11,160,False,0,1,1,2462,116,450.3075,Document
TypeScript,2147,14722,1486.2338425925927,MERGED,1,2,2,0,1,39,False,0,0,0,758,3,12.577777777777778,Feature
TypeScript,85,722,327.9494212962963,MERGED,7,67,6,0,4,2,False,0,0,0,1065,74,23.85361111111111,Document
Rust,264,5382,415.7097800925926,MERGED,14,13,2,1,2,4,False,0,1,1,866,27,98.31472222222222,Feature
TypeScript,85,722,332.1049421296296,MERGED,2,2,1,0,1,97,False,0,0,0,1775,4,68.87388888888889,Document
V,2097,34361,1568.5985648148146,MERGED,1,2,1,0,1,202,True,0,0,0,525,3,25.414722222222224,Bug
TypeScript,85,722,328.41300925925924,MERGED,2,2,1,0,1,85,False,0,0,0,1079,4,0.175,Document
TypeScript,2147,14722,1488.0852430555553,MERGED,13,449,8,0,1,708,False,0,0,0,4040,462,136.6225,Document
JavaScript,5139,7050,1219.2851273148149,CLOSED,0,1,1,1,1,0,False,0,1,1,582,1,0.15472222222222223,Feature
Python,137,75,701.338761574074,MERGED,0,261,8,2,30,0,False,0,2,2,1548,261,1864.8577777777778,Bug
TypeScript,85,722,327.8609490740741,MERGED,2,11,2,0,4,83,False,0,0,0,1270,13,6.997222222222222,Document
C++,2234,23694,2371.727465277778,MERGED,1,1,1,1,1,215,False,0,1,1,533,2,3.734166666666667,Bug
TypeScript,2147,14722,1486.9340046296295,MERGED,2,17,6,0,1,706,False,0,0,0,4330,19,3.9144444444444444,Feature
JavaScript,8844,63474,4093.184826388889,MERGED,9,104,8,1,4,104,True,0,1,1,608,113,2.0566666666666666,Bug
TypeScript,2147,14722,1488.860011574074,MERGED,9,9,2,0,2,172,False,0,0,0,1785,18,53.045,Feature
TypeScript,261,3765,692.7058912037037,MERGED,2,0,2,0,1,171,False,0,0,0,1251,2,0.07694444444444444,Document
PHP,1334,2960,4222.936550925926,MERGED,0,2,1,0,2,158,False,0,0,0,806,2,26.0975,Document
TypeScript,261,3765,692.6184606481482,MERGED,4,13,5,0,1,895,True,0,0,0,1645,17,0.24416666666666667,Document
TypeScript,261,3765,692.5373495370371,MERGED,1,8,2,0,3,894,True,0,0,0,1523,9,0.45666666666666667,Document
C++,2234,23694,2373.6988888888886,MERGED,9,55,1,2,2,287,False,1,1,1,748,64,7.163888888888889,Bug
Rust,264,5382,418.9545717592593,MERGED,0,16,1,0,1,262,True,0,0,0,742,16,3.3125,Document
Rust,264,5382,418.7673263888889,CLOSED,99,99,2,2,1,240,True,1,1,1,659,198,0.1411111111111111,Bug
Rust,264,5382,418.2162962962963,MERGED,1,40,2,0,2,416,False,0,0,0,757,41,18.75777777777778,Feature
Python,137,75,700.2571180555556,MERGED,0,55,5,0,11,0,False,0,0,0,1103,55,1527.266388888889,Document
TypeScript,85,722,331.99946759259257,MERGED,0,1,1,0,1,90,False,0,0,0,1211,1,0.06277777777777778,Document
TypeScript,261,3765,691.7850694444445,MERGED,2,5,3,0,1,168,False,0,0,0,1481,7,0.26861111111111113,Document
TypeScript,261,3765,691.7569791666666,MERGED,3,10,3,0,3,167,False,0,0,0,1343,13,0.27111111111111114,Document
TypeScript,261,3765,690.7364351851852,MERGED,120,119,10,0,8,599,True,0,0,0,1284,239,42.61944444444445,Document
TypeScript,261,3765,691.6442824074074,MERGED,1,10,2,0,2,99,True,0,0,0,1424,11,1.583611111111111,Document
C++,2234,23694,2370.021678240741,MERGED,0,38,2,1,2,284,False,0,1,1,531,38,13.890555555555556,Bug
TypeScript,261,3765,691.498912037037,MERGED,2,9,2,0,1,891,True,0,0,0,1351,11,0.08083333333333333,Document
V,2097,34361,1566.7783912037037,MERGED,0,30,2,0,2,197,True,0,0,0,452,30,10.228333333333333,Bug
TypeScript,7,6,661.1402893518518,MERGED,9,2,1,0,2,269,False,0,0,0,1066,11,71.15694444444445,Feature
Rust,264,5382,419.85328703703703,MERGED,95,123,18,0,4,163,False,0,0,0,865,218,69.3975,Bug
TypeScript,15,34,506.2238888888889,MERGED,43,148,14,0,10,171,False,0,0,0,213,191,455.88194444444446,Bug
PHP,1334,2960,4224.0162037037035,MERGED,9,22,3,0,6,159,False,0,0,0,1396,31,124.38277777777778,Document
Rust,264,5382,416.96452546296297,MERGED,15,0,1,0,1,103,True,0,0,0,772,15,0.5166666666666667,Feature
Rust,264,5382,416.7505439814815,CLOSED,1,2,1,0,1,409,False,0,0,0,759,3,4.149444444444445,Bug
Go,30,295,364.20709490740745,MERGED,1,1,1,0,1,111,True,0,0,0,1024,2,0.10305555555555555,Bug
Go,395,660,1279.345625,MERGED,2,2,1,8,3,0,False,4,4,1,313,4,684.7577777777777,Feature
TypeScript,261,3765,689.843900462963,MERGED,1,8,2,0,2,254,True,0,0,0,1492,9,19.901944444444446,Document
Rust,264,5382,415.9898148148148,MERGED,25,54,4,2,1,408,False,1,1,1,695,79,3.6469444444444443,Bug
TypeScript,261,3765,689.8598032407408,MERGED,1,9,2,0,1,193,False,0,0,0,1464,10,0.22777777777777777,Document
Go,421,1654,1526.093564814815,MERGED,44,91,4,2,1,12,False,0,2,1,1676,135,67.29777777777778,Document
Rust,264,5382,419.96741898148144,MERGED,2,1,1,0,1,109,True,0,0,0,1001,3,0.9613888888888888,Feature
TypeScript,261,3765,689.6380555555555,MERGED,0,75,2,0,11,163,False,0,0,0,1315,75,0.5555555555555556,Document
JavaScript,5139,7050,1217.8556944444445,MERGED,0,31,2,2,4,97,False,0,2,2,718,31,21.955555555555556,Document
C++,2234,23694,2369.9660648148147,MERGED,9,10,1,3,3,25,False,1,2,2,598,19,27.005555555555556,Document
TypeScript,2147,14722,1486.1940972222221,MERGED,1,15,3,0,1,169,False,0,0,0,1539,16,0.43555555555555553,Feature
Rust,417,2801,938.0265046296296,MERGED,0,71,1,0,3,206,False,0,0,0,785,71,2.464166666666667,Feature
V,2097,34361,1567.3744444444444,MERGED,1,16,2,0,1,199,True,0,0,0,715,17,5.733888888888889,Bug
V,2097,34361,1567.3931018518517,MERGED,0,1,1,0,1,200,True,0,0,0,574,1,3.077777777777778,Feature
PHP,1334,2960,4220.14244212963,MERGED,15,2,1,0,1,869,False,0,0,0,1750,17,214.13583333333332,Feature
TypeScript,261,3765,688.8037152777778,MERGED,2,12,2,0,2,190,False,0,0,0,1285,14,0.8805555555555555,Document
C++,2234,23694,2373.7241550925924,MERGED,1,12,2,1,1,29,False,0,1,1,862,13,3.9805555555555556,Bug
TypeScript,7,6,659.1037152777777,MERGED,1,2,1,0,5,15,True,0,0,0,868,3,44.26888888888889,Feature
TypeScript,202,107,1159.6175,MERGED,1,1,1,4,3,255,True,0,4,4,989,2,149.13472222222222,Document
TypeScript,2071,16639,1258.5990972222223,MERGED,3,3,1,0,1,0,False,0,0,0,1839,6,287.45416666666665,Bug
Go,30,295,361.54585648148145,MERGED,3,3,1,4,1,109,True,1,3,2,1005,6,17.880277777777778,Feature
TypeScript,2147,14722,1485.0107754629628,MERGED,5,414,3,0,1,170,False,0,0,0,1336,419,0.5672222222222222,Feature
TypeScript,261,3765,692.7355324074074,MERGED,3,8,2,0,1,196,False,0,0,0,1878,11,0.30083333333333334,Document
TypeScript,2147,14722,1485.0116782407406,MERGED,0,4,1,0,1,167,False,0,0,0,1338,4,0.10111111111111111,Feature
JavaScript,5139,7050,1220.8734606481482,MERGED,1,125,4,3,9,83,False,1,2,2,1409,126,65.74527777777777,Feature
Rust,264,5382,418.144224537037,MERGED,0,6,2,1,1,0,False,0,1,1,957,6,3.1566666666666667,Document
JavaScript,8844,63474,4092.188877314815,MERGED,37,60,3,0,2,108,True,0,0,0,1053,97,2.1505555555555556,Bug
Rust,264,5382,418.0238194444444,MERGED,5,27,1,0,1,106,True,0,0,0,1045,32,1.2683333333333333,Feature
Rust,264,5382,418.0087847222222,MERGED,7,15,1,0,1,260,True,0,0,0,862,22,0.5308333333333334,Feature
JavaScript,5139,7050,1221.7184259259259,MERGED,19,20,1,1,10,102,False,0,1,1,1325,39,0.22694444444444445,Document
JavaScript,8844,63474,4091.7708680555556,MERGED,2,2,1,0,1,61,True,0,0,0,926,4,9.620277777777778,Feature
Rust,264,5382,417.7806018518518,MERGED,1,3,2,0,1,104,True,0,0,0,951,4,1.0505555555555555,Feature
JavaScript,8844,63474,4091.493298611111,MERGED,0,21,2,0,1,100,True,0,0,0,1013,21,16.39027777777778,Feature
Rust,264,5382,417.73304398148144,MERGED,10,2,1,0,1,414,False,0,0,0,990,12,0.5197222222222222,Bug
Rust,264,5382,417.24339120370365,MERGED,1,27,4,4,7,0,False,1,3,1,1556,28,333.9436111111111,Bug
TypeScript,261,3765,691.7408449074073,MERGED,20,14,2,0,1,166,False,0,0,0,2353,34,0.04888888888888889,Document
C++,2234,23694,2371.8992013888887,MERGED,2,26,2,1,1,546,False,0,1,1,1087,28,23.296944444444446,Bug
TypeScript,261,3765,691.4852083333334,MERGED,33,119,4,0,2,890,True,0,0,0,2146,152,0.6316666666666667,Document
TypeScript,261,3765,691.4783101851853,MERGED,3,19,3,0,1,195,False,0,0,0,1947,22,0.2086111111111111,Document
Go,421,1654,1523.3077314814816,MERGED,1,8,1,0,1,61,False,0,0,0,1228,9,18.219166666666666,Bug
TypeScript,15,34,503.41170138888884,MERGED,640,1427,28,0,46,134,False,0,0,0,304,2067,548.8108333333333,Feature
JavaScript,5139,7050,1220.8634953703704,MERGED,2,2,2,1,8,100,False,0,1,1,1246,4,0.2075,Document
JavaScript,5139,7050,1220.8397569444444,MERGED,1,178,3,1,5,99,False,0,1,1,1221,179,0.44805555555555554,Document
V,2097,34361,1568.0127314814815,MERGED,103,65,4,0,5,18,True,0,0,0,5234,168,19.69333333333333,Document
TypeScript,261,3765,690.5114930555555,MERGED,12,11,2,0,2,598,True,0,0,0,2200,23,23.2975,Document
PHP,1334,2960,4222.32505787037,MERGED,18,21,1,2,2,202,False,2,0,0,1987,39,190.22583333333333,Document
TypeScript,7,6,658.1106597222223,CLOSED,5,176,7,0,6,14,True,0,0,0,926,181,0.06138888888888889,Feature
JavaScript,5139,7050,1220.198113425926,MERGED,2,98,4,2,6,98,False,1,1,1,1512,100,18.189166666666665,Document
TypeScript,3706,54074,1371.5031597222223,MERGED,188,50,4,0,1,36,True,0,0,0,2852,238,2195.3894444444445,Bug
Rust,264,5382,417.0554513888889,MERGED,0,2,1,0,1,337,False,0,0,0,932,2,0.2461111111111111,Feature
TypeScript,202,107,1160.7026157407406,MERGED,3,5,1,4,3,3,False,0,4,4,1154,8,1.7763888888888888,Document
JavaScript,5139,7050,1216.6655555555556,MERGED,36,41,28,3,5,93,False,1,2,2,1482,77,166.46416666666667,Feature
JavaScript,5139,7050,1216.5527893518517,MERGED,20,404,9,3,5,92,False,1,2,2,1085,424,169.03694444444446,Feature
TypeScript,261,3765,690.6003240740741,MERGED,55,62,4,0,3,141,True,0,0,0,1696,117,1.5786111111111112,Document
PHP,1334,2960,4223.016550925926,MERGED,1,1,1,1,1,66,False,0,1,1,1694,2,143.64388888888888,Document
Rust,264,5382,416.7688078703704,MERGED,0,10,1,0,1,410,False,0,0,0,990,10,2.39,Bug
TypeScript,261,3765,690.5210648148148,MERGED,3,20,5,0,3,215,True,0,0,0,1851,23,2.7822222222222224,Document
Vue,293,495,845.6427546296296,MERGED,7,13,1,3,1,379,False,0,3,3,730,20,4.668611111111111,Bug
TypeScript,261,3765,690.4998726851851,MERGED,2,12,3,0,1,887,True,0,0,0,1835,14,0.3725,Document
TypeScript,202,107,1160.5230787037037,MERGED,2,2,1,3,1,5,True,0,3,3,1039,4,0.09805555555555556,Document
Python,19249,70257,2473.5900578703704,CLOSED,0,391,3,6,7,234,False,4,2,1,366,391,219.73833333333334,Feature
Vue,293,495,844.869525462963,MERGED,8,7,2,11,2,168,True,2,9,5,916,15,23.10472222222222,Bug
V,2097,34361,1567.8028935185184,MERGED,1,12,1,0,1,11,True,0,0,0,896,13,2.2125,Document
Vue,10806,21162,1038.770451388889,MERGED,1,6,1,0,1,180,False,0,0,0,1055,7,2.5372222222222223,Bug
TypeScript,58,78,837.3156365740741,MERGED,2,169,5,1,5,174,False,0,1,1,2265,171,113.99583333333334,Feature
TypeScript,85,722,329.84488425925923,MERGED,0,35,6,0,1,86,False,0,0,0,2309,35,2.566388888888889,Document
TypeScript,178,1359,334.8991550925926,MERGED,2,115,3,2,1,17,True,0,2,2,2304,117,1.2005555555555556,Feature
TypeScript,7,6,660.9873611111111,MERGED,11,18,4,0,14,267,False,0,0,0,2020,29,140.08166666666668,Feature
Vue,10806,21162,1038.1073726851853,MERGED,3,1,1,0,1,179,False,0,0,0,1354,4,18.3525,Document
Go,421,1654,1523.1445138888887,MERGED,3,3,1,0,1,89,False,0,0,0,1273,6,0.6802777777777778,Document
Go,421,1654,1523.1435185185185,MERGED,5,7,2,0,1,88,False,0,0,0,1591,12,0.7005555555555556,Document
Go,421,1654,1523.1424189814816,MERGED,3,3,1,0,1,87,False,0,0,0,1288,6,0.7263888888888889,Document
PHP,1334,2960,4219.248125,MERGED,1,2,1,2,1,170,False,1,1,1,1581,3,89.49444444444444,Document
Rust,264,5382,415.9293171296296,MERGED,0,13,2,0,1,258,True,0,0,0,1052,13,1.6277777777777778,Feature
Go,421,1654,1522.9155208333334,MERGED,8,95,2,1,2,443,True,0,1,1,1234,103,5.641388888888889,Bug
TypeScript,261,3765,689.6352199074073,MERGED,5,8,3,0,4,140,True,0,0,0,1947,13,0.6316666666666667,Document
TypeScript,261,3765,689.5900231481481,MERGED,20,12,1,0,1,885,True,0,0,0,2232,32,1.076111111111111,Document
TypeScript,261,3765,689.5443171296297,MERGED,2,23,6,0,3,191,False,0,0,0,2016,25,2.16,Document
TypeScript,261,3765,689.4961342592593,MERGED,3,19,4,0,1,884,True,0,0,0,2224,22,0.8158333333333333,Document
Go,421,1654,1522.3447337962962,MERGED,4,5,2,1,1,86,False,0,1,1,1532,9,17.5625,Document
Go,421,1654,1524.2139583333335,MERGED,47,164,3,0,3,445,True,0,0,0,2276,211,112.42916666666666,Bug
V,2097,34361,1566.844375,MERGED,1,29,2,0,1,198,True,0,0,0,867,30,8.651388888888889,Bug
Vue,293,495,843.8534606481481,MERGED,0,10,1,6,3,167,True,1,5,4,868,10,22.897222222222222,Bug
TypeScript,2147,14722,1486.0483217592591,MERGED,2,34,4,0,1,102,False,0,0,0,2057,36,4.006111111111111,Document
JavaScript,5139,7050,1218.7389930555555,MERGED,1,12,2,1,4,293,False,0,1,1,1757,13,0.4519444444444444,Document
TypeScript,41368,87412,2952.6338541666664,MERGED,116,285,10,2,13,20,False,0,2,2,4734,401,2137.636388888889,Document
JavaScript,5139,7050,1217.531423611111,MERGED,1,154,5,4,7,97,False,1,3,3,1526,155,48.32472222222222,Feature
V,2097,34361,1566.0166319444445,MERGED,0,22,3,0,1,195,True,0,0,0,781,22,21.53638888888889,Bug
Rust,433,2229,252.4618634259259,MERGED,2,14,2,1,1,862,False,0,1,1,155,16,2.792222222222222,Bug
TypeScript,42,46,786.7026967592592,MERGED,2,2,1,1,2,143,False,0,1,1,169,4,0.04972222222222222,Bug
Go,421,1654,1526.071412037037,CLOSED,14,38,4,0,1,63,False,0,0,0,2154,52,0.013055555555555556,Feature
V,2097,34361,1565.9939814814816,MERGED,2,16,2,0,2,194,True,0,0,0,775,18,11.617222222222223,Bug
Vue,10806,21162,1036.9272106481483,MERGED,2,2,2,0,1,96,False,0,0,0,1177,4,5.763888888888889,Document
TypeScript,2147,14722,1487.3375578703706,MERGED,2,78,6,0,2,1,False,0,0,0,3181,80,159.875,Document
Vue,293,495,842.0495601851852,MERGED,1,2,1,5,3,388,True,1,4,3,850,3,38.350833333333334,Bug
JavaScript,5139,7050,1220.552488425926,MERGED,1,230,2,2,6,98,False,0,2,2,2546,231,73.88416666666667,Feature
TypeScript,85,722,332.04322916666666,MERGED,1,26,5,0,1,0,False,0,0,0,2554,27,71.84166666666667,Document
Go,54,353,747.7121296296297,MERGED,29,76,8,0,2,216,True,0,0,0,2199,105,0.8622222222222222,Document
Vue,293,495,846.9022685185186,MERGED,34,19,8,5,4,398,True,0,5,4,1156,53,93.65277777777777,Bug
Vue,293,495,841.9608680555556,MERGED,2,14,2,3,2,387,True,0,3,2,852,16,25.459722222222222,Bug
Java,450,746,4086.107025462963,MERGED,2,4,2,1,2,76,True,0,1,1,1020,6,3.1277777777777778,Bug
Python,547,7160,2253.4724652777777,MERGED,114,507,21,0,45,223,False,0,0,0,1011,621,675.9147222222222,Bug
C++,2234,23694,2374.0003935185186,MERGED,0,16,2,1,1,552,False,0,1,1,1582,16,64.30222222222223,Bug
Java,450,746,4087.399814814815,MERGED,4,15,1,1,1,583,False,0,1,1,310,19,260.3927777777778,Feature
Go,395,660,1282.1436921296297,MERGED,0,2,2,0,4,8,False,0,0,0,185,2,95.21833333333333,Bug
Vue,293,495,847.1001851851852,MERGED,16,43,1,9,1,381,False,2,7,3,1615,59,89.04972222222223,Bug
PHP,883,2338,1849.3371064814817,CLOSED,1,6,1,2,1,7,False,0,2,2,1625,7,83.50888888888889,Document
Vue,293,495,846.7875694444446,MERGED,19,65,4,14,5,397,True,5,9,5,1316,84,95.17333333333333,Bug
Vue,293,495,846.9137037037036,MERGED,15,230,12,10,7,169,True,3,7,4,1085,245,93.39277777777778,Bug
JavaScript,5139,7050,1216.8166087962964,MERGED,0,7165,7,1,2,292,False,0,1,1,1687,7165,0.02666666666666667,Document
Rust,264,5382,419.9380787037037,MERGED,25,30,8,0,3,419,False,0,0,0,1589,55,1.9333333333333333,Feature
TypeScript,178,1359,337.9993171296296,MERGED,14,14,2,1,1,22,True,0,1,1,2516,28,0.024166666666666666,Bug
Go,395,660,1278.172152777778,MERGED,31,233,7,0,7,95,False,0,0,0,563,264,90.60444444444444,Feature
Vue,293,495,847.0024305555556,MERGED,4,9,2,8,1,380,False,1,7,5,1442,13,69.35444444444444,Bug
Go,421,1654,1522.1280902777778,MERGED,0,620,5,0,3,14,False,0,0,0,1898,620,91.33277777777778,Bug
Go,30,295,361.29579861111114,MERGED,0,164,1,1,3,108,True,0,1,1,1098,164,4.516944444444444,Feature
TypeScript,261,3765,692.8285532407408,MERGED,86,157,3,1,4,603,True,0,1,1,3001,243,15.794722222222223,Document
TypeScript,2147,14722,1488.9811805555555,MERGED,197,319,7,0,1,10,False,0,0,0,3117,516,2.9780555555555557,Document
JavaScript,5139,7050,1219.8843749999999,MERGED,8,211,7,3,12,56,False,1,2,2,2265,219,21.7925,Feature
Kotlin,164,4296,416.55341435185187,MERGED,1,1,1,1,1,0,False,0,1,1,198,2,50.685,Bug
TypeScript,1297,21107,434.05288194444444,MERGED,0,58,3,1,2,983,True,0,1,1,1589,58,0.31027777777777776,Document
TypeScript,1297,21107,434.03630787037036,MERGED,3,5,2,1,2,982,True,0,1,1,1606,8,0.19083333333333333,Document
Rust,264,5382,419.02738425925924,MERGED,14,21,3,0,1,417,False,0,0,0,1490,35,1.256388888888889,Feature
TypeScript,261,3765,692.6822106481482,MERGED,69,83,7,0,2,170,False,0,0,0,2513,152,0.23305555555555554,Document
TypeScript,261,3765,692.6452314814815,MERGED,6,9,2,1,1,101,False,1,0,0,2735,15,0.5219444444444444,Document
JavaScript,5139,7050,1220.7585416666668,MERGED,51,974,10,3,14,94,False,0,3,2,2749,1025,235.85472222222222,Feature
Vue,293,495,843.0828472222223,CLOSED,23,29,5,6,3,1,False,2,4,3,1438,52,189.45833333333334,Bug
TypeScript,261,3765,691.8522453703704,MERGED,226,1042,48,0,13,100,False,0,0,0,2503,1268,16.470277777777778,Document
PHP,1334,2960,4220.105833333333,MERGED,1,1,1,4,2,2,False,1,3,2,1688,2,49.568888888888885,Document
TypeScript,261,3765,691.8689351851853,MERGED,18,12,7,0,4,169,False,0,0,0,2560,30,14.239166666666666,Document
Rust,264,5382,418.1517361111111,MERGED,1,3,3,0,1,162,False,0,0,0,1198,4,15.125555555555556,Bug
TypeScript,202,107,1159.8231712962963,MERGED,7,9,1,4,3,0,False,0,4,4,1574,16,117.90305555555555,Document
Go,395,660,1282.062199074074,MERGED,1,4,1,0,2,97,False,0,0,0,181,5,0.255,Bug
Go,421,1654,1522.0562037037037,MERGED,9,80,5,0,1,442,True,0,0,0,2103,89,26.710833333333333,Bug
TypeScript,261,3765,691.6916087962964,MERGED,1,12,2,0,1,100,True,0,0,0,2509,13,0.305,Document
TypeScript,202,107,1158.9897337962964,MERGED,10,31,1,5,8,2,False,0,5,4,1763,41,137.87527777777777,Document
TypeScript,15,34,502.25261574074074,CLOSED,15,44,1,1,5,477,True,0,1,1,201,59,173.5636111111111,Bug
TypeScript,495,2659,1921.4247685185185,MERGED,1361,49,7,2,4,102,True,1,1,1,768,1410,335.4794444444444,Document
TypeScript,307,2556,554.4456481481482,MERGED,1,1,1,1,2,187,True,0,1,1,1060,2,119.80305555555556,Bug
TypeScript,7,6,657.9465856481481,CLOSED,17,13,4,1,1,213,False,1,0,0,1623,30,51.901944444444446,Feature
Go,395,660,1282.156712962963,MERGED,6,12,1,0,2,98,False,0,0,0,283,18,135.46166666666667,Bug
TypeScript,85,722,329.23233796296296,MERGED,14,218,12,1,2,3,False,1,0,0,3080,232,66.17388888888888,Document
Go,395,660,1280.0915162037038,MERGED,0,12,1,1,9,7,False,1,0,0,411,12,192.97833333333332,Feature
Python,19249,70257,2476.771423611111,CLOSED,2,12,1,1,2,1597,False,1,0,0,244,14,14.22888888888889,Document
Rust,264,5382,417.9388425925926,MERGED,111,123,5,0,1,239,True,0,0,0,1735,234,0.9316666666666666,Bug
Python,137,75,701.1004976851851,CLOSED,0,190,10,0,15,0,False,0,0,0,2171,190,1363.2225,Bug
Rust,264,5382,417.86817129629634,MERGED,22,32,2,0,1,105,True,0,0,0,1614,54,1.3425,Feature
V,2097,34361,1568.5901273148147,MERGED,3,47,3,0,2,201,True,0,0,0,1167,50,25.593888888888888,Bug
JavaScript,5139,7050,1217.867037037037,MERGED,3,8,3,3,2,184,False,1,2,2,1876,11,21.49111111111111,Bug
Go,395,660,1281.125474537037,MERGED,234,2023,20,0,42,96,False,0,0,0,644,2257,455.6827777777778,Bug
Go,421,1654,1526.1520486111112,MERGED,35,27,3,0,1,448,True,0,0,0,2572,62,65.90444444444445,Bug
TypeScript,15,34,505.1638425925926,MERGED,2,3,2,0,1,170,False,0,0,0,242,5,0.6038888888888889,Feature
Go,1835,11245,1744.876261574074,MERGED,4,5,1,0,1,102,False,0,0,0,230,9,0.21027777777777779,Feature
TypeScript,7,6,661.0882060185185,MERGED,41,54,4,0,6,268,False,0,0,0,2077,95,117.41972222222222,Feature
Python,137,75,698.1776273148148,MERGED,0,198,10,2,62,0,False,0,2,1,2745,198,1899.0647222222221,Bug
TypeScript,307,2556,554.4363657407407,MERGED,2,4,1,1,1,568,True,0,1,1,1371,6,73.55972222222222,Bug
TypeScript,15,34,504.8487847222222,MERGED,2,4,2,0,2,951,False,0,0,0,245,6,7.993333333333333,Feature
Go,395,660,1280.4491782407406,MERGED,7,13,1,0,2,82,False,0,0,0,228,20,12.627222222222223,Feature
JavaScript,8844,63474,4093.2746064814814,MERGED,53,9,4,0,1,105,True,0,0,0,2510,62,141.93777777777777,Feature
Python,19249,70257,2475.637696759259,CLOSED,1,11,2,4,3,61,False,1,3,2,375,12,26.794444444444444,Bug
JavaScript,5139,7050,1216.5555324074073,MERGED,1,72,2,3,4,258,False,1,2,2,2342,73,52.04222222222222,Feature
Rust,264,5382,416.9239236111111,MERGED,9,8,2,2,1,411,False,1,1,1,1544,17,1.4497222222222221,Bug
TypeScript,15,34,505.4369791666666,MERGED,18,562,9,0,22,479,True,0,0,0,272,580,123.37805555555556,Feature
Go,395,660,1280.3783101851852,CLOSED,8,22,1,0,3,141,False,0,0,0,191,30,1.7308333333333332,Feature
Go,54,353,747.6075578703703,MERGED,157,1244,29,0,3,215,True,0,0,0,1522,1401,59.88861111111111,Document
Vue,293,495,844.7565625000001,MERGED,88,14,4,5,4,396,True,0,5,4,1183,102,34.5975,Bug
Rust,264,5382,416.23496527777775,MERGED,60,174,15,0,7,336,False,0,0,0,1263,234,18.02638888888889,Document
Vue,293,495,845.0763310185185,MERGED,13,16,1,4,2,307,True,0,4,3,1428,29,18.184444444444445,Bug
Rust,264,5382,419.20625,MERGED,8,7,1,0,1,4,False,0,0,0,1856,15,0.9241666666666667,Feature
TypeScript,261,3765,689.7721296296296,MERGED,2,17,2,0,2,597,True,0,0,0,2332,19,0.41638888888888886,Document
TypeScript,7,6,658.955,MERGED,2016,3326,93,0,9,265,False,0,0,0,2664,5342,170.74416666666667,Feature
TypeScript,261,3765,689.5263310185186,MERGED,27,37,1,0,2,594,True,0,0,0,2898,64,1.2877777777777777,Document
JavaScript,9664,43889,3673.027789351852,MERGED,75,75,2,4,21,0,False,2,2,1,370,150,141.2888888888889,Feature
Python,547,7160,2253.540613425926,MERGED,5,5,1,0,1,230,False,0,0,0,388,10,1.9347222222222222,Document
TypeScript,1297,21107,430.9334490740741,MERGED,5,189,13,1,6,970,True,0,1,1,1287,194,0.9827777777777778,Document
Go,1835,11245,1743.7554050925926,MERGED,455,39,6,0,1,16,True,0,0,0,209,494,0.11388888888888889,Feature
TypeScript,202,107,1161.057361111111,MERGED,2,8,2,5,12,2,False,1,4,4,530,10,88.25861111111111,Bug
Vue,293,495,843.0159722222223,MERGED,40,180,6,11,6,389,True,4,7,4,1068,220,89.10777777777778,Document
Python,547,7160,2251.5910416666666,MERGED,3,11,2,0,4,20,False,0,0,0,1739,14,68.11944444444444,Document
Rust,264,5382,415.9830555555556,MERGED,6,14,2,0,1,259,True,0,0,0,1500,20,0.4602777777777778,Feature
Rust,433,2229,251.4188773148148,MERGED,0,18,2,1,1,853,False,0,1,1,345,18,4.641388888888889,Document
Vue,293,495,843.6996875,MERGED,57,37,1,2,5,391,True,0,2,2,1193,94,26.65888888888889,Bug
C#,80,125,834.8478935185185,MERGED,7,0,1,0,1,83,False,0,0,0,429,7,46.60166666666667,Document
TypeScript,2147,14722,1485.1589930555556,MERGED,9,4,1,0,1,52,False,0,0,0,2545,13,0.6519444444444444,Bug
JavaScript,5139,7050,1216.4969560185184,MERGED,3,15,3,2,2,183,False,1,1,1,2248,18,0.7877777777777778,Feature
TypeScript,17,33,733.7358912037038,MERGED,32,302,10,2,2,41,False,0,2,2,315,334,171.04444444444445,Feature
Go,421,1654,1525.9153703703705,MERGED,103,100,4,0,1,447,True,0,0,0,2493,203,2.9019444444444447,Document
Python,137,75,699.0036226851852,MERGED,0,646,16,3,32,0,False,0,3,3,1188,646,989.6,Bug
TypeScript,202,107,1159.8059375,MERGED,1,7,1,4,4,0,False,0,4,4,438,8,118.3025,Bug
TypeScript,15,34,506.6965046296296,MERGED,7,9,1,0,1,956,False,0,0,0,255,16,1.4444444444444444,Bug
Go,54,353,747.6057754629629,MERGED,0,11,2,0,1,214,True,0,0,0,1314,11,2.1230555555555557,Bug
TypeScript,261,3765,688.7377546296296,MERGED,5,78,9,0,6,882,True,0,0,0,2969,83,1.3263888888888888,Document
TypeScript,202,107,1158.7105439814816,MERGED,10,10,2,4,2,1,False,0,4,4,1372,20,17.51361111111111,Document
Vue,293,495,843.6763773148149,MERGED,1,1,1,3,1,302,True,0,3,2,1532,2,2.286111111111111,Bug
TypeScript,261,3765,688.6398495370371,MERGED,38,47,6,0,3,97,True,0,0,0,2902,85,1.8180555555555555,Document
TypeScript,307,2556,553.4333217592592,MERGED,1,1,1,3,1,567,True,1,2,1,939,2,28.155277777777776,Bug
Go,395,660,1278.1256597222223,MERGED,1,6,1,0,2,46,False,0,0,0,223,7,22.032777777777778,Feature
V,2097,34361,1566.4783680555556,MERGED,0,7,3,0,1,196,True,0,0,0,1318,7,10.46861111111111,Bug
Python,547,7160,2252.5730555555556,MERGED,0,1,1,0,1,229,False,0,0,0,404,1,0.2925,Bug
Go,395,660,1278.165798611111,MERGED,3,2,1,0,1,52,False,0,0,0,185,5,16.02166666666667,Feature
TypeScript,261,3765,688.5146875,MERGED,1293,1007,139,0,4,881,True,0,0,0,929,2300,0.8238888888888889,Document
TypeScript,41368,87412,2953.7220601851855,MERGED,0,1,1,6,1,0,False,2,4,2,2264,1,0.8463888888888889,Document
Go,421,1654,1524.9507870370371,MERGED,12,13,9,0,1,446,True,0,0,0,2891,25,5.301111111111111,Bug
TypeScript,15,34,502.54773148148143,MERGED,1,1,1,0,1,939,False,0,0,0,240,2,0.435,Bug
Vue,293,495,843.0760995370371,MERGED,0,10,2,4,1,300,True,0,4,3,1416,10,3.0747222222222224,Bug
Rust,433,2229,250.36980324074077,MERGED,1,5,1,1,2,850,False,0,1,1,266,6,0.5822222222222222,Bug
PHP,883,2338,1844.9424537037037,MERGED,482,526,3,0,2,6,False,0,0,0,1173,1008,0.2975,Document
Go,395,660,1277.828761574074,MERGED,3,3,1,0,1,94,False,0,0,0,217,6,0.5033333333333333,Feature
TypeScript,15,34,505.51434027777776,MERGED,9,37,3,0,2,953,False,0,0,0,314,46,0.7841666666666667,Bug
Python,547,7160,2254.585972222222,MERGED,3,7,1,0,3,282,True,0,0,0,540,10,0.02666666666666667,Bug
Vue,293,495,845.0444791666667,MERGED,49,76,16,10,19,306,True,4,6,4,1527,125,92.32527777777777,Bug
Java,450,746,4086.189560185185,MERGED,11,1,1,0,1,147,False,0,0,0,1323,12,0.43972222222222224,Bug
TypeScript,15,34,505.0684722222222,MERGED,51,60,5,0,13,952,False,0,0,0,336,111,11.698333333333334,Feature
TypeScript,202,107,1160.828900462963,MERGED,121,57,1,12,4,0,False,3,9,5,2185,178,114.02583333333334,Document
Rust,433,2229,249.5783101851852,MERGED,5,5,1,1,1,848,False,0,1,1,285,10,0.9097222222222222,Document
Rust,433,2229,249.4998148148148,MERGED,7,8,2,1,1,847,False,0,1,1,360,15,2.7969444444444442,Feature
Go,30,295,362.29167824074074,MERGED,3,3,2,0,1,110,True,0,0,0,2493,6,0.08694444444444445,Bug
V,2097,34361,1564.3762962962962,MERGED,0,18,3,0,2,192,True,0,0,0,1415,18,39.80305555555555,Bug
Python,137,75,702.9581018518519,MERGED,0,174,4,0,16,0,False,0,0,0,1746,174,581.6544444444445,Document
V,2097,34361,1564.9446064814813,MERGED,6,116,5,1,2,193,True,0,1,1,1469,122,11.092777777777778,Bug
C++,2234,23694,2369.947766203704,MERGED,86,107,5,1,4,24,False,0,1,1,2570,193,24.782222222222224,Bug
Go,54,353,751.114074074074,MERGED,3,3,4,0,1,74,True,0,0,0,1855,6,0.1575,Document
C#,80,125,835.8367476851853,MERGED,4,14,1,0,2,195,True,0,0,0,490,18,18.683888888888887,Document
Python,547,7160,2253.4640856481483,MERGED,4,12,1,1,1,222,False,0,1,1,715,16,0.2861111111111111,Bug
TypeScript,15,34,502.4165972222222,MERGED,7,62,2,0,2,478,True,0,0,0,383,69,91.31388888888888,Feature
TypeScript,2071,16639,1260.3886805555555,MERGED,2,2,1,0,1,0,False,0,0,0,2469,4,244.51055555555556,Bug
TypeScript,202,107,1162.1389699074073,CLOSED,25,28,2,8,3,1,False,3,5,4,2440,53,13.893611111111111,Document
Java,450,746,4085.272569444445,MERGED,1,1,1,1,1,30,False,0,1,1,454,2,1.61,Feature
Go,395,660,1279.2571990740742,MERGED,3,18,1,0,1,120,False,0,0,0,275,21,23.110277777777778,Feature
JavaScript,9664,43889,3672.186030092593,CLOSED,73,328,37,1,1,245,True,1,0,0,452,401,18.81138888888889,Feature
TypeScript,307,2556,554.7267592592592,MERGED,2,4,1,1,3,18,False,0,1,1,1349,6,114.85,Bug
Go,30,295,361.25365740740745,MERGED,10,52,3,1,1,107,True,0,1,1,2021,62,0.20833333333333334,Feature
TypeScript,7,6,658.0328472222222,MERGED,9,98,10,2,3,214,False,1,1,1,1995,107,49.76444444444444,Feature
TypeScript,1297,21107,432.8664814814815,MERGED,6,6,6,1,1,975,True,0,1,1,2167,12,0.007222222222222222,Document
JavaScript,9664,43889,3673.1884837962966,MERGED,84,503,14,0,5,314,True,0,0,0,662,587,144.24944444444444,Feature
TypeScript,58,78,834.5108564814815,MERGED,419,578,118,2,5,121,False,0,2,2,3646,997,158.52333333333334,Bug
V,2097,34361,1568.6826273148147,MERGED,11,39,2,0,3,203,True,0,0,0,2475,50,23.35972222222222,Bug
TypeScript,15,34,502.64206018518513,CLOSED,1,3,1,0,2,316,False,0,0,0,317,4,26.727222222222224,Bug
TypeScript,15,34,503.1996875,MERGED,0,3,1,0,1,169,False,0,0,0,429,3,0.5877777777777777,Feature
Python,547,7160,2253.694247685185,CLOSED,4218,4698,88,0,11,21,False,0,0,0,2005,8916,17.86,Document
TypeScript,15,34,502.53650462962963,MERGED,5,8,4,0,2,938,False,0,0,0,258,13,12.8325,Feature
Rust,264,5382,416.7889351851852,MERGED,22,4,6,0,1,102,True,0,0,0,2146,26,23.039166666666667,Feature
TypeScript,495,2659,1922.1702662037035,MERGED,195,5,15,0,4,103,True,0,0,0,886,200,306.50194444444446,Document
TypeScript,202,107,1160.0759722222222,MERGED,1,4,1,15,9,1,False,8,7,5,508,5,111.8488888888889,Bug
Go,30,295,359.91681712962964,MERGED,11,23,2,0,2,95,True,0,0,0,2027,34,0.10305555555555555,Feature
Rust,433,2229,249.48993055555556,MERGED,34,18,3,1,1,846,False,0,1,1,501,52,3.4516666666666667,Feature
TypeScript,41368,87412,2953.7208796296295,MERGED,0,1,1,0,1,1912,True,0,0,0,2071,1,0.22805555555555557,Document
TypeScript,178,1359,337.95430555555555,MERGED,2,53,3,2,1,20,True,0,2,2,3818,55,1.6922222222222223,Feature
Go,395,660,1277.9080208333332,MERGED,0,2,2,0,1,51,False,0,0,0,331,2,4.785277777777778,Feature
TypeScript,17,33,735.809386574074,MERGED,39,106,4,1,1,42,False,0,1,1,406,145,4.631388888888889,Feature
TypeScript,41368,87412,2955.068125,MERGED,6,1,1,0,2,0,False,0,0,0,2113,7,0.3425,Document
C#,80,125,836.9540625,MERGED,233,1149,19,0,10,196,True,0,0,0,722,1382,68.32611111111112,Document
Rust,264,5382,415.9617013888889,MERGED,15,32,4,0,1,101,True,0,0,0,2260,47,19.781944444444445,Feature
TypeScript,15,34,504.71280092592593,MERGED,4,12,4,0,2,949,False,0,0,0,442,16,1.3263888888888888,Bug
TypeScript,15,34,504.64721064814813,MERGED,14,24,4,0,5,948,False,0,0,0,485,38,0.4711111111111111,Feature
JavaScript,5139,7050,1216.460659722222,MERGED,2,31,3,2,2,55,False,0,2,2,2800,33,54.054722222222225,Feature
TypeScript,15,34,504.6136574074074,MERGED,19,13,4,0,2,947,False,0,0,0,468,32,0.08888888888888889,Document
V,2097,34361,1567.4141087962962,MERGED,4,4,1,0,1,37,True,0,0,0,1726,8,2.566666666666667,Document
Starlark,440,286,504.1969791666667,MERGED,0,190,2,11,8,0,False,7,4,3,2071,190,1140.895,Document
C#,80,125,835.0191319444444,MERGED,13,13,2,0,1,161,True,0,0,0,624,26,133.14527777777778,Document
Python,547,7160,2254.5944907407406,MERGED,17,10,1,0,7,283,True,0,0,0,609,27,0.2025,Bug
TypeScript,17,33,732.0381712962962,MERGED,6,31,4,1,4,26,True,0,1,1,363,37,16.376944444444444,Bug
Python,547,7160,2254.571412037037,MERGED,14,14,1,0,1,281,True,0,0,0,580,28,0.019166666666666665,Bug
Rust,264,5382,415.92118055555557,MERGED,11,1,4,0,1,100,True,0,0,0,2098,12,4.113611111111111,Feature
Rust,264,5382,415.917962962963,MERGED,63,6,2,0,1,21,True,0,0,0,2204,69,1.1905555555555556,Feature
TypeScript,85,723,331.9699189814815,MERGED,92,194,44,0,4,89,False,0,0,0,4693,286,2.738888888888889,Document
Java,450,746,4088.1068055555556,MERGED,186,496,4,1,10,749,False,0,1,1,1935,682,3.486111111111111,Document
V,2097,34361,1563.906273148148,MERGED,89,89,28,3,7,16,True,1,2,1,9979,178,85.21083333333333,Document
TypeScript,85,723,331.97984953703707,MERGED,17,43,4,0,3,4,False,0,0,0,4526,60,0.3213888888888889,Document
Vue,293,495,843.7691203703704,MERGED,28,43,10,5,16,303,True,1,4,3,1978,71,1.7869444444444444,Bug
TypeScript,15,34,502.4546296296296,MERGED,3,14,2,1,3,133,False,1,0,0,443,17,45.37611111111111,Feature
Python,547,7160,2253.551875,CLOSED,18,8,5,0,3,231,False,0,0,0,613,26,1.778888888888889,Document
TypeScript,202,107,1161.583298611111,MERGED,105,133,5,7,11,0,False,3,4,4,2898,238,199.36777777777777,Document
Vue,293,495,842.1306018518518,MERGED,24,83,4,18,5,377,False,4,14,4,1651,107,64.89916666666667,Bug
TypeScript,261,3765,692.5209490740741,MERGED,77,10,6,0,1,101,True,0,0,0,4191,87,0.3972222222222222,Document
Python,547,7160,2252.0040046296294,MERGED,26,107,5,1,7,25,True,0,1,1,703,133,62.72138888888889,Bug
TypeScript,2147,14722,1487.9972800925925,MERGED,14,15,7,0,1,296,False,0,0,0,3103,29,0.1275,Bug
Go,30,295,362.42506944444443,CLOSED,3,22,1,2,2,155,True,1,1,1,2421,25,12.266944444444444,Bug
Go,30,295,363.13364583333333,MERGED,7,496,4,3,12,156,True,1,2,1,2937,503,27.57638888888889,Feature
TypeScript,17,33,732.992800925926,MERGED,43,180,14,1,6,27,True,0,1,1,450,223,21.974444444444444,Bug
JavaScript,9664,43889,3672.8382986111114,CLOSED,10,481,2,1,1,246,True,1,0,0,559,491,0.8538888888888889,Feature
TypeScript,15,34,502.63300925925927,MERGED,18,31,4,0,5,168,False,0,0,0,405,49,12.588055555555556,Feature
C#,80,125,834.8826388888889,MERGED,8,1352,574,0,3,84,False,0,0,0,619,1360,41.9575,Document
Vue,293,495,843.1304398148148,MERGED,4,6,1,3,1,301,True,0,3,2,1465,10,1.7802777777777778,Bug
TypeScript,41368,87412,2952.793958333333,MERGED,1,1,1,0,1,1911,True,0,0,0,2076,2,0.5830555555555555,Document
TypeScript,261,3765,691.6814120370371,MERGED,2,75,6,3,1,892,True,1,2,1,3142,77,0.5402777777777777,Document
TypeScript,4,33,777.0708217592593,MERGED,326,966,16,2,13,213,True,1,1,1,615,1292,25.515,Feature
TypeScript,41368,87412,2952.4819675925924,MERGED,92,91,3,0,2,433,True,0,0,0,2141,183,0.4191666666666667,Document
JavaScript,9664,43889,3671.968831018519,CLOSED,5,4,3,1,1,313,True,1,0,0,568,9,14.569444444444445,Feature
Erlang,2054,12122,3812.0583449074074,MERGED,3,4,4,0,1,381,True,0,0,0,1317,7,67.71416666666667,Document
TypeScript,261,3765,690.6776157407407,MERGED,10,77,6,0,3,98,True,0,0,0,3859,87,27.84111111111111,Document
JavaScript,9664,43889,3671.867337962963,MERGED,1,1,3,0,1,244,True,0,0,0,582,2,0.4938888888888889,Bug
TypeScript,42,46,784.726423611111,MERGED,0,2,1,1,1,141,False,0,1,1,724,2,0.39222222222222225,Feature
Erlang,2054,12122,3812.2028356481483,MERGED,3,130,8,2,2,350,False,0,2,1,1132,133,93.62388888888889,Document
TypeScript,1297,21107,427.9809490740741,MERGED,146,1,15,1,1,960,True,0,1,1,2223,147,0.0075,Document
Vue,293,495,841.9392592592593,CLOSED,21,138,9,2,9,55,False,0,2,2,1774,159,0.06944444444444445,Bug
TypeScript,7,6,661.8043518518518,MERGED,15,33,4,2,1,215,False,0,2,1,2903,48,0.2902777777777778,Document
TypeScript,2071,16639,1260.2084722222223,CLOSED,2,2,2,0,3,4,False,0,0,0,2696,4,0.030833333333333334,Bug
TypeScript,17,33,731.9614236111111,MERGED,24,296,6,1,1,40,False,0,1,1,465,320,3.8366666666666664,Feature
TypeScript,261,3765,690.5135532407407,MERGED,9,52,5,0,1,888,True,0,0,0,3394,61,0.3622222222222222,Document
JavaScript,8844,63474,4094.232326388889,MERGED,42,56,11,1,4,4,True,0,1,1,6475,98,119.1763888888889,Feature
JavaScript,8844,63474,4091.817071759259,MERGED,7,70,9,0,3,62,True,0,0,0,3045,77,8.748888888888889,Bug
TypeScript,41368,87412,2952.661400462963,MERGED,0,14,4,0,3,23,False,0,0,0,2637,14,4.402222222222222,Document
TypeScript,3393,2334,981.8372337962963,CLOSED,12,45,5,1,9,117,False,0,1,1,4713,57,120.54833333333333,Bug
Erlang,2054,12122,3810.9778703703705,MERGED,33,41,2,2,2,239,True,0,2,1,1136,74,96.07722222222222,Document
Erlang,2054,12122,3810.8925925925923,MERGED,19,52,4,2,3,237,True,0,2,1,1237,71,19.674722222222222,Document
Erlang,2054,12122,3809.0535416666667,MERGED,2,13,3,2,3,1007,True,0,2,1,1039,15,6.811111111111111,Document
Erlang,2054,12122,3808.9029861111107,MERGED,3,93,5,2,2,368,True,0,2,1,1222,96,187.21916666666667,Document
TypeScript,261,3765,689.8580324074073,MERGED,121,117,11,0,9,192,False,0,0,0,3949,238,2.2641666666666667,Document
TypeScript,42,46,783.7076157407408,MERGED,1,1,1,2,1,85,False,1,1,1,584,2,0.14694444444444443,Document
TypeScript,261,3765,689.808113425926,MERGED,580,214,13,0,4,164,False,0,0,0,4119,794,0.6227777777777778,Document
Erlang,2054,12122,3812.3673726851853,MERGED,2,2,1,0,1,64,False,0,0,0,675,4,60.452222222222225,Document
TypeScript,261,3765,689.7803125,MERGED,118,120,10,0,2,886,True,0,0,0,3242,238,0.4475,Document
TypeScript,41368,87412,2950.5948726851852,MERGED,0,4,1,0,2,1906,True,0,0,0,2123,4,2.078611111111111,Document
Go,421,1654,1525.9312037037037,MERGED,5640,7,51,0,1,603,False,0,0,0,4051,5647,0.01611111111111111,Document
Python,547,7160,2250.5885879629627,MERGED,2,28,2,0,4,147,False,0,0,0,840,30,3.2730555555555556,Bug
TypeScript,261,3765,689.4765162037037,MERGED,26,103,7,0,3,883,True,0,0,0,3723,129,1.5319444444444446,Document
TypeScript,15,34,504.58087962962964,MERGED,20,21,7,0,4,946,False,0,0,0,492,41,0.4013888888888889,Feature
TypeScript,41368,87412,2953.822708333333,CLOSED,8,61,7,24,6,87,True,10,14,3,3349,69,44.66277777777778,Document
TypeScript,85,723,328.1589814814815,MERGED,0,36,2,0,2,163,False,0,0,0,3794,36,1.051388888888889,Document
JavaScript,9664,43889,3670.1792708333337,CLOSED,13,29,3,1,1,243,True,1,0,0,510,42,2.1469444444444443,Feature
Python,547,7160,2250.5210185185183,MERGED,8,34,3,0,3,146,False,0,0,0,1141,42,1.7805555555555554,Bug
Python,2407,12180,256.6888888888889,MERGED,1,1,1,1,2,73,True,0,1,1,959,2,53.17055555555555,Bug
Java,450,746,4089.2886458333337,MERGED,1,309,7,1,15,31,False,0,1,1,864,310,114.88666666666667,Feature
Java,450,746,4085.198703703704,MERGED,65623,11198,10,1,3,29,False,0,1,1,667,76821,0.8541666666666666,Feature
TypeScript,41368,87412,2950.6810995370374,MERGED,7,9,2,0,2,1,False,0,0,0,2266,16,2.848333333333333,Document
TypeScript,41368,87412,2949.716134259259,MERGED,2,2,2,0,1,1600,True,0,0,0,2168,4,0.5097222222222222,Document
Go,1835,11245,1742.9291435185185,MERGED,125,85,7,0,1,100,False,0,0,0,521,210,3.2755555555555556,Feature
TypeScript,261,3765,688.7217476851852,MERGED,164,267,15,0,6,162,False,0,0,0,3772,431,2.7063888888888887,Document
TypeScript,15,34,503.6758101851852,MERGED,4,109,2,0,1,942,False,0,0,0,526,113,1.8583333333333334,Document
TypeScript,261,3765,688.6470138888889,MERGED,15,133,2,0,12,161,False,0,0,0,3686,148,1.0975,Document
C#,80,125,836.7915046296297,MERGED,386,3614,648,0,13,85,False,0,0,0,851,4000,72.10277777777777,Document
TypeScript,15,34,502.32055555555553,MERGED,0,61,2,0,3,132,False,0,0,0,565,61,20.708055555555557,Feature
TypeScript,1297,21107,432.8261226851852,MERGED,16,57,7,1,4,974,True,0,1,1,3171,73,0.8122222222222222,Document
TypeScript,58,78,833.624386574074,MERGED,66,206,5,1,2,173,False,0,1,1,2676,272,17.420555555555556,Feature
Rust,264,5382,417.1582986111111,MERGED,1,1,1,0,4,338,False,0,0,0,2639,2,14.652777777777779,Bug
Starlark,440,286,507.1138888888889,CLOSED,0,209,5,3,9,0,False,2,1,1,2551,209,1226.1961111111111,Document
Go,421,1654,1526.0731944444444,CLOSED,40,1901,22,1,6,64,False,1,0,0,8139,1941,819.4216666666666,Bug
Python,547,7160,2254.440451388889,MERGED,0,4,1,0,2,22,False,0,0,0,2713,4,0.2175,Document
Erlang,2054,12122,3808.412789351852,MERGED,22,187,7,2,1,336,False,0,2,1,1197,209,46.97805555555556,Document
V,2097,34361,1567.9774421296297,MERGED,10,51,1,0,1,1,False,0,0,0,2611,61,20.54861111111111,Document
C#,80,125,836.6364930555555,MERGED,14,144,21,0,3,177,True,0,0,0,764,158,2.1597222222222223,Document
Python,137,75,698.6265625,MERGED,1,5,2,0,1,235,False,0,0,0,998,6,0.16083333333333333,Document
Python,137,75,700.0779629629629,MERGED,0,54,4,0,13,3,False,0,0,0,2064,54,776.3419444444445,Document
TypeScript,41368,87412,2954.9608449074076,MERGED,1,3,3,1,5,1913,True,0,1,1,2435,4,3.1016666666666666,Document
C++,2234,23694,2369.8372800925927,MERGED,38,139,1,2,9,283,False,1,1,1,3092,177,47.0625,Bug
PHP,1334,2960,4219.909594907407,MERGED,14,80,4,0,6,48,False,0,0,0,3959,94,23.6575,Document
TypeScript,41368,87412,2953.668680555556,MERGED,5,9,3,2,4,15,False,1,1,1,3947,14,574.7980555555556,Document
TypeScript,41368,87412,2954.760509259259,MERGED,1,6,2,1,4,14,False,1,0,0,2632,7,2.8991666666666664,Document
TypeScript,3393,2334,983.0974537037036,MERGED,17,16,2,1,2,120,False,0,1,1,1179,33,0.5633333333333334,Bug
Vue,293,495,843.9818402777778,MERGED,165,217,16,7,9,304,True,1,6,3,2357,382,19.575277777777778,Bug
Python,137,75,701.9510069444444,MERGED,0,172,2,0,3,4,False,0,0,0,1519,172,311.7397222222222,Feature
TypeScript,3393,2334,982.8490393518518,MERGED,1,1,1,1,1,119,False,0,1,1,1068,2,0.08833333333333333,Bug
TypeScript,202,107,1158.8285069444444,CLOSED,397,306,3,3,1,1,False,0,3,3,957,703,46.766666666666666,Bug
Python,2407,12180,254.25679398148148,MERGED,1,138,3,6,1,1,False,2,4,2,4028,139,304.35305555555556,Document
C#,80,125,835.5721874999999,MERGED,2,10,2,0,1,197,False,0,0,0,1005,12,9.861944444444445,Document
JavaScript,9664,43889,3672.8292708333333,MERGED,0,86,2,1,2,1,False,0,1,1,752,86,0.43805555555555553,Feature
JavaScript,5139,7050,1219.792013888889,MERGED,4,38,2,2,3,0,False,1,1,1,2710,42,118.06555555555556,Bug
JavaScript,9664,43889,3672.114016203704,MERGED,195,3230,58,0,8,33,False,0,0,0,705,3425,25.925833333333333,Feature
TypeScript,15,34,506.6478009259259,MERGED,10,17,1,0,1,955,False,0,0,0,756,27,1.283611111111111,Feature
TypeScript,69,2215,328.70355324074075,MERGED,3515,1906,129,2,68,27,False,0,2,2,1358,5421,266.0311111111111,Document
Python,137,75,701.2015393518518,CLOSED,0,0,2,0,1,0,False,0,0,0,1150,0,319.6333333333333,Bug
PHP,883,2338,1845.955474537037,CLOSED,629,2299,35,2,2,2,False,0,2,2,4508,2928,523.8561111111111,Document
TypeScript,41368,87412,2953.7354166666664,MERGED,0,1,1,0,2,1,False,0,0,0,2252,1,3.387777777777778,Document
TypeScript,85,723,331.2381712962963,CLOSED,10447,5232,232,0,26,166,False,0,0,0,7378,15679,310.37694444444446,Document
PHP,883,2338,1844.8260416666665,CLOSED,499,605,5,0,7,1,False,0,0,0,2596,1104,47.090833333333336,Document
TypeScript,41368,87412,2953.588125,MERGED,1,2,1,2,2,0,False,1,1,1,2536,3,2.504166666666667,Document
TypeScript,41368,87412,2953.492013888889,CLOSED,9,1,2,1,2,13,False,1,0,0,2496,10,2.162777777777778,Document
TypeScript,202,107,1161.0775231481482,CLOSED,2,7,2,4,1,0,False,0,4,4,1740,9,392.8383333333333,Document
TypeScript,41368,87412,2953.477175925926,MERGED,1,1,1,1,1,1604,True,0,1,1,2131,2,0.4419444444444444,Document
TypeScript,41368,87412,2953.439293981481,CLOSED,144,359,24,4,12,11,False,1,3,3,2680,503,0.5002777777777778,Document
Erlang,2054,12122,3808.1012962962964,MERGED,3,3,1,0,1,61,False,0,0,0,702,6,0.07055555555555555,Document
Erlang,2054,12122,3807.903761574074,MERGED,1,1,1,0,1,60,False,0,0,0,730,2,1.9375,Document
TypeScript,41368,87412,2952.765474537037,MERGED,0,95,4,1,3,435,True,1,0,0,2182,95,1.6888888888888889,Document
TypeScript,41368,87412,2952.638935185185,MERGED,506,131,9,1,3,1910,True,0,1,1,2439,637,4.488888888888889,Document
TypeScript,41368,87412,2952.419340277778,MERGED,61,107,5,0,8,587,True,0,0,0,2184,168,11.09361111111111,Document
Go,1835,11245,1745.2085532407407,MERGED,0,0,1,1,1,1,False,0,1,1,920,0,23.79,Document
C#,80,125,833.5398263888889,CLOSED,1,1324349,23,2,4,7,False,1,1,1,1128,1324350,529.2197222222222,Document
TypeScript,41368,87412,2952.4535069444446,MERGED,1,1,1,0,1,0,False,0,0,0,2273,2,3.253888888888889,Document
TypeScript,41368,87412,2952.476458333333,MERGED,3,39,2,2,2,1602,True,1,1,1,2943,42,3.3497222222222223,Document
JavaScript,9664,43889,3670.963877314815,MERGED,0,548,20,0,1,312,True,0,0,0,841,548,0.1597222222222222,Feature
TypeScript,41368,87412,2952.4506944444443,MERGED,1,1,1,1,1,85,True,0,1,1,2360,2,0.9422222222222222,Document
TypeScript,41368,87412,2950.4980324074077,CLOSED,1,1,1,9,2,83,True,2,7,3,2384,2,46.875277777777775,Document
TypeScript,4,33,775.9216319444445,MERGED,5,8,2,1,2,196,False,0,1,1,1075,13,0.035555555555555556,Document
TypeScript,41368,87412,2950.918402777778,MERGED,4058,3925,9,5,6,583,True,0,5,4,2806,7983,61.4025,Document
TypeScript,1297,21107,428.5470949074074,MERGED,19,7,5,1,4,965,True,0,1,1,3128,26,0.19805555555555557,Document
TypeScript,1297,21107,428.53908564814816,MERGED,52,331,8,1,2,964,True,0,1,1,2755,383,0.01888888888888889,Document
TypeScript,41368,87412,2951.708668981482,CLOSED,2,8,1,0,2,51,True,0,0,0,2350,10,16.714166666666667,Document
TypeScript,149,2900,391.8656712962963,MERGED,0,1,1,1,1,103,False,0,1,1,899,1,4.131388888888889,Feature
TypeScript,41368,87412,2951.782175925926,MERGED,1,0,1,1,5,1909,True,1,0,0,2186,1,5.785,Document
TypeScript,41368,87412,2951.829224537037,MERGED,16,11,3,0,3,585,True,0,0,0,2127,27,2.5327777777777776,Document
TypeScript,41368,87412,2950.5953587962963,MERGED,51,62,1,3,4,580,True,1,2,1,2300,113,3.2602777777777776,Document
TypeScript,41368,87412,2951.7073611111114,CLOSED,1,1,1,1,1,12,False,1,0,0,2312,2,1.4252777777777779,Document
JavaScript,9664,43889,3670.0377546296295,MERGED,8,37,1,0,1,242,True,0,0,0,718,45,4.113333333333333,Bug
TypeScript,41368,87412,2951.6732870370374,MERGED,4,4,1,0,1,584,True,0,0,0,2491,8,1.2008333333333334,Document
TypeScript,41368,87412,2951.643715277778,MERGED,1,1,1,0,1,1601,True,0,0,0,2146,2,2.1266666666666665,Document
Python,14532,41182,1098.6056018518518,CLOSED,0,365,307,0,2,0,False,0,0,0,997,365,17.863333333333333,Document
TypeScript,15,34,503.59825231481483,MERGED,32,81,6,0,2,941,False,0,0,0,783,113,2.5319444444444446,Document
Starlark,440,286,507.800949074074,MERGED,14,33,1,0,5,9,False,0,0,0,1398,47,143.70305555555555,Bug
Starlark,440,286,507.4287152777778,MERGED,4,4,1,0,1,2,False,0,0,0,1552,8,152.63222222222223,Document
TypeScript,15,34,502.83978009259255,MERGED,85,131,10,0,4,46,False,0,0,0,913,216,20.81138888888889,Document
Go,1835,11245,1741.8696527777777,MERGED,467,639,15,2,10,99,False,1,1,1,655,1106,71.80388888888889,Feature
PHP,883,2338,1845.976747685185,CLOSED,20,31,3,2,1,19,False,0,2,2,3239,51,359.3513888888889,Document
TypeScript,41368,87412,2949.749525462963,MERGED,2,2,1,0,3,2,False,0,0,0,1014,4,1.1791666666666667,Document
TypeScript,41368,87412,2949.607685185185,MERGED,2,2,2,0,1,429,True,0,0,0,2727,4,1.941111111111111,Document
TypeScript,41368,87412,2949.426342592593,MERGED,6,6,2,12,4,0,False,5,7,2,2761,12,3.7263888888888888,Document
TypeScript,3706,54074,1370.7232870370372,MERGED,95,618,16,0,2,167,True,0,0,0,3087,713,161.60055555555556,Feature
TypeScript,41368,87412,2949.448634259259,MERGED,2,5,2,0,1,1599,True,0,0,0,2830,7,0.8366666666666667,Document
Erlang,2054,12122,3811.2095023148145,MERGED,209,304,21,0,3,379,True,0,0,0,1323,513,184.5625,Document
V,2097,34361,1566.6541203703703,MERGED,27,438,7,5,6,2,False,2,3,2,4129,465,309.06916666666666,Bug
Erlang,2054,12122,3812.0739467592593,CLOSED,42,77,1,0,1,73,True,0,0,0,1008,119,117.6375,Document
Python,2407,12180,253.70644675925925,MERGED,5,10,3,2,5,276,True,1,1,1,2589,15,1.4938888888888888,Document
Erlang,2054,12122,3811.2230555555557,MERGED,36,14,3,0,2,142,False,0,0,0,1105,50,137.55027777777778,Document
Python,137,75,703.0494791666666,MERGED,1,32,3,0,1,215,False,0,0,0,1220,33,0.2997222222222222,Document
TypeScript,41368,87412,2953.644988425926,MERGED,3,15,3,14,1,14,False,5,9,3,3517,18,283.33,Document
Python,2407,12180,255.92747685185188,CLOSED,5,45,8,2,5,0,False,1,1,1,3268,50,984.8930555555555,Document
Python,2407,12180,252.59070601851852,MERGED,307,982,23,29,198,134,True,10,19,3,1877,1289,628.9322222222222,Feature
Erlang,2054,12122,3811.379537037037,MERGED,0,16,2,0,1,348,False,0,0,0,1049,16,112.86222222222223,Document
Rust,264,5382,420.09064814814815,MERGED,8,39,2,0,1,110,True,0,0,0,4051,47,63.40472222222222,Feature
Rust,264,5382,419.283125,MERGED,14,101,11,2,1,66,False,1,1,1,4795,115,87.95194444444445,Feature
TypeScript,261,3765,692.6965393518518,MERGED,466,394,50,0,13,602,True,0,0,0,6699,860,91.27527777777777,Document
Erlang,2054,12122,3809.8607638888893,MERGED,8,20,2,0,3,369,True,0,0,0,1136,28,163.38416666666666,Document
TypeScript,178,1359,337.1799305555556,MERGED,132,120,4,1,1,21,True,0,1,1,7557,252,9.435277777777777,Bug
TypeScript,41368,87412,2954.2300694444443,CLOSED,4,85,5,2,1,13,False,1,1,1,4073,89,222.74305555555554,Document
Python,2407,12180,256.86059027777776,MERGED,0,0,0,0,2,6,False,0,0,0,1537,0,49.03666666666667,Document
TypeScript,85,723,327.9666898148148,MERGED,44,2241,35,0,37,11,False,0,0,0,6175,2285,173.0677777777778,Document
Erlang,2054,12122,3809.147592592593,CLOSED,3,3,2,3,1,337,False,2,1,1,1146,6,170.95805555555555,Document
Rust,264,5382,417.3176736111111,CLOSED,0,67,8,0,1,413,False,0,0,0,3097,67,141.35694444444445,Feature
Erlang,2054,12122,3809.003773148148,MERGED,7,8,5,0,3,234,True,0,0,0,1218,15,165.1875,Document
Python,2407,12180,252.57405092592592,MERGED,1,1,1,1,2,3,False,0,1,1,1504,2,4.054722222222222,Document
Python,2407,12180,256.85866898148146,CLOSED,1,1,1,2,1,5,False,1,1,1,1514,2,0.03194444444444444,Document
Starlark,440,286,506.1641550925926,MERGED,0,260,2,0,2,2,False,0,0,0,1646,260,18.19527777777778,Feature
TypeScript,307,2556,554.7361111111111,MERGED,10,37,6,1,6,53,True,0,1,1,3775,47,166.28055555555557,Feature
TypeScript,85,723,330.9751157407407,MERGED,83,164,30,0,3,88,False,0,0,0,6933,247,2.5372222222222223,Document
Erlang,2054,12122,3811.9521412037034,MERGED,2,2,1,0,1,19,True,0,0,0,1066,4,0.49527777777777776,Document
Rust,264,5382,419.14369212962964,MERGED,77,638,11,0,1,143,False,0,0,0,5146,715,15.998055555555556,Feature
TypeScript,85,723,330.07899305555554,MERGED,1110,4856,10,0,8,96,False,0,0,0,5508,5966,26.219166666666666,Document
Java,450,746,4089.005462962963,MERGED,38,231,17,1,12,148,False,0,1,1,4020,269,121.19111111111111,Bug
Starlark,440,286,504.78260416666666,MERGED,3,21,1,0,1,8,False,0,0,0,1506,24,51.2275,Bug
Erlang,2054,12122,3811.410659722222,MERGED,1,1,1,0,1,349,False,0,0,0,1063,2,16.184444444444445,Document
Erlang,2054,12122,3811.2632638888886,MERGED,25,106,10,0,6,63,False,0,0,0,1107,131,20.690277777777776,Document
Python,2407,12180,256.4411689814815,MERGED,1,0,1,0,1,4,False,0,0,0,1496,1,0.32611111111111113,Document
Python,547,7160,2254.870162037037,MERGED,22,23,2,0,2,25,False,0,0,0,2936,45,41.80777777777778,Document
Erlang,2054,12122,3811.180763888889,MERGED,58,27,7,0,1,347,False,0,0,0,1610,85,16.182777777777776,Document
TypeScript,261,3765,692.7347685185185,MERGED,537,207,24,0,4,896,True,0,0,0,5919,744,0.6461111111111111,Document
C++,2234,23694,2372.9632291666667,CLOSED,87,232,6,1,21,286,False,0,1,1,4025,319,17.646944444444443,Feature
TypeScript,3393,2334,981.8928356481482,CLOSED,265,1049,2,3,4,459,False,0,3,2,1261,1314,154.7463888888889,Bug
Python,137,75,700.3313888888889,CLOSED,0,18,1,1,1,16,False,1,0,0,1385,18,0.10888888888888888,Bug
JavaScript,8844,63474,4092.4022453703706,MERGED,32,96,15,0,2,102,True,0,0,0,5454,128,25.985833333333332,Feature
C#,80,125,836.7140856481482,MERGED,53,72,3,0,3,5,False,0,0,0,1354,125,69.85972222222222,Document
TypeScript,85,723,329.9514351851852,MERGED,32,191,14,0,2,87,False,0,0,0,5316,223,6.495,Document
TypeScript,3393,2334,982.4374652777778,MERGED,28,35,1,2,4,460,False,0,2,1,1353,63,107.3325,Feature
Rust,264,5382,418.24972222222226,MERGED,163,1167,25,0,3,261,True,0,0,0,3971,1330,16.247777777777777,Feature
Erlang,2054,12122,3810.9616319444444,MERGED,2,2,1,0,1,238,True,0,0,0,1106,4,0.4038888888888889,Document
Python,137,75,699.5326388888889,CLOSED,1,14,2,0,3,2,False,0,0,0,1304,15,13.036666666666667,Document
Erlang,2054,12122,3810.7491898148146,MERGED,2,93,5,0,3,488,True,0,0,0,1180,95,8.28888888888889,Document
Rust,413,5117,481.47188657407406,CLOSED,0,64,4,1,2,16,False,0,1,1,4213,64,1645.9133333333334,Document
TypeScript,4,33,779.2528935185186,MERGED,2,14,1,1,2,371,False,0,1,1,1167,16,0.13111111111111112,Bug
Erlang,2054,12122,3810.358923611111,MERGED,8,40,3,0,2,345,False,0,0,0,1135,48,17.74416666666667,Document
TypeScript,4,33,779.1434606481481,MERGED,29,33,1,2,1,215,True,1,1,1,1134,62,0.03638888888888889,Feature
Python,547,7160,2254.6056712962964,MERGED,13,9,4,0,6,23,False,0,0,0,3765,22,4.7411111111111115,Document
Erlang,2054,12122,3810.011805555556,MERGED,0,1,1,1,1,18,True,1,0,0,1009,1,23.789166666666667,Document
Python,2407,12180,255.23611111111111,MERGED,45,233,18,0,10,285,True,0,0,0,1269,278,0.3963888888888889,Document
TypeScript,1297,21107,432.68555555555554,MERGED,146,206,11,1,5,973,True,0,1,1,3314,352,0.012777777777777779,Document
Erlang,2054,12122,3810.0407060185184,MERGED,68,252,32,0,28,236,True,0,0,0,1434,320,4.040277777777778,Document
Erlang,2054,12122,3810.25630787037,MERGED,33,28,1,0,1,344,False,0,0,0,1215,61,2.661111111111111,Document
Erlang,2054,12122,3810.2410185185186,MERGED,21,93,9,0,9,343,False,0,0,0,1209,114,3.006111111111111,Document
TypeScript,3393,2334,984.0707291666666,MERGED,0,15,1,1,2,329,False,0,1,1,1520,15,0.16722222222222222,Feature
TypeScript,3393,2334,983.987962962963,MERGED,1,2,1,1,2,700,False,0,1,1,1068,3,2.4830555555555556,Bug
Erlang,2054,12122,3809.3591898148147,MERGED,16,43,9,0,1,10,False,0,0,0,1326,59,35.4875,Document
Erlang,2054,12122,3809.967037037037,MERGED,3,35,3,0,2,235,True,0,0,0,1200,38,1.5169444444444444,Document
TypeScript,3393,2334,983.0664930555555,MERGED,10,47,1,1,3,328,False,0,1,1,1573,57,21.046666666666667,Feature
Python,2407,12180,254.05506944444446,MERGED,1,1,1,0,2,280,True,0,0,0,1482,2,28.414722222222224,Document
Erlang,2054,12122,3809.647835648148,MERGED,3,4,3,0,1,378,True,0,0,0,1353,7,13.018055555555556,Document
Erlang,2054,12122,3809.447638888889,MERGED,7,14,1,1,1,341,False,1,0,0,1016,21,16.078611111111112,Document
Erlang,2054,12122,3809.388773148148,MERGED,5,18,2,2,1,340,False,2,0,0,1230,23,18.575555555555557,Document
Erlang,2054,12122,3809.320868055556,MERGED,14,49,4,0,3,62,False,0,0,0,1238,63,19.406944444444445,Document
Erlang,2054,12122,3809.291805555555,MERGED,2,5,1,1,1,339,False,1,0,0,1057,7,13.650833333333333,Document
Rust,264,5382,417.1766550925926,MERGED,16,62,6,0,1,412,False,0,0,0,4565,78,0.7197222222222223,Feature
Rust,264,5382,415.96702546296297,MERGED,21,70,11,3,2,179,False,0,3,1,3714,91,54.291111111111114,Bug
Erlang,2054,12122,3809.1789004629627,MERGED,2,2,2,2,2,338,False,1,1,1,1021,4,16.35638888888889,Document
Erlang,2054,12122,3808.6661805555555,MERGED,12,28,1,0,1,9,False,0,0,0,1216,40,43.57805555555556,Document
TypeScript,1297,21107,432.0810300925926,MERGED,148,313,21,1,9,971,True,0,1,1,3979,461,1.105,Document
TypeScript,202,107,1156.5326388888889,CLOSED,365,375,19,3,9,254,True,0,3,3,5261,740,189.05444444444444,Document
TypeScript,3393,2334,983.0491087962963,MERGED,6,8,1,1,1,699,False,0,1,1,1254,14,0.6769444444444445,Document
TypeScript,3393,2334,982.9551967592593,MERGED,2,6,1,2,1,461,False,0,2,1,1680,8,2.539722222222222,Feature
TypeScript,3393,2334,982.91125,MERGED,0,28,1,1,1,698,False,0,1,1,1234,28,0.8480555555555556,Document
JavaScript,34,25,213.46152777777777,MERGED,3,0,1,0,1,2,False,0,0,0,1548,3,2.4094444444444445,Feature
TypeScript,85,723,328.0114351851852,MERGED,73,374,46,0,2,84,False,0,0,0,7345,447,0.9936111111111111,Document
TypeScript,41368,87412,2955.164965277778,MERGED,47,25,4,0,1,438,True,0,0,0,3818,72,11.675555555555556,Document
TypeScript,3393,2334,980.8013194444444,MERGED,0,1,1,2,1,0,False,0,2,1,1182,1,26.839444444444446,Feature
Erlang,2054,12122,3809.155405092593,MERGED,2,11,3,0,1,45,False,0,0,0,1046,13,5.138333333333334,Document
TypeScript,1073,11366,1106.8747569444445,CLOSED,3,3,1,1,1,134,False,0,1,1,1954,6,500.9411111111111,Bug
C++,363,552,552.2356134259259,MERGED,79,62,2,1,1,233,False,0,1,1,1538,141,1.2825,Document
TypeScript,41368,87412,2955.1077546296297,MERGED,12,14,5,1,3,437,True,1,0,0,4202,26,0.48638888888888887,Document
Erlang,2054,12122,3808.0652546296296,MERGED,28,49,4,3,3,44,False,3,0,0,988,77,38.595,Document
V,2097,34361,1567.678576388889,MERGED,60,90,2,0,1,38,True,0,0,0,4496,150,5.03,Document
Go,54,353,746.882662037037,MERGED,74,118,9,0,1,213,True,0,0,0,7289,192,1.3111111111111111,Bug
JavaScript,34,25,212.59672453703703,MERGED,18,15,5,5,3,1,False,2,3,1,1665,33,145.8486111111111,Document
TypeScript,41368,87412,2954.840578703704,MERGED,5,7,2,0,1,88,True,0,0,0,3142,12,1.0452777777777778,Document
TypeScript,261,3765,689.7263888888889,MERGED,83,70,2,0,2,595,True,0,0,0,6126,153,18.447222222222223,Document
Java,450,746,4084.9372800925926,CLOSED,121,120,2,1,10,3,False,0,1,1,5839,241,943.4405555555555,Bug
Java,450,746,4088.2463657407407,MERGED,37,119,4,1,2,375,False,0,1,1,4286,156,3.3105555555555557,Document
TypeScript,4,33,777.6441319444444,MERGED,18,24,2,1,1,201,False,0,1,1,1561,42,0.3616666666666667,Document
C#,80,125,834.8192592592592,MERGED,44,51,5,0,3,82,False,0,0,0,1070,95,16.858888888888888,Document
Starlark,440,286,502.6376388888889,MERGED,0,6,1,0,1,58,False,0,0,0,1430,6,4.877777777777778,Bug
TypeScript,3393,2334,981.9154629629629,MERGED,1,2,1,1,1,327,False,0,1,1,1397,3,2.3105555555555557,Bug
TypeScript,307,2556,554.6744097222222,CLOSED,9,29,5,1,2,52,True,0,1,1,3355,38,1.458888888888889,Feature
JavaScript,34,25,212.51752314814814,MERGED,3,3,1,1,2,0,False,0,1,1,1151,6,1.3380555555555556,Bug
Erlang,2054,12122,3808.1747685185182,MERGED,2,3,1,0,1,375,True,0,0,0,1253,5,9.117777777777778,Document
TypeScript,261,3765,689.7312962962964,MERGED,267,302,29,0,1,596,True,0,0,0,5165,569,0.25333333333333335,Document
Python,2407,12180,252.97659722222224,CLOSED,9,13,2,0,7,272,True,0,0,0,1449,22,0.8941666666666667,Bug
JavaScript,0,0,6.95400462962963,CLOSED,2,15,3,0,1,5,False,0,0,0,1586,17,0.15222222222222223,Document
C#,80,125,834.4524189814815,MERGED,2,1155,12,0,2,176,True,0,0,0,1092,1157,24.26638888888889,Document
Erlang,2054,12122,3807.83369212963,MERGED,6,0,2,0,1,487,True,0,0,0,1137,6,17.752777777777776,Document
TypeScript,149,2900,391.80995370370374,CLOSED,3,75,6,2,1,102,False,0,2,2,3053,78,935.3533333333334,Bug
TypeScript,1297,21107,430.67099537037035,MERGED,596,605,7,1,2,969,True,0,1,1,3611,1201,2.602777777777778,Document
Java,450,746,4086.974814814815,MERGED,2,23,1,1,2,39,False,0,1,1,1383,25,0.3591666666666667,Feature
Erlang,2054,12122,3807.978576388889,MERGED,1,1,1,0,1,374,True,0,0,0,1177,2,4.6627777777777775,Document
Erlang,2054,12122,3807.955740740741,MERGED,2,6,2,0,1,373,True,0,0,0,1446,8,0.38333333333333336,Document
Erlang,2054,12122,3807.882511574074,MERGED,1,1,1,0,1,372,True,0,0,0,1155,2,0.08277777777777778,Document
Erlang,2054,12122,3807.846666666667,MERGED,25,140,11,0,3,371,True,0,0,0,1417,165,1.6016666666666666,Document
TypeScript,61,71,1685.4294791666669,MERGED,84,357,14,3,7,5,True,1,2,1,4016,441,67.1325,Bug
TypeScript,41368,87412,2953.7356018518517,CLOSED,6,31,2,1,1,1605,True,1,0,0,3857,37,0.6375,Document
TypeScript,41368,87412,2953.7147685185187,MERGED,10,57,4,0,1,590,True,0,0,0,4117,67,0.47333333333333333,Document
TypeScript,41368,87412,2953.502164351852,MERGED,18,18,1,0,1,589,True,0,0,0,3249,36,8.6675,Document
Python,2407,12180,252.12071759259257,MERGED,32,0,1,0,2,133,True,0,0,0,1150,32,14.950833333333334,Bug
TypeScript,15,34,504.8041666666666,MERGED,58,112,21,0,10,950,False,0,0,0,1465,170,27.218333333333334,Feature
TypeScript,4,33,776.1354282407407,MERGED,5,7,3,2,1,600,True,1,1,1,1586,12,0.04722222222222222,Feature
Go,421,1654,1523.9120717592593,MERGED,24,128,5,0,1,90,False,0,0,0,5561,152,1.4661111111111111,Document
TypeScript,261,3765,689.6380787037037,MERGED,2,33,3,0,5,0,True,0,0,0,829,35,7.1433333333333335,Document
TypeScript,41368,87412,2952.868657407407,MERGED,5,83,6,1,5,1,True,0,1,1,4558,88,20.23611111111111,Document
TypeScript,202,107,1156.9367824074075,MERGED,21,31,6,4,2,150,True,0,4,4,4809,52,60.110277777777775,Document
Java,450,746,4085.173668981481,MERGED,59,167,8,1,10,146,False,0,1,1,3795,226,44.54833333333333,Document
TypeScript,307,2556,552.8497453703704,MERGED,90,262,6,0,3,186,True,0,0,0,4142,352,19.9125,Bug
TypeScript,3393,2334,981.0263541666667,MERGED,0,10,2,1,1,697,False,0,1,1,1448,10,0.1475,Feature
JavaScript,34,25,211.0575462962963,MERGED,6,8,1,0,1,8,False,0,0,0,1333,14,0.22833333333333333,Bug
TypeScript,1073,11366,1107.6959375,MERGED,4,4,3,2,2,157,False,1,1,1,1630,8,0.3225,Bug
TypeScript,41368,87412,2952.6199421296296,MERGED,11,9,4,4,1,434,True,2,2,1,3281,20,6.558611111111111,Document
TypeScript,41368,87412,2951.765671296296,MERGED,0,12,1,1,5,1908,True,1,0,0,3194,12,44.93694444444444,Document
TypeScript,3393,2334,980.1884027777778,MERGED,6,6,2,2,4,458,False,0,2,1,1527,12,18.753055555555555,Bug
TypeScript,3393,2334,979.9857407407408,MERGED,1,2,1,2,2,457,False,0,2,1,1414,3,23.479166666666668,Bug
PHP,883,2338,1844.8714467592592,MERGED,17,41,4,0,2,1,False,0,0,0,4747,58,0.043055555555555555,Document
TypeScript,41368,87412,2952.5960532407407,MERGED,12,13,1,0,1,588,True,0,0,0,3364,25,0.4502777777777778,Document
TypeScript,149,2900,391.7371759259259,MERGED,2,2,1,1,1,101,False,0,1,1,1265,4,0.25666666666666665,Bug
TypeScript,4,33,775.0497685185186,MERGED,2,3,2,2,1,210,True,1,1,1,1216,5,0.04833333333333333,Bug
TypeScript,3393,2334,980.1526157407408,MERGED,5,8,2,1,2,326,False,0,1,1,1507,13,1.2941666666666667,Bug
TypeScript,3393,2334,980.1268865740741,MERGED,0,15,2,1,1,325,False,0,1,1,1383,15,0.15861111111111112,Feature
TypeScript,1073,11366,1106.5948611111112,MERGED,73,95,4,1,4,152,False,0,1,1,1765,168,3.631111111111111,Feature
Erlang,2054,12122,3808.9434375,MERGED,70,354,13,2,7,377,True,1,1,1,1630,424,239.1988888888889,Document
TypeScript,41368,87412,2949.8080555555553,MERGED,0,412,6,0,2,430,True,0,0,0,3613,412,88.38027777777778,Document
Go,1835,11245,1743.663900462963,MERGED,0,19,2,0,2,145,False,0,0,0,1595,19,3.4588888888888887,Feature
TypeScript,41368,87412,2951.499502314815,MERGED,3,4,3,0,1,1907,True,0,0,0,3342,7,2.8394444444444447,Document
JavaScript,0,0,4.140358796296296,CLOSED,2,14,3,0,1,3,False,0,0,0,1594,16,0.19555555555555557,Document
Erlang,2054,12122,3812.0376504629626,MERGED,28,56,9,0,2,380,True,0,0,0,1551,84,0.5936111111111111,Document
Go,1835,11245,1743.0774189814813,MERGED,1,24,2,1,1,144,False,0,1,1,1443,25,0.5077777777777778,Feature
Python,2407,12180,257.0179976851852,MERGED,1,1,1,2,2,0,False,1,1,1,1714,2,45.51861111111111,Document
TypeScript,41368,87412,2950.5150925925923,MERGED,69,162,4,0,2,579,True,0,0,0,3233,231,1.6658333333333333,Document
TypeScript,149,2900,394.9711574074074,MERGED,12,181,9,5,5,106,False,2,3,3,2668,193,648.1127777777778,Feature
TypeScript,7,6,661.0059259259259,MERGED,118,282,7,0,2,223,False,0,0,0,7182,400,439.8727777777778,Bug
Python,2407,12180,257.0933680555556,MERGED,7,11,1,5,2,289,True,3,2,2,2111,18,0.14777777777777779,Document
Go,1835,11245,1742.209351851852,MERGED,1,1,1,0,1,141,False,0,0,0,1279,2,0.23666666666666666,Feature
TypeScript,41368,87412,2949.714652777778,MERGED,15,15,5,0,1,1,False,0,0,0,4291,30,1.2875,Document
Rust,264,5382,417.96763888888887,MERGED,95,5104,33,2,1,415,False,1,1,1,5794,5199,6.071944444444444,Document
TypeScript,41368,87412,2949.5193634259263,MERGED,13,220,12,0,1,577,True,0,0,0,4290,233,1.54,Document
TypeScript,149,2900,394.9603009259259,MERGED,71,87,5,1,1,105,False,0,1,1,2200,158,98.7461111111111,Bug
Python,2407,12180,255.9368287037037,MERGED,7,0,1,2,1,3,False,0,2,2,1941,7,6.345277777777778,Document
Starlark,440,286,504.36591435185187,MERGED,15,14,1,0,1,1,False,0,0,0,2329,29,61.22416666666667,Feature
Python,137,75,698.223136574074,MERGED,0,152,9,1,6,6,False,1,0,0,2296,152,69.28,Document
Erlang,2054,12122,3810.402106481481,MERGED,102,355,15,2,10,346,False,0,2,1,2063,457,120.04555555555555,Document
Python,2407,12180,255.4177083333333,MERGED,3,3,1,0,1,2,False,0,0,0,1671,6,0.9155555555555556,Document
Python,2407,12180,255.3942939814815,CLOSED,3,3,1,1,1,1,False,1,0,0,1879,6,0.4891666666666667,Document
Python,2407,12180,255.38841435185188,CLOSED,3,3,1,0,1,0,False,0,0,0,1668,6,0.08472222222222223,Document
TypeScript,58,78,834.3584375,MERGED,19,2667,12,2,12,187,True,1,1,1,9308,2686,69.34027777777777,Bug
Vue,293,495,845.8485532407408,MERGED,6,10,1,4,1,350,True,0,4,2,1691,16,0.09638888888888889,Document
Python,2407,12180,255.11174768518518,MERGED,8,142,5,1,6,284,True,1,0,0,1586,150,3.004722222222222,Document
Python,2407,12180,254.91613425925925,MERGED,3,6,1,8,2,0,False,5,3,1,2143,9,7.716944444444445,Document
TypeScript,4,33,778.6311689814816,MERGED,718,978,99,2,1,603,True,1,1,1,1887,1696,20.253611111111113,Document
Python,2407,12180,254.0176851851852,MERGED,1,4,1,4,5,279,True,3,1,1,1605,5,29.551111111111112,Document
TypeScript,3393,2334,983.1713078703705,MERGED,3,3,1,1,1,121,False,0,1,1,1665,6,0.29083333333333333,Bug
Python,2407,12180,255.52288194444444,MERGED,45,92,13,1,6,287,True,0,1,1,2212,137,11.002222222222223,Document
TypeScript,85,723,330.3631365740741,MERGED,52,256,17,0,7,165,False,0,0,0,8818,308,19.73138888888889,Document
Python,2407,12180,252.84844907407407,MERGED,2,3,2,9,5,0,False,5,4,1,1760,5,57.45472222222222,Document
Starlark,440,286,502.1931597222222,MERGED,0,284,3,1,1,0,False,1,0,0,1968,284,15.536388888888888,Document
TypeScript,202,107,1160.7820949074073,MERGED,165,156,11,12,13,70,True,1,11,4,7074,321,429.8202777777778,Document
Python,2407,12180,253.72869212962962,MERGED,3,11,1,0,2,277,True,0,0,0,2092,14,0.9536111111111111,Document
Erlang,2054,12122,3808.676863425926,MERGED,1,1,1,0,1,376,True,0,0,0,1863,2,0.9091666666666667,Document
Python,2407,12180,252.87859953703705,MERGED,1,3,1,2,2,0,False,1,1,1,2032,4,21.439166666666665,Document
Java,1,10,243.93810185185183,MERGED,490,537,11,0,3,8,False,0,0,0,11642,1027,0.21472222222222223,Document
Go,1835,11245,1745.2143402777776,MERGED,1,2,1,4,1,2,False,2,2,1,2025,3,60.46888888888889,Document
Python,2407,12180,252.66655092592592,MERGED,28,16,5,0,6,72,True,0,0,0,1667,44,1.9213888888888888,Document
TypeScript,4,33,776.391724537037,MERGED,340,1091,26,2,7,602,True,1,1,1,2096,1431,25.468333333333334,Document
TypeScript,1073,11366,1108.809826388889,MERGED,0,1,1,0,1,30,True,0,0,0,1962,1,0.0075,Bug
TypeScript,261,3765,688.7328703703703,MERGED,115,255,4,0,2,593,True,0,0,0,9963,370,23.1475,Document
Go,182,37,1722.2524768518517,MERGED,97,39,8,3,8,448,False,3,0,0,6136,136,21.371111111111112,Document
Python,2407,12180,252.11687500000002,MERGED,17,15,2,0,2,271,True,0,0,0,1922,32,15.078888888888889,Document
TypeScript,1073,11366,1108.5907060185184,MERGED,0,6,2,1,1,160,False,0,1,1,2282,6,0.13694444444444445,Feature
TypeScript,41368,87412,2952.61818287037,MERGED,18,32,4,3,3,1603,True,1,2,1,4595,50,5.509166666666666,Document
TypeScript,4,33,776.6048611111111,MERGED,66,155,7,0,3,197,False,0,0,0,2232,221,0.020833333333333332,Document
TypeScript,41368,87412,2951.4207291666667,MERGED,3,10,3,3,5,50,True,1,2,1,2318,13,61.59305555555556,Document
TypeScript,4,33,776.2168634259259,MERGED,8,36,8,2,1,601,True,1,1,1,1781,44,0.5166666666666667,Document
Starlark,440,286,503.3268634259259,MERGED,0,270,2,6,8,0,False,3,3,2,2809,270,419.6041666666667,Feature
TypeScript,4,33,775.051111111111,MERGED,75,171,10,2,20,211,True,1,1,1,2202,246,28.571944444444444,Bug
Python,14532,41182,1099.8796875,CLOSED,0,2,1,0,2,0,False,0,0,0,1785,2,0.056666666666666664,Document
TypeScript,3393,2334,980.1057175925926,MERGED,1,2,1,1,5,695,False,0,1,1,1956,3,0.15861111111111112,Bug
JavaScript,0,0,4.200104166666667,CLOSED,1,13,2,0,1,4,False,0,0,0,1564,14,47.79472222222222,Document
TypeScript,4,33,775.4489120370371,MERGED,259,513,20,1,10,368,False,0,1,1,2073,772,0.8630555555555556,Bug
TypeScript,149,2900,391.71333333333337,MERGED,11,3,1,1,1,181,True,0,1,1,1972,14,0.8386111111111111,Feature
TypeScript,1073,11366,1106.543715277778,MERGED,1,2,1,1,1,151,False,0,1,1,1747,3,28.32888888888889,Bug
TypeScript,261,3765,690.6987962962962,MERGED,270,322,20,0,3,194,False,0,0,0,8376,592,0.3113888888888889,Document
TypeScript,1073,11366,1106.6226041666666,MERGED,9,11,1,1,1,132,False,0,1,1,2008,20,1.256388888888889,Document
JavaScript,5139,7050,1219.5858680555555,MERGED,70,246,9,4,9,259,False,2,2,2,9806,316,117.67166666666667,Feature
Go,30,295,362.97875,MERGED,5,327,16,6,20,97,True,1,5,2,7469,332,147.1461111111111,Feature
Go,1835,11245,1743.866041666667,MERGED,12,51,2,0,1,147,False,0,0,0,2018,63,1.1216666666666666,Document
Go,1835,11245,1743.822476851852,MERGED,3,23,2,0,3,146,False,0,0,0,1790,26,0.08194444444444444,Document
Go,421,1654,1523.9788657407407,MERGED,130,55,13,0,1,241,False,0,0,0,9828,185,25.629444444444445,Bug
JavaScript,8844,63474,4094.302025462963,MERGED,128,283,35,0,2,107,True,0,0,0,7181,411,120.45611111111111,Document
TypeScript,7,6,660.9782523148148,MERGED,133,1372,83,1,11,16,True,0,1,1,6775,1505,93.53083333333333,Feature
TypeScript,261,3765,688.7658449074074,MERGED,30,471,45,0,4,253,True,0,0,0,8418,501,19.75027777777778,Document
TypeScript,1073,11366,1107.1322337962963,MERGED,293,1548,16,12,10,3,False,5,7,4,2653,1841,419.6277777777778,Bug
Rust,433,2229,251.78515046296297,MERGED,2,2,2,6,2,90,False,1,5,3,2715,4,266.0661111111111,Feature
Go,30,295,364.3143518518518,MERGED,58,181,3,1,3,157,True,0,1,1,5515,239,0.3663888888888889,Feature
Starlark,440,286,503.1116203703704,MERGED,0,213,5,0,15,1,False,0,0,0,2459,213,255.83833333333334,Document
TypeScript,3393,2334,984.6299421296297,MERGED,328,13,4,2,1,0,False,0,2,1,3252,341,131.66666666666666,Feature
Rust,417,2801,937.1255787037038,MERGED,102,148,6,0,5,205,False,0,0,0,7477,250,8.574722222222222,Document
Rust,413,5117,479.5884490740741,MERGED,29,55,2,4,11,5,False,0,4,3,2675,84,342.0469444444444,Document
C++,2234,23694,2371.002013888889,MERGED,79,242,6,3,30,285,False,1,2,2,6921,321,136.24194444444444,Bug
TypeScript,307,2556,554.7396643518518,MERGED,180,228,11,1,4,188,True,1,0,0,6837,408,142.73388888888888,Bug
V,2097,34361,1569.6912268518518,MERGED,59,94,3,9,5,0,False,4,5,2,6150,153,28.645,Document
JavaScript,8844,63474,4092.5237731481484,MERGED,34,112,23,0,2,103,True,0,0,0,8119,146,23.174444444444443,Document
Python,2407,12180,255.4810300925926,MERGED,9,9,4,0,9,286,True,0,0,0,2073,18,0.5347222222222222,Document
Python,4516,54985,943.6002199074073,CLOSED,0,64,2,1,1,8,False,0,1,1,3198,64,29.31833333333333,Document
Python,137,75,698.8661111111111,MERGED,3,7,2,1,4,236,False,0,1,1,2253,10,87.23083333333334,Bug
Starlark,440,286,506.15369212962963,MERGED,0,347,2,1,1,0,False,1,0,0,2236,347,18.409444444444443,Document
TypeScript,1073,11366,1110.6071875,MERGED,6,12,3,2,2,165,False,1,1,1,2315,18,93.64305555555555,Document
JavaScript,8844,63474,4091.470798611111,MERGED,155,356,5,0,1,99,True,0,0,0,8809,511,16.8575,Bug
TypeScript,41368,87412,2954.211886574074,MERGED,19,42,2,0,2,0,False,0,0,0,7006,61,6.255277777777778,Document
TypeScript,41368,87412,2954.605578703704,MERGED,10,81,4,6,6,11,True,3,3,3,4874,91,50.67944444444444,Document
JavaScript,8844,63474,4090.3509027777777,MERGED,59,239,13,1,1,98,True,0,1,1,6340,298,26.039444444444445,Document
JavaScript,8844,63474,4089.4334490740744,MERGED,306,1427,91,0,12,97,True,0,0,0,6027,1733,48.30555555555556,Document
TypeScript,1073,11366,1108.946539351852,CLOSED,0,1,1,1,2,0,False,0,1,1,2421,1,88.425,Bug
TypeScript,4,33,778.1167013888889,MERGED,226,281,23,2,23,214,True,1,1,1,2790,507,23.58861111111111,Document
TypeScript,4,33,778.516087962963,MERGED,45,69,4,1,1,202,False,0,1,1,3464,114,0.017222222222222222,Document
TypeScript,41368,87412,2953.471238425926,MERGED,27,20,5,7,4,12,False,2,5,2,5739,47,22.974444444444444,Document
Starlark,440,286,503.6209837962963,MERGED,16,30,2,0,2,59,False,0,0,0,2635,46,3.3744444444444444,Document
Python,2407,12180,253.68490740740742,MERGED,49,42,13,0,5,275,True,0,0,0,2890,91,2.6355555555555554,Document
Python,4516,54985,938.7445138888888,MERGED,1,4,1,3,2,7,False,2,1,1,2361,5,86.805,Document
TypeScript,1073,11366,1109.0934375,MERGED,0,1,1,2,2,0,False,0,2,2,2142,1,14.824444444444444,Bug
TypeScript,1073,11366,1108.8444791666668,MERGED,1,1,1,0,1,31,True,0,0,0,2332,2,17.066666666666666,Document
TypeScript,1297,21107,429.5391550925926,MERGED,33,11,28,1,1,967,True,0,1,1,5069,44,0.1225,Document
TypeScript,3393,2334,981.0059375000001,MERGED,19,8,4,4,2,269,False,1,3,2,2960,27,20.160833333333333,Feature
TypeScript,41368,87412,2952.435300925926,MERGED,40,53,1,8,8,431,True,5,3,1,4740,93,10.97638888888889,Document
TypeScript,1073,11366,1108.7804513888889,MERGED,13,42,3,0,2,163,False,0,0,0,2823,55,0.4925,Feature
TypeScript,3393,2334,981.1046180555555,MERGED,4,8,2,1,1,116,False,0,1,1,2698,12,1.8447222222222222,Feature
TypeScript,41368,87412,2951.6058680555557,MERGED,25,147,9,18,21,3,False,6,12,4,3534,172,23.38277777777778,Document
TypeScript,41368,87412,2951.934826388889,MERGED,31,29,10,0,5,586,True,0,0,0,5265,60,0.42194444444444446,Document
Rust,413,5117,480.73776620370376,MERGED,945,18,9,0,3,121,False,0,0,0,2520,963,1.745,Document
JavaScript,34,25,211.10423611111113,MERGED,18,18,15,0,1,9,False,0,0,0,3581,36,0.09305555555555556,Feature
Go,1835,11245,1744.8043171296297,MERGED,2,2,1,4,1,0,False,1,3,2,1992,4,1.6275,Document
TypeScript,307,2556,550.7131134259259,MERGED,9,60,10,1,1,185,True,0,1,1,6225,69,0.9872222222222222,Bug
Go,1835,11245,1744.6212384259259,MERGED,1,2,1,0,1,527,False,0,0,0,2226,3,0.07694444444444444,Document
Starlark,440,286,505.19670138888887,MERGED,0,2623,6,9,14,1,False,3,6,2,3767,2623,523.8722222222223,Document
TypeScript,41368,87412,2949.78025462963,MERGED,1,47,3,2,1,578,True,1,1,1,6393,48,0.8086111111111111,Document
TypeScript,7,6,661.1745486111112,MERGED,3,378,14,0,36,17,True,0,0,0,8488,381,162.64222222222222,Feature
Go,1835,11245,1742.0871875,MERGED,28,46,1,0,1,139,False,0,0,0,2992,74,0.5613888888888889,Document
Python,2407,12180,252.09021990740743,MERGED,55,389,18,0,46,269,True,0,0,0,3948,444,478.0761111111111,Feature
TypeScript,1073,11366,1106.8671412037036,MERGED,23,67,3,1,2,133,False,0,1,1,3551,90,502.57472222222225,Document
Python,4516,54985,942.2466319444444,MERGED,21,144,2,2,9,3,False,1,1,1,4468,165,298.00083333333333,Document
Python,137,75,702.0596527777778,MERGED,0,169,11,0,7,7,False,0,0,0,3348,169,94.20388888888888,Bug
Erlang,2054,12122,3812.3196875,MERGED,17,82,3,0,1,351,False,0,0,0,2810,99,115.65583333333333,Document
TypeScript,184,377,1927.7567361111112,MERGED,14,30,5,0,2,225,False,0,0,0,4292,44,3.3941666666666666,Document
TypeScript,3393,2334,985.2432291666668,MERGED,18,18,6,3,1,0,False,0,3,2,4828,36,52.229166666666664,Bug
Python,2407,12180,256.98287037037034,MERGED,1,1,1,2,2,0,False,1,1,1,3773,2,46.135,Document
Python,2407,12180,256.29898148148146,MERGED,79,5,3,1,3,288,True,0,1,1,3549,84,3.2494444444444444,Document
V,2097,34361,1566.7134143518517,MERGED,169,259,9,0,3,36,True,0,0,0,8811,428,4.763888888888889,Document
TypeScript,184,377,1924.696550925926,MERGED,25,27,3,2,2,32,False,1,1,1,3511,52,24.967222222222222,Document
Python,4516,54985,940.1551851851851,MERGED,40,40,1,0,3,53,False,0,0,0,3972,80,127.22916666666667,Document
Python,4516,54985,941.4919328703704,MERGED,0,87,2,6,24,0,False,3,3,2,4257,87,50.35611111111111,Document
TypeScript,4,33,779.311701388889,MERGED,100,147,15,1,5,372,False,0,1,1,4884,247,0.25194444444444447,Bug
Python,4516,54985,938.652337962963,MERGED,213,1,2,3,2,1,False,2,1,1,3814,214,162.8552777777778,Document
Python,4516,54985,938.1528819444444,MERGED,8,9,1,9,7,0,False,4,5,2,3557,17,174.78833333333333,Document
TypeScript,4,33,778.344375,MERGED,557,595,71,1,11,370,False,0,1,1,3928,1152,21.695833333333333,Document
Python,2407,12180,254.90619212962963,MERGED,24,66,5,0,14,283,True,0,0,0,3959,90,7.964722222222222,Document
TypeScript,41368,87412,2950.717928240741,MERGED,210,390,20,1,15,84,True,0,1,1,7617,600,41.47888888888889,Document
Python,4516,54985,941.5442592592593,CLOSED,0,77,2,1,6,1,False,0,1,1,4002,77,20.618333333333332,Document
Python,2407,12180,253.9374189814815,MERGED,4,4,1,10,5,0,False,7,3,1,2968,8,31.333055555555557,Document
TypeScript,4,33,778.2278009259259,MERGED,15,208,12,1,9,369,False,0,1,1,4444,223,1.676111111111111,Feature
TypeScript,3393,2334,982.8169907407408,MERGED,12,41,8,1,3,118,False,0,1,1,3581,53,0.5786111111111111,Bug
Go,1835,11245,1744.8623032407406,CLOSED,4161,5224,349,1,39,2,False,0,1,1,4115,9385,137.65527777777777,Document
Go,1835,11245,1744.6752314814814,MERGED,1,4,1,4,1,0,False,1,3,2,3048,5,144.6886111111111,Document
JavaScript,8844,63474,4091.524861111111,MERGED,120,524,52,9,26,101,True,3,6,2,12450,644,520.3275,Bug
Python,2407,12180,253.28453703703704,MERGED,2,143,1,0,13,274,True,0,0,0,3070,145,11.629166666666666,Document
Python,2407,12180,253.01474537037038,MERGED,12,12,2,2,13,273,True,1,1,1,3562,24,18.164722222222224,Document
TypeScript,4,33,776.9178703703705,MERGED,198,328,16,1,5,199,False,0,1,1,4494,526,0.315,Feature
TypeScript,4,33,776.2173148148148,MERGED,38,69,10,2,6,212,True,1,1,1,3623,107,20.37638888888889,Feature
TypeScript,4,33,776.6510532407407,MERGED,67,180,24,1,3,198,False,0,1,1,3474,247,0.11888888888888889,Document
Starlark,440,286,502.60035879629635,MERGED,3,19,1,0,1,57,False,0,0,0,4134,22,5.768055555555556,Feature
Go,1835,11245,1746.1969212962965,MERGED,23,17,9,0,4,149,False,0,0,0,4213,40,10.104166666666666,Document
TypeScript,3393,2334,979.9867824074073,MERGED,114,178,6,1,186,694,False,0,1,1,5218,292,45.656666666666666,Feature
Go,1835,11245,1745.1058912037035,MERGED,100,58,4,0,1,148,False,0,0,0,4170,158,22.518055555555556,Document
Python,137,75,700.2116435185185,MERGED,0,59,4,1,7,0,False,0,1,1,6339,59,856.1763888888889,Bug
TypeScript,3393,2334,980.1884606481482,MERGED,15,51,7,1,4,696,False,0,1,1,3976,66,0.8911111111111111,Feature
TypeScript,1073,11366,1107.5197453703704,MERGED,37,53,3,1,3,155,False,0,1,1,3700,90,1.47,Bug
Java,450,746,4085.2360532407406,MERGED,44029,61704,11,1,6,38,False,0,1,1,4773,105733,17.088333333333335,Feature
Python,4516,54985,938.2182291666667,MERGED,1,4,1,1,1,0,False,0,1,1,3842,5,2.1655555555555557,Document
TypeScript,2147,14722,1485.9591319444444,MERGED,155,426,17,0,1,295,False,0,0,0,15118,581,187.7186111111111,Document
Go,1835,11245,1743.0872800925927,MERGED,76,28,7,0,1,525,False,0,0,0,3947,104,10.92361111111111,Document
TypeScript,7,6,661.3821064814815,MERGED,796,1102,37,0,28,244,False,0,0,0,13579,1898,162.90472222222223,Document
Go,1835,11245,1742.8762962962962,MERGED,186,47,5,0,1,524,False,0,0,0,3885,233,0.9363888888888889,Document
Go,1835,11245,1742.7746064814817,MERGED,1,4136,34,1,6,143,False,0,1,1,4834,4137,2.106388888888889,Document
Go,1835,11245,1742.1246180555556,MERGED,40,58,7,0,2,140,False,0,0,0,3662,98,0.9813888888888889,Document
TypeScript,7,6,659.0861689814815,MERGED,28,2535,51,0,82,266,False,0,0,0,12557,2563,168.505,Document
Go,30,295,362.9353356481481,MERGED,2193,2434,226,2,2,96,True,0,2,1,12622,4627,27.407777777777778,Feature
TypeScript,261,3765,690.6482407407407,MERGED,1469,653,25,0,7,165,False,0,0,0,14937,2122,2.735,Document
Python,4516,54985,942.65125,MERGED,64,85,1,3,3,1,False,1,2,1,4950,149,483.37166666666667,Document
Rust,264,5383,416.1805555555556,MERGED,618,1057,96,0,3,161,False,0,0,0,12505,1675,71.315,Bug
TypeScript,41368,87412,2954.484201388889,MERGED,144,812,30,1,15,199,False,0,1,1,10861,956,0.4663888888888889,Document
TypeScript,184,377,1926.165196759259,MERGED,1,1,1,1,1,30,False,1,0,0,4319,2,42.07694444444444,Document
TypeScript,41368,87412,2950.726435185185,MERGED,174,525,29,1,12,581,True,0,1,1,10877,699,1.3163888888888888,Document
Python,2407,12180,258.2086111111111,MERGED,5,16,7,1,3,290,True,1,0,0,5819,21,2.560277777777778,Document
Go,2,11,1159.2259953703704,MERGED,62,371,11,1,16,35,False,0,1,1,5588,433,52.374722222222225,Document
Python,2407,12180,255.60561342592595,MERGED,346,335,9,0,15,135,True,0,0,0,5288,681,3.4344444444444444,Feature
Python,137,75,698.2169560185185,MERGED,36,208,15,0,10,21,False,0,0,0,6886,244,103.29055555555556,Bug
TypeScript,261,3765,688.7478124999999,MERGED,45,111,23,0,5,139,True,0,0,0,10582,156,1.8488888888888888,Document
Python,4516,54985,943.1992476851851,MERGED,29,108,2,1,9,141,False,1,0,0,5239,137,1.5041666666666667,Document
Python,2407,12180,254.11494212962964,MERGED,19,48,3,0,14,281,True,0,0,0,5722,67,27.282777777777778,Document
Python,2407,12180,253.73719907407406,MERGED,73,236,23,0,8,278,True,0,0,0,6390,309,1.4847222222222223,Document
Java,450,746,4087.1790393518518,MERGED,78,454,15,1,19,40,False,0,1,1,5650,532,45.022777777777776,Document
Go,789,5551,1053.0733680555556,MERGED,28,431,5,2,1,5,False,2,0,0,5006,459,3.3672222222222223,Document
Python,4516,54985,938.0463194444445,MERGED,0,19,2,6,8,1,False,3,3,2,6593,19,102.91722222222222,Document
Python,2407,12180,252.1113310185185,MERGED,151,1159,41,0,13,270,True,0,0,0,6209,1310,16.1875,Document
TypeScript,1073,11366,1107.651701388889,CLOSED,16,94,4,1,1,129,True,0,1,1,6232,110,21.579166666666666,Feature
TypeScript,1073,11366,1107.6612037037037,MERGED,11,26,8,1,2,156,False,0,1,1,5578,37,0.23,Bug
Go,1835,11245,1744.9967361111112,MERGED,31,46,7,0,2,60,False,0,0,0,5736,77,28.888055555555557,Document
TypeScript,1073,11366,1106.5671296296296,MERGED,45,186,15,1,11,753,True,0,1,1,6516,231,27.404722222222222,Document
JavaScript,34,25,210.0073263888889,MERGED,2,32,13,0,1,76,False,0,0,0,6218,34,0.3486111111111111,Document
JavaScript,0,0,3.8861226851851853,CLOSED,0,11206,61,1,1,1,False,1,0,0,5258,11206,3.23,Document
Go,1835,11245,1743.8032060185185,MERGED,72,94,6,0,2,526,False,0,0,0,6332,166,1.1513888888888888,Document
Go,1835,11245,1743.6139699074074,MERGED,20,254,12,0,2,59,False,0,0,0,5211,274,7.001388888888889,Document
Go,1835,11245,1742.7153819444445,MERGED,91,531,11,1,1,523,False,1,0,0,6340,622,1.8411111111111111,Document
JavaScript,8844,63474,4093.3496527777775,MERGED,48,290,29,2,3,106,True,1,1,1,15781,338,140.34944444444446,Document
Python,1912,12140,81.97280092592592,MERGED,0,179,6,2,2,2,False,1,1,1,4707,179,0.8783333333333333,Feature
TypeScript,4,33,780.280636574074,MERGED,98,186,19,1,9,373,False,0,1,1,7953,284,0.5566666666666666,Bug
TypeScript,3393,2334,980.875474537037,MERGED,54,352,10,1,8,115,False,0,1,1,8237,406,8.435555555555556,Feature
TypeScript,1073,11366,1108.550787037037,MERGED,87,228,13,2,3,83,True,0,2,2,8783,315,0.8236111111111111,Bug
Rust,264,5383,420.82228009259256,MERGED,18,201,21,10,1,0,False,4,6,3,23986,219,168.01527777777778,Bug
TypeScript,4,33,777.4404861111111,MERGED,286,653,31,1,8,200,False,0,1,1,13077,939,3.4366666666666665,Document
TypeScript,58,78,843.0686342592593,CLOSED,7,39,4,2,2,195,True,1,1,1,1676,46,1830.6122222222223,Document
V,2097,34361,1571.0115856481482,CLOSED,2,29,2,0,3,24,True,0,0,0,792,31,3.9244444444444446,Bug
Vue,293,495,849.9666435185185,MERGED,25,25,8,5,1,19,False,0,5,5,1026,50,20.098333333333333,Bug
JavaScript,5139,7050,1223.6612499999999,MERGED,1,1,1,2,1,0,False,0,2,2,600,2,1497.0641666666668,Document
V,2097,34361,1571.0294212962963,MERGED,9,10,2,0,2,25,True,0,0,0,1392,19,32.749722222222225,Document
V,2097,34361,1570.7769097222224,MERGED,1,0,1,0,1,23,True,0,0,0,1600,1,38.78944444444444,Bug
Vue,10806,21162,1044.3142592592592,MERGED,31,108,2,1,3,30,False,0,1,1,2817,139,2029.7394444444444,Document
C#,80,125,842.530150462963,CLOSED,769,685,2,0,1,180,True,0,0,0,623,1454,1969.7427777777777,Document
TypeScript,7,6,668.0343865740741,MERGED,1,7,1,0,11,24,False,0,0,0,1266,8,1484.6786111111112,Feature
PHP,1334,2960,4231.013217592593,MERGED,2,7,1,0,1,70,False,0,0,0,1502,9,1127.3022222222223,Document
Python,547,7160,2259.644548611111,MERGED,2,2,2,0,4,78,False,0,0,0,586,4,1486.6766666666667,Bug
Rust,264,5383,425.97937499999995,MERGED,45,856,36,5,39,0,False,0,5,1,2869,901,290.87416666666667,Bug
TypeScript,41368,87412,2959.732928240741,MERGED,42,214,10,2,12,21,False,0,2,2,2458,256,1967.8855555555556,Document
TypeScript,7,6,666.1082060185184,CLOSED,11,11,7,0,4,19,True,0,0,0,2202,22,1490.3027777777777,Feature
Go,1835,11245,1751.6539699074074,MERGED,9,10,1,0,1,111,False,0,0,0,189,19,7.139166666666667,Feature
TypeScript,2147,14722,1493.853298611111,MERGED,2,87,3,0,1,719,False,0,0,0,1252,89,4.928333333333334,Document
JavaScript,5139,7050,1224.744363425926,MERGED,2,11,2,1,6,108,False,0,1,1,1636,13,1033.5027777777777,Document
Go,1835,11245,1751.9378125,CLOSED,0,35,1,0,1,112,False,0,0,0,250,35,64.00861111111111,Feature
Go,1835,11245,1749.8677083333332,MERGED,149,10,1,0,1,109,False,0,0,0,364,159,0.8433333333333334,Feature
TypeScript,261,3765,697.8533796296297,CLOSED,1,1,1,3,1,0,False,0,3,1,1011,2,638.8269444444444,Document
TypeScript,2147,14722,1495.1398263888889,MERGED,50,49,2,0,2,722,False,0,0,0,1992,99,90.88055555555556,Document
TypeScript,2147,14722,1493.7669675925927,MERGED,9,15,1,0,1,717,False,0,0,0,2090,24,0.38472222222222224,Bug
Go,30,295,370.18619212962966,MERGED,0,238,1,0,1,162,True,0,0,0,1424,238,0.036944444444444446,Document
Go,30,295,370.0780555555555,MERGED,3,3,2,0,1,100,True,0,0,0,1278,6,0.03833333333333333,Bug
Rust,264,5383,425.322337962963,CLOSED,1,19,3,4,3,243,True,2,2,2,1389,20,997.5061111111111,Bug
Rust,264,5383,424.23207175925927,CLOSED,93,181,103,0,9,0,False,0,0,0,1001,274,716.8402777777778,Bug
Python,19249,70257,2480.0440972222223,CLOSED,67,64,21,10,5,121,False,5,5,3,1032,131,47.78472222222222,Bug
TypeScript,12,11,1012.4335648148149,MERGED,1,1,1,0,1,38,False,0,0,0,1062,2,141.27916666666667,Feature
Go,11875,71339,2719.8721527777775,MERGED,2,4,4,1,1,289,True,0,1,1,1063,6,47.63388888888889,Bug
C#,80,125,841.823113425926,CLOSED,0,7,1,0,1,88,False,0,0,0,1021,7,20.639722222222222,Document
C#,80,125,840.7129050925927,CLOSED,34,22,2,0,1,86,False,0,0,0,1157,56,0.5113888888888889,Document
PHP,1334,2960,4227.846203703703,CLOSED,2,1,1,7,1,87,False,3,4,2,1454,3,410.41055555555556,Document
Vue,293,495,851.6990856481481,MERGED,4,47,3,11,5,58,False,4,7,5,1135,51,627.6227777777777,Bug
TypeScript,2147,14722,1495.0665046296297,MERGED,1,1,1,0,1,83,False,0,0,0,707,2,1.4947222222222223,Bug
TypeScript,2147,14722,1494.8834143518518,MERGED,3,6,1,0,3,174,False,0,0,0,665,9,1.2041666666666666,Feature
C++,2234,23694,2376.9815046296294,MERGED,24,25,1,1,2,32,False,0,1,1,534,49,25.09777777777778,Bug
PHP,1334,2960,4229.213391203703,MERGED,3,38,5,1,4,161,False,0,1,1,926,41,332.1641666666667,Bug
TypeScript,2147,14722,1494.8548379629628,MERGED,3,39,5,0,1,721,False,0,0,0,2579,42,0.4841666666666667,Document
V,2097,34361,1573.614375,MERGED,4,145,8,5,5,216,True,3,2,2,1658,149,116.05194444444444,Document
Go,30,295,370.0848495370371,MERGED,7,23,3,0,1,42,True,0,0,0,1785,30,0.03638888888888889,Bug
PHP,883,2338,1855.041724537037,CLOSED,213,223,79,4,1,1,False,1,3,3,2248,436,1369.6491666666666,Document
TypeScript,2147,14722,1493.9531712962962,MERGED,2,20,2,0,1,173,False,0,0,0,695,22,0.11388888888888889,Feature
TypeScript,85,723,339.0555092592593,MERGED,0,4,1,0,1,15,False,0,0,0,1107,4,0.32166666666666666,Document
TypeScript,7,6,665.1111921296296,MERGED,24,154,10,0,13,225,False,0,0,0,2775,178,1320.6008333333334,Feature
TypeScript,2147,14722,1492.178101851852,MERGED,0,5,1,1,1,674,False,1,0,0,645,5,19.25777777777778,Feature
TypeScript,2147,14722,1492.1444097222222,MERGED,1,2,1,0,1,673,False,0,0,0,611,3,20.072222222222223,Bug
Vue,293,495,851.7224884259259,MERGED,3,2,1,5,1,59,False,0,5,5,776,5,291.8652777777778,Bug
Erlang,2054,12122,3819.136030092593,MERGED,2,15,3,2,3,1022,True,0,2,1,1232,17,161.34555555555556,Document
TypeScript,2147,14722,1495.852233796296,MERGED,4,19,1,0,1,675,False,0,0,0,1276,23,170.76472222222222,Feature
TypeScript,2147,14722,1494.0678240740742,MERGED,1,1,1,0,1,82,False,0,0,0,857,2,1.2122222222222223,Feature
PHP,1334,2960,4231.223622685185,MERGED,3,16,1,1,1,871,False,0,1,1,828,19,65.55611111111111,Feature
JavaScript,5139,7050,1227.6121990740742,CLOSED,0,215,1,3,1,0,False,0,3,2,728,215,0.27555555555555555,Feature
Python,19249,70257,2483.687581018519,CLOSED,9,7,2,1,5,237,False,1,0,0,643,16,5.066388888888889,Feature
PHP,1334,2960,4229.117569444445,MERGED,7,1,1,1,1,149,False,0,1,1,741,8,18.003611111111113,Feature
TypeScript,85,723,336.4638425925926,MERGED,1,1,1,0,1,5,False,0,0,0,1131,2,0.009444444444444445,Document
TypeScript,178,1359,345.3115740740741,MERGED,1,2,1,1,1,12,True,0,1,1,1151,3,61.846666666666664,Bug
C++,2234,23694,2379.931446759259,MERGED,1,1,1,1,1,218,False,0,1,1,502,2,0.055,Feature
TypeScript,85,723,335.18180555555557,MERGED,0,6,1,0,1,101,False,0,0,0,1155,6,18.565,Document
TypeScript,85,723,336.01537037037036,MERGED,0,1,1,0,2,13,False,0,0,0,1108,1,0.19,Document
TypeScript,85,723,335.9955671296296,MERGED,1,0,1,0,1,12,False,0,0,0,1198,1,0.17972222222222223,Document
TypeScript,2147,14722,1492.792175925926,MERGED,1,1,1,1,1,103,False,0,1,1,952,2,0.32222222222222224,Bug
Go,421,1654,1533.0519097222223,MERGED,0,1,1,0,1,245,False,0,0,0,885,1,1.7441666666666666,Bug
PHP,1334,2960,4230.129421296296,MERGED,16,19,1,2,1,204,False,1,1,1,1509,35,291.4477777777778,Feature
Python,547,7160,2258.6583217592593,MERGED,2,5,1,0,10,226,False,0,0,0,518,7,859.6791666666667,Bug
Rust,264,5383,427.0083680555556,MERGED,197,321,17,0,1,433,False,0,0,0,554,518,0.8888888888888888,Feature
TypeScript,2147,14722,1492.227349537037,MERGED,1,4,2,0,2,46,False,0,0,0,835,5,12.919722222222223,Bug
TypeScript,41368,87412,2959.772962962963,MERGED,73,466,10,2,15,76,True,1,1,1,3823,539,1775.1372222222221,Document
Python,19249,70257,2484.674814814815,CLOSED,8,94,12,1,12,242,False,1,0,0,781,102,144.61555555555555,Document
TypeScript,2071,16640,1264.1230902777777,CLOSED,3,51,3,0,3,1,False,0,0,0,4155,54,1626.505,Document
TypeScript,261,3765,699.743599537037,MERGED,10,9,2,0,1,105,True,0,0,0,1386,19,0.5619444444444445,Document
TypeScript,58,78,843.0879745370371,MERGED,0,85,3,1,8,122,False,0,1,1,1500,85,33.11388888888889,Feature
TypeScript,261,3765,699.707986111111,MERGED,0,66,2,0,1,177,False,0,0,0,1429,66,1.3680555555555556,Document
TypeScript,41368,87412,2958.755277777778,MERGED,37,1362,7,2,8,31,False,1,1,1,4505,1399,1797.6502777777778,Document
Vue,293,495,852.8193981481481,CLOSED,0,0,0,3,4,61,False,0,3,2,1039,0,599.9613888888889,Bug
TypeScript,261,3765,699.5393055555555,MERGED,1,7,2,0,2,260,True,0,0,0,976,8,0.5822222222222222,Document
TypeScript,12,11,1011.508425925926,MERGED,15,35,2,0,1,45,False,0,0,0,1780,50,14.855833333333333,Feature
PHP,1334,2960,4227.222256944445,MERGED,2,2,2,3,1,29,False,0,3,2,1811,4,531.2711111111112,Document
Rust,264,5383,425.9739236111111,CLOSED,2,19,1,0,1,263,True,0,0,0,671,21,1.6483333333333334,Bug
Rust,264,5383,425.76265046296294,CLOSED,1,1,1,1,1,244,True,0,1,1,656,2,0.06055555555555556,Feature
Rust,417,2801,945.3582407407407,MERGED,0,3,1,0,1,209,False,0,0,0,690,3,1.9472222222222222,Feature
TypeScript,58,78,843.0922569444446,CLOSED,4,5,2,1,1,197,True,0,1,1,1724,9,1.7641666666666667,Bug
Rust,417,2801,945.0018055555556,MERGED,8,3,2,0,2,208,False,0,0,0,787,11,0.25333333333333335,Feature
TypeScript,42,46,792.7678819444444,MERGED,4,15,1,1,18,23,False,0,1,1,378,19,2.5702777777777777,Feature
TypeScript,261,3765,698.7662731481481,MERGED,1,7,2,0,1,106,False,0,0,0,1584,8,0.5430555555555555,Document
JavaScript,5139,7050,1224.6908217592593,CLOSED,0,3,1,1,1,106,False,0,1,1,661,3,0.15611111111111112,Feature
TypeScript,7,6,668.1393518518519,MERGED,9,0,1,0,7,21,True,0,0,0,1024,9,102.56722222222223,Feature
TypeScript,261,3765,698.5100000000001,MERGED,1,9,2,0,1,203,False,0,0,0,1350,10,0.24305555555555555,Document
Rust,264,5383,425.0202546296296,CLOSED,1,1,1,0,1,342,False,0,0,0,712,2,3.4491666666666667,Bug
PHP,1334,2960,4229.062418981482,MERGED,2,2,1,1,1,148,False,0,1,1,942,4,0.37083333333333335,Document
TypeScript,2147,14722,1496.0606944444444,MERGED,1,114,6,0,1,0,False,0,0,0,2136,115,160.03333333333333,Feature
TypeScript,178,1359,343.42803240740744,MERGED,1,75,6,1,4,7,False,0,1,1,1036,76,1.6783333333333332,Feature
Python,547,7160,2261.544409722222,MERGED,3,3,1,0,1,287,True,0,0,0,668,6,0.01361111111111111,Bug
TypeScript,261,3765,697.7882407407407,MERGED,0,28,2,0,1,174,False,0,0,0,1377,28,0.11611111111111111,Document
Rust,264,5383,427.01814814814816,MERGED,2,0,1,0,1,147,False,0,0,0,994,2,66.5111111111111,Bug
TypeScript,12,11,1011.2709259259259,MERGED,15,30,3,0,3,42,False,0,0,0,2125,45,143.74555555555557,Feature
TypeScript,2147,14722,1495.0078819444443,MERGED,9,6,1,0,1,33,False,0,0,0,1076,15,0.8416666666666667,Feature
V,2097,34361,1571.6182638888888,MERGED,1,2,1,1,2,207,True,0,1,1,540,3,86.12222222222222,Bug
TypeScript,261,3765,697.4778124999999,MERGED,1,3,1,0,1,906,True,0,0,0,1349,4,0.49277777777777776,Document
Rust,264,5383,424.10054398148145,MERGED,9,9,2,1,1,68,False,1,0,0,711,18,1.2069444444444444,Bug
TypeScript,2147,14722,1494.2207175925926,MERGED,11,11,5,0,3,56,False,0,0,0,1297,22,13.317777777777778,Bug
Go,30,295,370.2545949074074,MERGED,19,91,2,1,2,163,True,0,1,1,2482,110,17.025833333333335,Bug
TypeScript,261,3765,696.8034722222222,MERGED,1,7,2,0,2,259,True,0,0,0,1428,8,0.26944444444444443,Document
TypeScript,261,3765,696.6583449074074,MERGED,6,9,2,0,2,172,False,0,0,0,1376,15,0.6702777777777778,Document
TypeScript,178,1359,340.7179398148148,MERGED,0,11,1,3,2,0,False,1,2,2,1254,11,66.13944444444445,Feature
PHP,1334,2960,4231.018460648148,MERGED,1,1,1,1,1,1,False,0,1,1,1484,2,71.04333333333334,Document
TypeScript,261,3765,696.5097222222222,MERGED,0,22,1,0,1,903,True,0,0,0,1339,22,2.88,Document
Go,30,295,368.9817013888889,MERGED,10,52,4,6,7,159,True,3,3,1,3148,62,4.431111111111111,Feature
Rust,264,5383,423.18127314814814,MERGED,2,2,1,0,1,425,False,0,0,0,705,4,0.0077777777777777776,Bug
Rust,264,5383,423.1111689814815,MERGED,2,6,3,1,2,164,False,0,1,1,743,8,2.7216666666666667,Feature
Rust,264,5383,423.13427083333335,MERGED,0,4,1,0,1,424,False,0,0,0,675,4,0.35083333333333333,Feature
TypeScript,178,1359,343.77702546296297,MERGED,22,38,2,2,1,21,True,0,2,2,1770,60,98.6375,Feature
Rust,264,5383,427.0617592592593,MERGED,0,11,1,0,1,267,True,0,0,0,812,11,2.868333333333333,Feature
Rust,264,5383,423.0652777777778,MERGED,1,1,1,0,1,422,False,0,0,0,728,2,0.043055555555555555,Bug
TypeScript,261,3765,695.8375810185184,MERGED,1468,1672,21,0,3,901,True,0,0,0,1068,3140,19.025833333333335,Document
Rust,264,5383,426.91116898148147,MERGED,3,0,1,0,1,432,False,0,0,0,823,3,0.7022222222222222,Feature
TypeScript,7,6,667.8410416666667,MERGED,1,2,1,0,1,218,False,0,0,0,893,3,1.9013888888888888,Bug
C#,80,125,843.9935416666667,CLOSED,617,1749,47,0,52,199,True,0,0,0,1819,2366,1815.1205555555555,Document
JavaScript,5139,7050,1223.601388888889,MERGED,21,156,7,4,8,260,False,2,2,2,1068,177,68.97083333333333,Feature
TypeScript,85,723,336.28993055555554,MERGED,5,7,4,0,3,14,False,0,0,0,1447,12,0.8819444444444444,Document
TypeScript,2147,14722,1492.943900462963,MERGED,1,7,2,0,1,714,False,0,0,0,1794,8,19.885833333333334,Bug
TypeScript,7,6,668.9461111111111,MERGED,38,38,8,2,6,219,False,0,2,1,1803,76,260.69138888888887,Document
JavaScript,9664,43889,3679.9240046296295,MERGED,8,8,3,0,1,249,True,0,0,0,551,16,22.243055555555557,Feature
JavaScript,9664,43889,3679.8492245370367,MERGED,4,93,3,0,1,248,True,0,0,0,635,97,24.073055555555555,Feature
PHP,883,2338,1853.2018055555554,CLOSED,1,13,2,1,7,0,False,0,1,1,2046,14,735.2469444444445,Document
TypeScript,12,11,1012.223287037037,MERGED,8,8,2,0,1,46,False,0,0,0,2120,16,3.8136111111111113,Feature
TypeScript,261,3765,699.7446412037037,MERGED,29,10,2,0,2,207,False,0,0,0,2112,39,16.055,Document
TypeScript,2147,14722,1493.8379282407407,MERGED,34,51,6,0,1,718,False,0,0,0,3692,85,5.314166666666667,Bug
Rust,264,5383,426.0261689814815,MERGED,0,8,1,0,1,167,False,0,0,0,1145,8,1.191111111111111,Document
JavaScript,5139,7050,1227.7284837962964,MERGED,23,154,3,5,7,84,False,3,2,2,1838,177,81.55555555555556,Document
PHP,1334,2960,4229.137523148148,CLOSED,1,1,1,3,1,0,False,1,2,2,1721,2,45.17055555555555,Document
TypeScript,85,723,334.991087962963,MERGED,7,69,7,0,2,92,False,0,0,0,1499,76,22.855,Document
TypeScript,2147,14722,1492.1279861111109,MERGED,17,21,2,0,1,672,False,0,0,0,1197,38,20.49222222222222,Feature
TypeScript,2147,14722,1493.0705208333331,MERGED,47,93,9,0,2,715,False,0,0,0,3873,140,17.066388888888888,Bug
TypeScript,2147,14722,1492.2145601851853,MERGED,2,10,2,0,1,80,False,0,0,0,1309,12,13.561666666666667,Feature
TypeScript,2147,14722,1491.8412037037035,MERGED,4,7,2,0,2,710,False,0,0,0,1331,11,7.7444444444444445,Feature
TypeScript,12,11,1011.4924884259259,MERGED,8,13,2,0,3,44,False,0,0,0,2439,21,15.244444444444444,Feature
C++,2234,23694,2380.253483796296,CLOSED,9,157,14,1,4,0,False,0,1,1,784,166,0.06583333333333333,Document
JavaScript,5139,7050,1227.4859143518518,CLOSED,3,7,2,3,1,263,False,0,3,3,1244,10,65.45777777777778,Bug
TypeScript,58,78,842.3570949074074,MERGED,10,2,3,1,2,192,True,0,1,1,2075,12,19.63083333333333,Bug
Rust,264,5383,425.1565393518519,MERGED,2,2,1,0,3,345,False,0,0,0,1015,4,2.4672222222222224,Feature
Rust,264,5383,425.0508333333333,CLOSED,1,1,1,0,1,344,False,0,0,0,870,2,0.8033333333333333,Bug
Rust,264,5383,425.03258101851856,MERGED,4,4,2,0,2,343,False,0,0,0,818,8,0.1125,Feature
TypeScript,261,3765,698.7190509259259,MERGED,1,8,2,0,4,205,False,0,0,0,2166,9,2.053888888888889,Document
TypeScript,261,3765,698.7258680555556,MERGED,66,66,3,0,2,175,False,0,0,0,1938,132,1.0538888888888889,Document
Go,421,1654,1531.9241435185186,MERGED,13,11,2,0,1,244,False,0,0,0,1397,24,5.591666666666667,Bug
Rust,264,5383,424.9211921296296,MERGED,6,6,1,0,1,145,False,0,0,0,1039,12,0.9677777777777777,Bug
Vue,293,495,853.0907523148148,MERGED,97,190,8,27,20,62,False,12,15,6,1100,287,349.31638888888887,Bug
TypeScript,261,3765,698.4338310185185,MERGED,36,41,3,0,1,202,False,0,0,0,1859,77,0.755,Document
C++,2234,23694,2378.8527546296295,MERGED,0,19,2,1,1,293,False,0,1,1,924,19,20.06277777777778,Bug
TypeScript,178,1359,343.4597685185185,MERGED,0,54,5,1,2,8,False,0,1,1,1608,54,0.36138888888888887,Feature
Go,395,660,1288.1059143518519,MERGED,493,1134,6,0,19,101,False,0,0,0,473,1627,593.9875,Feature
TypeScript,7,6,664.9603935185186,MERGED,1,22,2,0,5,18,True,0,0,0,1062,23,22.8475,Feature
TypeScript,85,723,338.0009837962963,MERGED,4,16,4,0,1,97,False,0,0,0,2453,20,0.06027777777777778,Document
TypeScript,85,723,337.8464814814815,MERGED,58,40,10,0,4,95,False,0,0,0,2123,98,2.328888888888889,Document
Python,547,7160,2261.117534722222,MERGED,10,7,2,1,3,285,True,1,0,0,938,17,8.065277777777778,Document
Java,450,746,4096.12068287037,MERGED,1,1,1,2,2,152,False,0,2,1,797,2,3.327777777777778,Bug
V,2097,34361,1570.7476851851852,MERGED,0,32,2,0,1,206,True,0,0,0,718,32,39.49777777777778,Bug
JavaScript,5139,7050,1226.6891898148149,MERGED,1,1,1,1,3,103,False,0,1,1,1327,2,1.7705555555555557,Document
Go,30,295,367.17336805555556,MERGED,11,11,1,0,1,112,True,0,0,0,869,22,0.12305555555555556,Feature
Go,421,1654,1530.3535532407407,MERGED,80,205,3,1,1,13,False,1,0,0,1361,285,21.099444444444444,Bug
TypeScript,7,6,664.1749884259259,CLOSED,3,3,2,2,2,270,False,1,1,1,764,6,17.3825,Feature
Python,137,75,706.0493402777778,MERGED,0,46,4,0,10,3,False,0,0,0,1288,46,1340.3461111111112,Bug
Python,547,7160,2259.5044560185183,MERGED,16,46,5,1,5,284,True,1,0,0,846,62,38.339444444444446,Bug
Rust,264,5383,423.24391203703703,MERGED,2,2,1,1,1,426,False,1,0,0,903,4,0.008333333333333333,Feature
TypeScript,178,1359,344.35600694444446,MERGED,156,300,10,1,5,11,True,0,1,1,3022,456,174.02916666666667,Feature
JavaScript,5139,7050,1226.5136342592593,MERGED,2,13,2,2,3,262,False,0,2,2,1777,15,3.946111111111111,Feature
JavaScript,5139,7050,1227.8369675925926,MERGED,20,160,7,4,3,96,False,2,2,2,2232,180,137.25611111111112,Feature
TypeScript,261,3765,696.7982986111111,MERGED,2,9,2,0,2,198,False,0,0,0,1993,11,1.1366666666666667,Document
Go,395,660,1288.1847453703704,MERGED,1,1,1,0,1,0,False,0,0,0,162,2,138.0186111111111,Feature
Python,137,75,706.1065856481482,MERGED,3,13,3,0,3,73,False,0,0,0,1785,16,7.226388888888889,Document
TypeScript,2147,14722,1491.96,MERGED,7,21,3,0,2,711,False,0,0,0,2362,28,43.507777777777775,Feature
Go,395,660,1288.9893402777777,MERGED,7,48,3,0,3,60,False,0,0,0,337,55,333.68805555555554,Bug
Python,137,75,705.2505208333333,MERGED,25,88,3,1,9,72,False,1,0,0,1806,113,7.775833333333333,Bug
TypeScript,3989,23861,2849.3034953703705,MERGED,0,133,2,6,22,0,False,2,4,3,2494,133,2101.212777777778,Document
C++,2234,23694,2376.6928935185183,MERGED,29,76,4,1,3,288,False,0,1,1,1143,105,4.005277777777778,Bug
JavaScript,5139,7050,1227.742164351852,MERGED,20,284,6,4,5,95,False,2,2,2,2063,304,95.27722222222222,Feature
Python,137,75,707.1719560185185,MERGED,0,156,7,0,26,1,False,0,0,0,2093,156,1566.2955555555557,Bug
Go,421,1654,1530.142326388889,MERGED,18,9,2,0,1,449,True,0,0,0,2425,27,141.8161111111111,Bug
TypeScript,261,3765,695.8581018518518,MERGED,2,2,2,0,1,257,True,0,0,0,1918,4,0.19777777777777777,Document
TypeScript,261,3765,695.8530324074073,MERGED,3,9,4,0,2,256,True,0,0,0,1892,12,0.3511111111111111,Document
Vue,293,495,849.9365393518518,MERGED,57,350,17,18,19,170,True,8,10,6,1399,407,336.81,Bug
TypeScript,261,3765,695.5152777777777,MERGED,46,143,3,0,2,897,True,0,0,0,2076,189,0.4216666666666667,Document
Vue,10806,21162,1041.871388888889,MERGED,41,41,1,0,3,97,False,0,0,0,1341,82,97.08888888888889,Document
Vue,293,495,852.7277662037037,MERGED,8,16,3,6,9,60,False,0,6,4,1222,24,175.48416666666665,Bug
Rust,264,5383,425.00959490740746,MERGED,0,23,7,0,2,115,True,0,0,0,1711,23,115.23527777777778,Feature
Vue,293,495,853.5326388888889,MERGED,14,23,3,5,4,261,True,2,3,2,1085,37,123.06666666666666,Bug
Python,19249,70257,2483.5589583333335,CLOSED,2,2,1,1,1,1603,False,1,0,0,260,4,2.183611111111111,Bug
V,2097,34361,1571.9044791666665,MERGED,0,28,2,0,1,208,True,0,0,0,964,28,11.720555555555556,Bug
Go,395,660,1288.9811574074074,CLOSED,1372,2181,32,1,10,59,False,1,0,0,164,3553,0.15555555555555556,Feature
TypeScript,3393,2334,988.1934722222222,MERGED,69213,0,700,1,1,712,False,0,1,1,226,69213,43.56472222222222,Feature
TypeScript,85,723,337.0677314814815,MERGED,10,90,7,0,7,98,False,0,0,0,2607,100,116.38083333333333,Document
TypeScript,7,6,668.1208680555555,CLOSED,42,108,9,0,8,20,True,0,0,0,4961,150,1103.8041666666666,Feature
Rust,417,2801,946.2140856481482,MERGED,70,54,23,1,3,24,False,0,1,1,363,124,1.376111111111111,Document
Vue,10806,21162,1042.1734722222222,CLOSED,1,0,1,1,2,0,False,0,1,1,1282,1,14.114722222222222,Bug
TypeScript,202,107,1168.059826388889,MERGED,26,250,10,4,6,1,False,0,4,4,1850,276,112.60472222222222,Document
Rust,264,5383,422.7457523148148,MERGED,40523,40553,14,0,40,0,False,0,0,0,2895,81076,34.00138888888889,Bug
Go,395,660,1286.824525462963,MERGED,12,24,2,0,3,27,False,0,0,0,330,36,314.1075,Feature
TypeScript,2147,14722,1496.0469097222222,MERGED,6,6,3,0,1,297,False,0,0,0,2439,12,4.8180555555555555,Bug
Python,137,75,706.2085532407408,MERGED,0,602,28,0,79,0,False,0,0,0,3236,602,1966.9855555555555,Document
TypeScript,2147,14722,1495.997627314815,MERGED,2,196,2,0,3,1,False,0,0,0,2868,198,3.5327777777777776,Feature
TypeScript,2147,14722,1494.133275462963,MERGED,65,349,7,0,1,176,False,0,0,0,3562,414,2.2025,Document
Vue,10806,21162,1042.08,MERGED,6,5,2,0,1,182,False,0,0,0,1400,11,3.289722222222222,Document
TypeScript,58,78,843.0645486111111,CLOSED,0,77,2,1,2,194,True,0,1,1,2232,77,0.08,Feature
Rust,264,5383,426.16489583333333,MERGED,12,6,1,0,1,349,False,0,0,0,1320,18,2.5838888888888887,Feature
Rust,264,5383,426.0788310185185,MERGED,6,9,2,1,6,348,False,1,0,0,1124,15,4.490833333333334,Bug
V,2097,34361,1570.598900462963,MERGED,1,29,3,5,2,205,True,2,3,2,921,30,19.269444444444446,Bug
Go,395,660,1287.8792708333333,MERGED,8,11,1,0,4,83,False,0,0,0,171,19,1.0197222222222222,Feature
Rust,264,5383,425.809375,CLOSED,25,4,2,0,4,346,False,0,0,0,1729,29,7.469444444444444,Feature
TypeScript,7,6,667.0238541666666,MERGED,6,31,3,0,8,23,False,0,0,0,1413,37,4.92,Feature
Go,395,660,1286.0511574074073,MERGED,6,8,1,0,2,100,False,0,0,0,191,14,0.8155555555555556,Bug
Go,30,295,369.1515162037037,MERGED,2,2,1,0,1,98,True,0,0,0,1244,4,0.11222222222222222,Bug
Rust,264,5383,425.7327083333333,MERGED,2,2,1,0,1,430,False,0,0,0,1747,4,0.8397222222222223,Bug
Go,30,295,369.0485532407408,MERGED,2,11,1,1,1,160,True,0,1,1,1345,13,0.10055555555555555,Bug
TypeScript,2147,14722,1492.928912037037,MERGED,72,268,5,0,2,175,False,0,0,0,6216,340,1.1941666666666666,Document
TypeScript,4,33,785.3919444444444,MERGED,99,361,32,1,14,377,False,0,1,1,289,460,136.7238888888889,Feature
TypeScript,178,1359,343.7162962962963,MERGED,6,36,4,1,1,9,False,0,1,1,2441,42,0.11888888888888889,Feature
Vue,293,495,851.1480555555555,MERGED,0,1236,19,48,27,382,False,10,38,6,1212,1236,140.59194444444444,Bug
PHP,1334,2960,4228.125092592592,MERGED,1,1,1,0,1,78,False,0,0,0,1625,2,0.4116666666666667,Document
Rust,264,5383,425.3306944444444,MERGED,6,8,3,0,1,429,False,0,0,0,1739,14,0.7261111111111112,Feature
TypeScript,15,34,512.650486111111,MERGED,0,117,1,0,1,965,False,0,0,0,377,117,191.27722222222224,Feature
TypeScript,85,723,337.90749999999997,MERGED,18,86,13,0,2,95,False,0,0,0,3503,104,0.355,Document
TypeScript,7,6,666.0011458333333,MERGED,230,159,18,0,91,273,False,0,0,0,1259,389,23.009166666666665,Feature
Go,395,660,1288.5967592592592,MERGED,0,11,1,0,1,84,False,0,0,0,223,11,9.733611111111111,Feature
JavaScript,34,25,215.53480324074076,MERGED,0,54,11,0,4,33,False,0,0,0,84,54,0.29305555555555557,Bug
PHP,883,2338,1852.1992361111113,CLOSED,5,13,5,1,3,6,False,0,1,1,2707,18,759.4538888888889,Document
JavaScript,8844,63474,4098.88681712963,MERGED,4,8,3,0,3,63,True,0,0,0,1324,12,7.204444444444444,Bug
TypeScript,261,3765,698.5375115740741,MERGED,5,9,3,0,3,204,False,0,0,0,2296,14,0.2313888888888889,Document
TypeScript,58,78,841.3553009259259,MERGED,0,2,2,1,1,190,True,0,1,1,249,2,17.149722222222223,Feature
TypeScript,85,723,335.1905555555556,MERGED,115,273,4,0,4,5,False,0,0,0,3318,388,97.35555555555555,Document
Python,137,75,709.0171875,MERGED,7,74,5,0,14,1,False,0,0,0,1698,81,988.4852777777778,Bug
Rust,417,2801,942.9955208333334,MERGED,7,9,5,2,1,207,False,0,2,2,1287,16,1.2827777777777778,Document
PHP,883,2338,1854.9806481481482,CLOSED,2,2,2,2,2,28,False,0,2,2,1792,4,21.6075,Document
JavaScript,5139,7050,1224.5211226851852,MERGED,35,20,7,3,6,261,False,1,2,2,2089,55,51.76277777777778,Feature
Rust,417,2801,944.1088425925926,MERGED,11,588,5,3,4,16,False,1,2,2,527,599,147.87916666666666,Bug
TypeScript,2147,14722,1494.1683564814814,MERGED,28,16,3,0,1,55,False,0,0,0,2612,44,0.5458333333333333,Feature
TypeScript,7,6,665.1739004629629,MERGED,9,10,2,1,3,272,False,0,1,1,1588,19,22.077222222222222,Bug
TypeScript,85,723,335.23672453703705,MERGED,47,93,4,0,2,167,False,0,0,0,3419,140,41.595555555555556,Document
Rust,264,5383,424.2304513888889,CLOSED,16,16,7,0,1,427,False,0,0,0,1584,32,0.7730555555555556,Bug
TypeScript,42,46,792.1632175925926,MERGED,39,215,10,1,9,25,True,0,1,1,376,254,23.475555555555555,Bug
Python,19249,70257,2482.782037037037,CLOSED,16,9,1,2,2,1601,False,2,0,0,235,25,20.310277777777777,Document
Vue,10806,21162,1046.136435185185,MERGED,0,10,2,5,2,17,False,2,3,2,4528,10,12.8525,Bug
TypeScript,261,3765,697.6532638888889,MERGED,4737,3308,163,0,10,606,True,0,0,0,2543,8045,1.3730555555555555,Document
TypeScript,1297,21107,438.9246412037037,MERGED,1,1,1,1,1,1003,True,0,1,1,1484,2,0.011111111111111112,Document
TypeScript,261,3765,697.496574074074,MERGED,0,15,3,0,1,907,True,0,0,0,2364,15,0.9855555555555555,Document
TypeScript,7,6,664.8729398148148,MERGED,6,12,5,1,3,216,False,0,1,1,1362,18,0.6397222222222222,Feature
TypeScript,202,107,1167.6889583333334,MERGED,118,105,1,4,1,223,True,0,4,4,1376,223,0.9769444444444444,Document
TypeScript,202,107,1167.6876273148148,MERGED,7,3,1,4,1,222,True,0,4,4,1517,10,1.0,Document
TypeScript,2147,14722,1492.8547800925926,MERGED,25,25,1,0,1,713,False,0,0,0,3187,50,22.04861111111111,Bug
TypeScript,261,3765,696.854525462963,MERGED,4,40,5,0,2,905,True,0,0,0,2681,44,16.147777777777776,Document
Python,547,7160,2259.55505787037,MERGED,30,48,2,1,8,27,False,0,1,1,3064,78,386.5736111111111,Document
Python,547,7160,2261.1314467592592,MERGED,2,10,2,0,3,286,True,0,0,0,463,12,9.750277777777777,Bug
TypeScript,2147,14722,1492.079525462963,MERGED,23,51,4,0,6,712,False,0,0,0,2576,74,51.191944444444445,Document
Go,421,1654,1529.3974305555555,MERGED,21,30,4,0,2,65,False,0,0,0,3045,51,17.040555555555557,Bug
TypeScript,15,34,511.4415856481482,MERGED,4,4,1,0,1,482,True,0,0,0,204,8,1.8111111111111111,Feature
JavaScript,9664,43889,3681.050752314815,MERGED,38,592,6,0,6,191,True,0,0,0,449,630,120.64222222222222,Feature
C++,2234,23694,2378.917002314815,MERGED,1,1,1,1,1,34,False,0,1,1,601,2,3.1911111111111112,Feature
TypeScript,261,3765,696.8505324074075,MERGED,9,8,7,0,1,104,False,0,0,0,2603,17,0.10916666666666666,Document
Python,547,7160,2258.5294328703703,MERGED,8,14,1,0,3,26,False,0,0,0,3117,22,411.38666666666666,Document
Python,137,75,705.0375694444446,MERGED,0,360,15,0,13,17,False,0,0,0,2011,360,1413.335,Bug
JavaScript,9664,43889,3679.9883564814813,MERGED,16,284,48,1,23,56,True,0,1,1,298,300,22.17361111111111,Feature
Rust,264,5383,422.7692939814815,MERGED,2,2,2,0,2,420,False,0,0,0,1142,4,1.0530555555555556,Bug
TypeScript,7,6,666.5958449074075,MERGED,13,21,3,3,5,27,False,2,1,1,2188,34,127.34194444444445,Feature
JavaScript,9664,43889,3681.4334722222225,MERGED,0,93,3,1,1,0,False,0,1,1,480,93,63.1225,Feature
Go,30,295,370.02827546296294,MERGED,25,20,7,0,1,41,True,0,0,0,4975,45,0.029722222222222223,Bug
TypeScript,307,2556,561.5673842592593,MERGED,4,0,1,2,1,300,True,1,1,1,842,4,3.576111111111111,Bug
TypeScript,17,33,740.8626736111111,MERGED,1,23,1,1,1,44,False,0,1,1,241,24,3.0205555555555557,Bug
JavaScript,9664,43889,3678.202488425926,CLOSED,2,8,2,0,3,55,True,0,0,0,345,10,64.34722222222223,Feature
TypeScript,15,34,510.31350694444444,MERGED,7,44,3,0,3,322,False,0,0,0,211,51,2.5675,Bug
TypeScript,261,3765,695.6043518518518,MERGED,7,37,6,0,2,143,True,0,0,0,2564,44,0.24416666666666667,Document
TypeScript,307,2556,560.6811921296296,MERGED,0,17,1,0,2,299,True,0,0,0,1003,17,17.964444444444446,Feature
Java,450,746,4094.1892592592594,CLOSED,31,128,3,1,3,149,False,0,1,1,1351,159,1.2377777777777779,Bug
Python,19249,70257,2483.508414351852,CLOSED,9,15,2,1,3,1602,False,1,0,0,461,24,5.541666666666667,Bug
Rust,417,2801,947.3535300925927,MERGED,22,100,11,1,9,276,False,0,1,1,694,122,71.71222222222222,Bug
Go,11875,71339,2714.979560185185,MERGED,3,10,2,0,1,279,True,0,0,0,1545,13,0.18388888888888888,Feature
JavaScript,9664,43889,3678.2889699074076,MERGED,0,60,3,0,4,628,False,0,0,0,363,60,17.739166666666666,Feature
TypeScript,15,34,512.6612962962963,MERGED,3,17,2,0,2,966,False,0,0,0,354,20,1.886388888888889,Document
Rust,264,5383,426.94684027777777,MERGED,150,105,8,0,1,266,True,0,0,0,2219,255,0.5855555555555556,Feature
Go,1835,11245,1748.8343750000001,MERGED,13,14,3,0,1,106,False,0,0,0,199,27,0.7655555555555555,Feature
Rust,433,2229,256.57806712962963,MERGED,10,18,3,1,1,879,False,0,1,1,299,28,1.8208333333333333,Document
Go,1835,11245,1748.5880439814816,MERGED,3,3,1,0,1,105,False,0,0,0,219,6,0.22833333333333333,Document
C#,80,125,840.678900462963,CLOSED,1,2,1,0,2,20,False,0,0,0,418,3,16.6375,Document
Go,421,1654,1529.2620023148147,MERGED,47,93,7,1,1,243,False,0,1,1,3296,140,89.40833333333333,Bug
TypeScript,202,107,1166.960451388889,MERGED,67,77,1,6,7,152,True,0,6,4,2524,144,138.9763888888889,Document
TypeScript,202,107,1163.933900462963,MERGED,0,5,2,4,2,217,True,0,4,4,1893,5,17.342777777777776,Document
Python,137,75,705.3672222222222,CLOSED,2,209,8,1,14,0,False,0,1,1,1845,211,1247.5452777777778,Document
Go,30,295,369.1807175925926,MERGED,55,155,4,0,1,39,True,0,0,0,1944,210,0.23333333333333334,Feature
TypeScript,15,34,511.7173263888889,MERGED,248,355,1,0,3,483,True,0,0,0,310,603,2.42,Bug
Python,547,7160,2260.5210300925924,MERGED,6,4,1,1,1,4,False,1,0,0,467,10,1.3094444444444444,Bug
Python,137,75,708.6007986111111,MERGED,7,1502,29,8,47,24,False,4,4,1,2883,1509,1650.3016666666667,Document
Vue,293,495,848.9833101851851,MERGED,1,2,1,4,1,309,True,1,3,2,1434,3,1.5127777777777778,Bug
TypeScript,41368,87412,2958.669479166667,CLOSED,3,3,3,0,1,17,False,0,0,0,2675,6,596.1180555555555,Document
PHP,1334,2960,4229.9404629629635,MERGED,6,113,4,1,7,21,False,0,1,1,3781,119,342.28777777777776,Document
TypeScript,307,2556,558.770787037037,MERGED,0,3,1,1,1,9,False,0,1,1,1124,3,0.7022222222222222,Bug
TypeScript,58,78,841.2951157407407,MERGED,3,9,2,1,4,95,False,0,1,1,2217,12,17.88083333333333,Feature
TypeScript,307,2556,558.7312962962964,MERGED,2,6,1,1,1,8,False,0,1,1,946,8,1.0025,Bug
TypeScript,307,2556,558.7007523148148,MERGED,1,1,1,1,1,7,False,0,1,1,1056,2,0.7105555555555556,Bug
TypeScript,15,34,510.7866898148148,MERGED,6,55,2,0,3,960,False,0,0,0,264,61,17.358333333333334,Feature
V,2097,34361,1569.893738425926,CLOSED,7,16,4,12,4,204,True,0,12,7,1502,23,61.80861111111111,Feature
TypeScript,12,11,1011.3287847222223,MERGED,2,2,2,0,1,145,False,0,0,0,761,4,20.02,Bug
TypeScript,15,34,510.735625,MERGED,14,46,2,0,26,51,False,0,0,0,434,60,144.70166666666665,Document
Go,395,660,1284.9512037037036,CLOSED,0,14,1,2,1,0,False,1,1,1,245,14,70.22194444444445,Feature
Go,395,660,1286.1441435185186,MERGED,16,78,4,0,2,57,False,0,0,0,421,94,24.782222222222224,Feature
TypeScript,1297,21107,440.00934027777777,MERGED,3,23,4,1,3,1008,True,0,1,1,2287,26,0.49944444444444447,Document
TypeScript,15,34,510.3433101851852,MERGED,22,50,6,0,4,481,True,0,0,0,351,72,27.82888888888889,Feature
Rust,264,5383,425.7836805555555,MERGED,7,22,3,1,1,117,True,1,0,0,3122,29,337.6947222222222,Document
Go,395,660,1286.088599537037,MERGED,2,2,1,0,1,26,False,0,0,0,240,4,20.976388888888888,Feature
TypeScript,12,11,1012.3814930555556,MERGED,71,226,2,0,6,47,False,0,0,0,5319,297,67.15916666666666,Feature
Rust,264,5383,425.03033564814814,MERGED,17,100,3,0,1,116,True,0,0,0,1998,117,4.251388888888889,Document
TypeScript,15,34,510.55958333333336,MERGED,20,21,2,0,3,50,False,0,0,0,299,41,0.18472222222222223,Feature
TypeScript,15,34,510.5584837962963,MERGED,4,9,2,0,1,959,False,0,0,0,379,13,0.016666666666666666,Feature
TypeScript,15,34,510.54785879629634,MERGED,0,6,1,0,2,958,False,0,0,0,270,6,0.20555555555555555,Feature
Rust,264,5383,425.0024537037037,MERGED,5,10,6,0,1,242,True,0,0,0,2596,15,1.4847222222222223,Bug
Rust,264,5383,424.8321759259259,MERGED,4,12,1,0,1,114,True,0,0,0,2158,16,3.563888888888889,Feature
TypeScript,307,2556,557.6818402777777,MERGED,1,1,1,1,1,571,True,0,1,1,851,2,23.11777777777778,Bug
Go,395,660,1286.048136574074,CLOSED,27,693,4,0,1,99,False,0,0,0,371,720,0.05416666666666667,Feature
TypeScript,15,34,509.84887731481484,CLOSED,20,68,1,0,54,49,False,0,0,0,377,88,22.439166666666665,Document
TypeScript,218,1201,2948.092372685185,MERGED,62,129,7,4,6,173,True,4,0,0,567,191,167.79527777777778,Feature
TypeScript,15,34,512.7149421296297,MERGED,23,18,5,0,1,967,False,0,0,0,485,41,0.5936111111111111,Feature
Go,30,295,367.23219907407406,MERGED,4,56,2,1,2,158,True,0,1,1,2296,60,0.12666666666666668,Bug
Python,2407,12180,260.7927314814815,MERGED,437,972,76,14,22,2,False,8,6,3,2269,1409,1715.2702777777777,Document
TypeScript,7,6,664.2295138888888,MERGED,22,22,7,0,2,271,False,0,0,0,2355,44,40.75222222222222,Feature
TypeScript,17,33,738.8420949074074,MERGED,28,200,6,1,3,30,True,0,1,1,340,228,74.69666666666667,Bug
TypeScript,15,34,509.5768287037037,MERGED,1,8,1,0,1,321,False,0,0,0,360,9,0.4247222222222222,Feature
Go,1835,11245,1749.6005902777779,MERGED,69,162,7,0,3,107,False,0,0,0,400,231,2.7511111111111113,Feature
Rust,264,5383,423.78898148148147,MERGED,33,33,4,0,1,67,False,0,0,0,2266,66,2.6616666666666666,Bug
TypeScript,2147,14722,1493.2091319444444,MERGED,168,157,7,0,1,716,False,0,0,0,5424,325,13.759166666666667,Bug
JavaScript,5139,7050,1227.7151967592592,MERGED,26,215,8,3,6,185,False,1,2,2,5086,241,307.2663888888889,Feature
TypeScript,1297,21107,437.67376157407404,MERGED,2,4,2,2,7,25,False,1,1,1,2052,6,19.461388888888887,Document
Python,137,75,706.3690624999999,MERGED,20,32,9,0,8,74,False,0,0,0,2320,52,0.9263888888888889,Document
JavaScript,5139,7050,1224.6601851851851,CLOSED,15,146,3,1,11,105,False,0,1,1,2510,161,0.7333333333333333,Document
JavaScript,9664,43889,3681.4613773148144,CLOSED,0,0,0,0,0,0,False,0,0,0,622,0,0.049444444444444444,Bug
TypeScript,261,3765,698.905462962963,MERGED,3,75,8,0,5,26,True,0,0,0,3373,78,86.51416666666667,Document
Python,2407,12180,259.0624305555555,MERGED,0,0,0,12,9,0,False,5,7,2,2528,0,1507.9258333333332,Document
TypeScript,15,34,508.5226967592593,MERGED,3,2,1,0,1,480,True,0,0,0,300,5,0.5447222222222222,Bug
TypeScript,85,723,339.170462962963,MERGED,62,37,1,0,1,102,False,0,0,0,3872,99,0.18805555555555556,Document
Starlark,440,286,510.9922569444445,CLOSED,0,220,3,2,7,0,False,1,1,1,2021,220,1133.1155555555556,Feature
TypeScript,261,3765,697.6788194444445,MERGED,32,129,10,0,20,908,True,0,0,0,3532,161,116.43555555555555,Document
TypeScript,41368,87412,2960.8419907407406,MERGED,1,1,1,0,2,21,False,0,0,0,1959,2,1.2130555555555556,Document
TypeScript,15,34,513.3965162037038,MERGED,9733,3221,330,0,15,326,False,0,0,0,561,12954,77.3475,Feature
TypeScript,41368,87412,2960.8130902777775,MERGED,1,3,1,0,1,0,False,0,0,0,2201,4,0.5608333333333333,Document
TypeScript,261,3765,699.727175925926,MERGED,9,39,8,0,1,107,False,0,0,0,3152,48,0.8552777777777778,Document
TypeScript,3393,2334,990.6228703703704,MERGED,2,6,2,3,1,0,False,0,3,2,1015,8,173.78722222222223,Feature
TypeScript,261,3765,699.4680555555556,MERGED,10,57,5,0,1,609,True,0,0,0,3694,67,1.3694444444444445,Document
Vue,293,495,848.9566435185185,MERGED,2,3,3,5,2,308,True,1,4,3,1682,5,1.2816666666666667,Bug
C#,80,125,843.4936342592592,MERGED,4,3,2,0,1,179,False,0,0,0,630,7,0.3525,Document
TypeScript,307,2556,558.7512731481481,CLOSED,8,20,1,1,2,0,False,0,1,1,1357,28,69.89083333333333,Feature
TypeScript,85,723,337.1780439814815,MERGED,26086,4,81,0,3,168,False,0,0,0,4303,26090,23.24888888888889,Document
C#,80,125,842.719849537037,MERGED,1556,74,589,0,8,89,False,0,0,0,611,1630,22.156666666666666,Document
Go,1835,11245,1749.7716898148149,MERGED,5,20,4,0,1,108,False,0,0,0,458,25,0.5725,Bug
TypeScript,17,33,739.9599189814816,MERGED,19,24,6,1,1,43,False,0,1,1,512,43,20.796666666666667,Feature
Python,547,7160,2257.633761574074,MERGED,1,5,1,2,2,224,False,0,2,2,573,6,20.04861111111111,Bug
TypeScript,261,3765,698.7675231481481,MERGED,9,131,6,0,5,206,False,0,0,0,3892,140,0.685,Document
TypeScript,261,3765,698.6806712962963,MERGED,245,90,10,0,6,909,True,0,0,0,3063,335,1.9044444444444444,Document
Go,54,353,756.8731828703703,MERGED,31,153,8,0,4,220,True,0,0,0,3937,184,0.665,Bug
TypeScript,15,34,509.4041550925926,MERGED,1,1,1,1,1,320,False,0,1,1,396,2,1.9202777777777778,Document
TypeScript,15,34,509.19025462962964,MERGED,2,3,2,0,1,172,False,0,0,0,437,5,0.4052777777777778,Feature
TypeScript,2071,16640,1264.7074768518519,MERGED,1,1,1,0,1,11,False,0,0,0,2582,2,140.93972222222223,Bug
TypeScript,261,3765,697.9905787037037,MERGED,45,69,5,0,4,201,False,0,0,0,3548,114,11.710555555555555,Document
Go,421,1654,1532.883958333333,MERGED,8,13,7,1,1,11,False,0,1,1,4384,21,73.0625,Bug
TypeScript,261,3765,697.8797916666667,MERGED,23,51,7,0,1,262,True,0,0,0,3787,74,14.082222222222223,Document
TypeScript,15,34,508.6424768518518,MERGED,32,33,4,0,1,957,False,0,0,0,447,65,19.345,Feature
TypeScript,2071,16640,1264.257974537037,MERGED,1,2,1,0,3,1,False,0,0,0,2722,3,151.61333333333334,Bug
TypeScript,2071,16640,1264.0567824074074,MERGED,7,9,2,0,1,3,False,0,0,0,2930,16,156.45916666666668,Document
Python,14531,41183,1107.8382175925926,MERGED,1,1,1,0,1,1419,True,0,0,0,783,2,10.510833333333334,Document
TypeScript,41368,87412,2958.745902777778,MERGED,404,0,2,0,1,19,False,0,0,0,2178,404,0.4519444444444444,Document
C++,2234,23694,2381.5107175925928,MERGED,2,11,3,3,5,3,False,1,2,2,960,13,68.00333333333333,Bug
TypeScript,261,3765,696.7119328703703,MERGED,6,155,6,0,2,2,True,0,0,0,1529,161,25.110277777777778,Document
JavaScript,9664,43889,3678.199108796296,MERGED,3,18,4,0,3,54,True,0,0,0,599,21,16.690277777777776,Feature
TypeScript,261,3765,697.674675925926,MERGED,29,40,3,0,2,104,True,0,0,0,3265,69,0.22805555555555557,Document
TypeScript,41368,87412,2958.489722222222,MERGED,4,4,1,0,1,11,False,0,0,0,2284,8,2.3319444444444444,Document
TypeScript,69,2215,335.6394328703704,MERGED,130,2269,26,2,25,29,False,0,2,1,1260,2399,488.26694444444445,Document
TypeScript,15,34,512.6406944444444,MERGED,132,62,11,0,6,964,False,0,0,0,603,194,1.8175,Bug
TypeScript,307,2556,558.6906712962963,MERGED,1,10,3,1,2,19,False,0,1,1,1440,11,1.4755555555555555,Bug
TypeScript,2071,16640,1262.0378587962962,CLOSED,86,132,2,1,1,2,False,0,1,1,3352,218,23.98138888888889,Document
TypeScript,261,3765,696.8770833333333,MERGED,2,163,17,0,4,199,False,0,0,0,4211,165,17.351111111111113,Document
Go,1835,11245,1752.1565625,MERGED,3,3,3,0,5,2,False,0,0,0,639,6,0.2313888888888889,Document
TypeScript,41368,87412,2959.0395023148144,MERGED,105,58,3,3,26,33,False,1,2,1,2669,163,308.3563888888889,Document
C#,80,125,840.7788657407408,MERGED,10,6,1,0,4,7,True,0,0,0,619,16,1.1144444444444443,Document
Go,1835,11245,1747.6445254629627,MERGED,14,29,5,0,2,104,False,0,0,0,388,43,0.6975,Feature
TypeScript,261,3765,696.668298611111,MERGED,157,193,46,0,5,605,True,0,0,0,4796,350,1.1336111111111111,Document
TypeScript,261,3765,696.6436921296296,MERGED,27,38,10,0,1,103,False,0,0,0,3869,65,0.5927777777777777,Document
C++,2234,23694,2378.890729166667,MERGED,14,47,5,2,2,553,False,1,1,1,3052,61,118.2425,Bug
Go,30,295,369.9674305555556,MERGED,10,52,4,0,7,161,True,0,0,0,2980,62,0.024444444444444446,Feature
TypeScript,261,3765,696.5223726851851,MERGED,11,18,2,0,1,604,True,0,0,0,3797,29,0.21027777777777779,Document
TypeScript,307,2556,557.6603240740741,MERGED,3,0,1,1,1,570,True,0,1,1,1429,3,0.5194444444444445,Bug
Rust,264,5383,426.9061805555555,MERGED,390,3,19,0,1,431,False,0,0,0,3285,393,0.06138888888888889,Feature
TypeScript,261,3765,696.4780787037038,MERGED,90,245,10,0,2,902,True,0,0,0,3544,335,0.37694444444444447,Document
TypeScript,15,34,511.43542824074075,MERGED,13,13,2,0,1,323,False,0,0,0,551,26,1.2013888888888888,Bug
Rust,433,2229,255.49266203703704,MERGED,1,94,2,1,3,873,False,0,1,1,502,95,1.8288888888888888,Feature
JavaScript,9664,43889,3675.980231481481,MERGED,99,99,2,2,2,0,False,1,1,1,526,198,45.60777777777778,Feature
TypeScript,15,34,509.3414236111111,CLOSED,71,403,6,1,2,318,False,1,0,0,680,474,84.96972222222222,Feature
Python,72,25,1659.6735648148149,MERGED,2,56,2,0,1,30,False,0,0,0,2454,58,0.8666666666666667,Document
TypeScript,41368,87412,2956.7506828703704,MERGED,1,1,1,1,1,1607,True,0,1,1,2083,2,0.795,Document
TypeScript,2147,14722,1491.2813078703703,MERGED,197,3787,67,0,5,172,False,0,0,0,4962,3984,18.5025,Document
,0,0,69.96546296296296,CLOSED,0,74445,76,0,3,5,True,0,0,0,5436,74445,0.010277777777777778,Feature
TypeScript,15,34,509.37118055555555,MERGED,42,62,8,0,6,319,False,0,0,0,603,104,74.46527777777777,Bug
TypeScript,261,3765,695.780300925926,MERGED,136,24,70,0,2,900,True,0,0,0,4497,160,0.9930555555555556,Document
TypeScript,261,3765,695.765636574074,MERGED,260,90,10,0,3,899,True,0,0,0,3424,350,0.5605555555555556,Document
TypeScript,202,107,1167.1988541666667,MERGED,4,4,1,6,5,0,False,0,6,5,1157,8,125.59527777777778,Document
TypeScript,4,33,786.2587268518519,MERGED,11859,14321,38,2,20,226,True,1,1,1,1813,26180,931.1247222222222,Bug
TypeScript,261,3765,695.6510416666666,MERGED,53,527,21,0,3,898,True,0,0,0,4639,580,1.6516666666666666,Document
Python,19249,70258,2479.326145833333,CLOSED,2,10,4,3,5,1598,False,2,1,1,643,12,84.79888888888888,Bug
TypeScript,7,6,665.805787037037,MERGED,102,148,4,1,4,217,False,0,1,1,2865,250,29.03,Feature
C#,80,125,843.5549074074074,MERGED,3,6,2,0,1,180,False,0,0,0,920,9,95.82138888888889,Document
Java,450,746,4096.2540625,MERGED,61,164,15,1,12,32,False,0,1,1,904,225,70.85083333333333,Feature
TypeScript,41368,87412,2955.967303240741,CLOSED,0,1,1,1,1,0,False,1,0,0,2145,1,0.12916666666666668,Document
JavaScript,9664,43889,3681.2385879629633,MERGED,5,5,1,1,1,1,False,0,1,1,746,10,66.14972222222222,Feature
C#,80,125,843.6852199074074,MERGED,47886,3542,1315,0,13,181,False,0,0,0,926,51428,73.3875,Document
TypeScript,202,107,1166.7127083333332,MERGED,1,1,1,4,2,1,False,0,4,4,1036,2,116.12694444444445,Document
TypeScript,1297,21107,439.9873842592593,MERGED,10,79,6,1,2,1007,True,0,1,1,3152,89,0.04972222222222222,Document
TypeScript,2071,16640,1264.1417939814814,MERGED,2,2,2,0,2,1,False,0,0,0,2157,4,3.5419444444444443,Document
TypeScript,2071,16640,1264.125625,CLOSED,1,1,1,1,1,0,False,0,1,1,2288,2,3.944722222222222,Document
Erlang,2054,12122,3819.4528587962964,MERGED,21,125,7,2,1,15,False,0,2,1,1349,146,113.51472222222222,Document
JavaScript,8844,63474,4097.326157407408,MERGED,9,201,16,0,6,108,True,0,0,0,3199,210,47.573055555555555,Feature
Erlang,2054,12122,3819.221666666667,MERGED,78,80,28,2,3,1024,True,0,2,1,1207,158,4.320277777777778,Document
Erlang,2054,12122,3819.2326736111113,MERGED,62,384,38,2,2,372,False,0,2,1,1523,446,72.14722222222223,Document
Erlang,2054,12122,3818.978113425926,MERGED,1,7,2,2,1,1021,True,0,2,1,1557,8,2.735,Document
TypeScript,4,33,786.5777083333334,MERGED,2,7,2,1,1,213,False,0,1,1,927,9,0.2544444444444444,Bug
Erlang,2054,12122,3818.2521412037036,MERGED,9,157,7,2,3,368,False,0,2,1,1110,166,19.881666666666668,Document
Erlang,2054,12122,3817.251921296296,MERGED,22,3,6,0,1,67,False,0,0,0,764,25,1.3025,Document
Erlang,2054,12122,3817.9947685185184,MERGED,94,29,13,2,4,492,True,0,2,1,1228,123,87.99416666666667,Document
TypeScript,41368,87412,2961.0907291666667,MERGED,13,25,2,1,2,1,False,1,0,0,2672,38,47.05361111111111,Document
JavaScript,9664,43889,3680.7269444444446,MERGED,43,43,1,1,3,0,False,0,1,1,722,86,3.9788888888888887,Feature
JavaScript,5139,7050,1225.5527430555555,MERGED,30,34,19,2,7,99,False,0,2,2,4444,64,27.264722222222222,Bug
Erlang,2054,12122,3816.6007754629627,MERGED,2,26,5,2,1,12,False,0,2,1,1270,28,41.52027777777778,Document
C#,80,125,842.8338657407407,MERGED,0,13,2,0,2,182,False,0,0,0,839,13,18.83,Document
Rust,264,5383,422.93796296296296,MERGED,615,75,9,0,4,421,False,0,0,0,2662,690,1.3977777777777778,Feature
Erlang,2054,12122,3816.3287731481482,MERGED,5,23,4,3,2,363,False,1,2,1,1559,28,2.6355555555555554,Document
Erlang,2054,12122,3816.1981944444447,MERGED,43,86,5,2,2,360,False,0,2,1,1349,129,3.2655555555555558,Document
TypeScript,218,1201,2949.489178240741,MERGED,51,309,19,5,9,89,True,2,3,1,933,360,185.36277777777778,Document
Erlang,2054,12122,3816.016712962963,MERGED,2,15,4,2,2,48,False,0,2,1,1270,17,27.75861111111111,Document
Erlang,2054,12122,3816.005358796296,MERGED,5,6,4,2,2,370,True,0,2,1,1201,11,24.654722222222222,Document
Erlang,2054,12122,3816.0773958333334,MERGED,2,187,8,2,5,490,True,0,2,1,1339,189,26.623333333333335,Document
TypeScript,1297,21107,437.7212615740741,MERGED,2185,3945,19,1,3,995,True,0,1,1,2829,6130,2.161111111111111,Document
Erlang,2054,12122,3815.9046527777778,MERGED,37,91,5,2,2,489,True,0,2,1,1449,128,30.76388888888889,Document
TypeScript,41368,87412,2960.9377083333334,MERGED,8,10,2,0,4,94,True,0,0,0,2429,18,15.175277777777778,Document
V,2097,34361,1572.7100694444443,MERGED,5,26,5,0,1,209,True,0,0,0,2587,31,59.925555555555555,Bug
TypeScript,15,34,513.7021527777778,MERGED,12,33,3,0,1,969,False,0,0,0,789,45,0.059444444444444446,Document
TypeScript,2147,14722,1495.1899074074074,CLOSED,490,614,78,0,2,175,False,0,0,0,7746,1104,805.795,Bug
Erlang,2054,12122,3815.270636574074,CLOSED,3,4,2,3,1,353,False,1,2,1,999,7,14.791944444444445,Document
Python,2407,12180,261.38549768518516,CLOSED,2,2,1,3,2,2,False,1,2,1,2683,4,1285.226111111111,Document
TypeScript,41368,87412,2957.4141203703707,MERGED,8,4,1,0,1,4,False,0,0,0,2499,12,0.9975,Document
TypeScript,41368,87412,2957.4045833333334,MERGED,8,2,1,0,2,3,False,0,0,0,2375,10,1.2883333333333333,Document
JavaScript,9664,43889,3679.215127314815,MERGED,150,536,17,0,11,316,True,0,0,0,791,686,15.113611111111112,Feature
TypeScript,41368,87412,2957.398310185185,MERGED,1,1,1,0,1,2,False,0,0,0,2178,2,1.3491666666666666,Document
TypeScript,41368,87412,2960.639386574074,CLOSED,0,11,2,0,1,1918,True,0,0,0,2705,11,3.9358333333333335,Document
Rust,433,2229,257.9651388888889,MERGED,69,69,11,3,1,884,False,1,2,2,856,138,0.9813888888888889,Bug
C#,80,125,840.5431597222222,MERGED,1932,8837,82,0,56,215,False,0,0,0,1275,10769,554.8636111111111,Document
TypeScript,4,33,784.2182291666667,MERGED,101,9036,4,1,5,376,False,0,1,1,929,9137,0.12027777777777778,Bug
TypeScript,307,2556,560.4834722222222,MERGED,2,24,3,2,2,298,True,1,1,1,2370,26,4.815555555555555,Feature
Erlang,2054,12122,3819.012696759259,MERGED,5,23,3,2,1,245,True,0,2,1,1179,28,71.60388888888889,Document
Go,789,5551,1062.2724768518517,MERGED,0,21,1,4,2,12,False,2,2,1,1545,21,332.2316666666667,Document
C#,80,125,839.6034490740741,MERGED,3,3,1,0,4,19,False,0,0,0,783,6,96.74583333333334,Document
Rust,264,5383,425.7999189814814,MERGED,875,1184,43,0,3,146,False,0,0,0,4000,2059,343.71694444444444,Bug
Python,547,7160,2258.510775462963,MERGED,126,141,38,1,12,225,False,0,1,1,781,267,25.899444444444445,Bug
Go,1835,11245,1749.6814930555556,CLOSED,0,0,0,0,0,4,False,0,0,0,945,0,1.6947222222222222,Document
Erlang,2054,12122,3818.144768518519,MERGED,3,35,6,3,3,49,False,1,2,1,1244,38,168.17527777777778,Document
TypeScript,41368,87412,2959.627847222222,MERGED,8,8,2,1,1,93,True,0,1,1,2528,16,0.2775,Document
Erlang,2054,12122,3817.9522685185184,MERGED,43,48,3,2,3,372,True,0,2,1,1217,91,94.02583333333334,Document
Python,547,7160,2258.6241435185184,MERGED,23,173,14,1,8,208,False,0,1,1,761,196,4.203611111111111,Bug
JavaScript,9664,43889,3677.9274768518517,CLOSED,226,1040,48,1,21,315,True,1,0,0,952,1266,15.509166666666667,Bug
TypeScript,307,2556,558.7212384259259,MERGED,25,155,7,11,9,297,True,5,6,1,680,180,65.00777777777778,Feature
Starlark,440,286,511.0811574074074,MERGED,52,50,2,0,10,3,False,0,0,0,1380,102,382.66277777777776,Feature
Vue,293,495,849.0964467592593,MERGED,14,17,1,5,1,310,True,0,5,4,773,31,19.20722222222222,Bug
TypeScript,4,33,783.2508101851853,MERGED,1,1,1,2,1,218,True,1,1,1,992,2,0.03805555555555556,Bug
Erlang,2054,12122,3816.9495949074076,MERGED,35,89,13,2,3,371,True,0,2,1,1232,124,22.37472222222222,Document
C#,80,125,839.6974421296296,MERGED,202,569,2,0,3,178,True,0,0,0,679,771,44.40472222222222,Document
TypeScript,41368,87412,2955.8048263888886,CLOSED,123,41,12,1,5,1914,True,0,1,1,4247,164,0.6138888888888889,Document
Python,14531,41183,1109.0918865740741,MERGED,1,1,1,1,2,0,False,0,1,1,1406,2,396.90555555555557,Document
TypeScript,15,34,511.6575925925926,MERGED,3,4,1,0,1,961,False,0,0,0,636,7,0.08944444444444444,Bug
TypeScript,7,6,666.0287962962963,MERGED,224,1993,142,0,14,226,False,0,0,0,4907,2217,314.06666666666666,Feature
TypeScript,3393,2334,987.2337847222221,MERGED,1,1,1,1,1,123,False,0,1,1,1061,2,0.11527777777777778,Bug
TypeScript,41368,87412,2958.4985416666664,MERGED,6,6,3,0,2,16,False,0,0,0,2886,12,2.0172222222222222,Document
Erlang,2054,12122,3815.1023495370373,MERGED,2,30,4,3,3,47,False,1,2,1,1170,32,21.909166666666668,Document
Erlang,2054,12122,3814.704548611111,MERGED,3,8,4,2,1,240,True,0,2,1,1212,11,6.640833333333333,Document
TypeScript,41368,87412,2957.927962962963,MERGED,2,2,1,0,1,92,True,0,0,0,2263,4,0.36194444444444446,Document
TypeScript,15,34,509.46150462962964,MERGED,9,102,6,0,4,173,False,0,0,0,820,111,49.745,Feature
Erlang,2054,12122,3816.6242708333334,MERGED,5,59,3,0,1,13,False,0,0,0,1147,64,132.695,Document
Erlang,2054,12122,3817.01625,MERGED,1,1,1,0,1,21,True,0,0,0,1074,2,15.248333333333333,Document
TypeScript,41368,87412,2957.5243750000004,MERGED,2,2,1,1,1,91,True,0,1,1,2236,4,2.1069444444444443,Document
TypeScript,41368,87412,2957.455625,MERGED,1,1,1,1,2,90,True,0,1,1,2757,2,3.752222222222222,Document
TypeScript,41368,87412,2957.509629629629,MERGED,4,24,2,0,2,12,True,0,0,0,2385,28,0.98,Document
TypeScript,149,2900,399.8061689814815,CLOSED,2,18,2,1,1,107,False,0,1,1,2126,20,743.4419444444444,Bug
TypeScript,261,3765,694.7817361111111,MERGED,6,46,6,0,3,142,True,0,0,0,2644,52,17.31277777777778,Document
TypeScript,41368,87412,2958.700590277778,MERGED,41,78,15,2,4,18,False,1,1,1,3310,119,454.00916666666666,Document
Erlang,2054,12122,3818.451331018519,MERGED,75,166,5,0,2,371,False,0,0,0,1087,241,183.5475,Document
Go,30,295,369.88128472222223,MERGED,34,412,19,5,13,99,True,2,3,1,6444,446,26.18638888888889,Feature
TypeScript,41368,87412,2955.7236689814818,MERGED,5,4,1,0,2,439,True,0,0,0,2329,9,27.754444444444445,Document
Python,19249,70258,2484.349525462963,CLOSED,11,48,2,4,54,238,False,3,1,1,1198,59,76.71138888888889,Bug
TypeScript,41368,87412,2956.0379050925926,MERGED,1,1,1,0,1,1,False,0,0,0,2509,2,0.9069444444444444,Document
Erlang,2054,12122,3819.289930555555,MERGED,19,8,1,0,2,144,False,0,0,0,954,27,111.45861111111111,Document
Erlang,2054,12122,3817.892337962963,MERGED,59,19,13,0,3,491,True,0,0,0,1343,78,162.08027777777778,Document
Erlang,2054,12122,3819.145520833333,MERGED,580,1230,32,0,13,68,False,0,0,0,1289,1810,99.58361111111111,Document
TypeScript,41368,87412,2955.4841898148147,MERGED,2,2,2,0,1,89,True,0,0,0,2450,4,0.7847222222222222,Document
TypeScript,41368,87412,2955.4692129629634,MERGED,4,1,1,0,1,1606,True,0,0,0,2254,5,0.5766666666666667,Document
TypeScript,218,1201,2951.3693055555555,MERGED,296,150,8,4,17,178,True,4,0,0,1363,446,324.75638888888886,Feature
TypeScript,58,78,843.3073148148147,MERGED,97,306,19,1,3,96,False,0,1,1,7512,403,25.990555555555556,Bug
Starlark,440,286,513.8973263888889,MERGED,1,1,1,0,1,32,False,0,0,0,1211,2,69.83027777777778,Feature
TypeScript,2071,16640,1264.7902083333333,MERGED,1,7,2,0,2,8,False,0,0,0,3113,8,138.84472222222223,Bug
JavaScript,22,26,941.9305092592593,MERGED,5,4,2,0,1,10,True,0,0,0,1567,9,3.0069444444444446,Feature
Python,19249,70258,2482.6266087962963,CLOSED,1,87,3,2,19,235,False,1,1,1,1040,88,29.924166666666668,Feature
C++,2234,23694,2376.9607407407407,MERGED,33,58,3,1,6,31,False,0,1,1,3635,91,267.18305555555554,Bug
Python,137,75,708.4969444444445,MERGED,4,124,15,0,6,23,False,0,0,0,2412,128,919.8755555555556,Bug
JavaScript,8844,63474,4100.409247685185,MERGED,19,45,7,0,1,110,True,0,0,0,3343,64,92.42444444444445,Document
Rust,264,5383,423.9133564814815,MERGED,22,79,11,3,1,113,True,3,0,0,4263,101,72.24333333333334,Bug
TypeScript,4,33,786.4689583333334,MERGED,63,32,3,2,1,614,True,1,1,1,1426,95,140.70027777777779,Document
TypeScript,85,723,339.0906944444444,MERGED,688,2260,22,0,70,16,False,0,0,0,6792,2948,4.643611111111111,Document
Python,2407,12180,263.8908912037037,MERGED,131,141,5,0,15,303,True,0,0,0,1691,272,54.553333333333335,Document
TypeScript,3393,2334,989.2643171296296,MERGED,1,1,1,4,6,270,False,1,3,2,1807,2,209.70388888888888,Feature
TypeScript,261,3765,699.6533449074074,MERGED,85,386,20,0,5,176,False,0,0,0,5594,471,76.62611111111111,Document
Python,137,75,706.9471064814815,MERGED,11,39,6,0,8,75,False,0,0,0,3809,50,8.66388888888889,Bug
JavaScript,8844,63474,4097.685543981482,MERGED,2,248,6,0,6,109,True,0,0,0,4273,250,157.72861111111112,Bug
Erlang,2054,12122,3818.957986111111,CLOSED,2,8,3,0,1,244,True,0,0,0,1172,10,0.7563888888888889,Document
Python,2407,12180,259.7596643518519,MERGED,0,12,1,10,7,1,False,4,6,1,1518,12,179.59222222222223,Document
Erlang,2054,12122,3818.3382407407407,MERGED,1,1,1,0,1,14,False,0,0,0,1172,2,27.023611111111112,Document
Erlang,2054,12122,3818.7223611111112,MERGED,3,55,4,0,1,373,True,0,0,0,1349,58,4.163888888888889,Document
Erlang,2054,12122,3818.314050925926,MERGED,9,8,3,0,1,369,False,0,0,0,1191,17,18.779444444444444,Document
TypeScript,85,723,336.87217592592594,MERGED,37,653,27,0,5,94,False,0,0,0,6403,690,25.426111111111112,Document
Erlang,2054,12122,3818.2853125,MERGED,24,30,7,0,8,76,True,0,0,0,953,54,18.609166666666667,Document
Erlang,2054,12122,3814.214872685185,MERGED,73,301,6,0,2,385,True,0,0,0,1344,374,200.89416666666668,Document
TypeScript,4,33,786.1933680555557,MERGED,1,6,3,1,1,60,False,0,1,1,1372,7,66.59777777777778,Bug
Erlang,2054,12122,3818.2026388888885,MERGED,0,2,2,1,1,75,True,1,0,0,1336,2,16.156944444444445,Document
Java,450,746,4095.221365740741,MERGED,154,248,116,2,13,151,False,0,2,1,4679,402,136.65555555555557,Bug
C#,80,125,843.793287037037,MERGED,1,6,2,0,5,90,False,0,0,0,1245,7,66.32916666666667,Document
Erlang,2054,12122,3817.00681712963,MERGED,53,37,7,0,1,390,True,0,0,0,1457,90,45.68666666666667,Document
C++,2234,23694,2379.0184606481484,MERGED,20,56,13,1,5,294,False,0,1,1,4458,76,39.466944444444444,Bug
JavaScript,5139,7050,1227.8643981481482,MERGED,476,344,46,10,27,57,False,5,5,3,6458,820,172.73194444444445,Feature
Erlang,2054,12122,3817.204375,MERGED,45,73,10,0,1,66,False,0,0,0,1000,118,29.798055555555557,Document
C#,80,125,842.424988425926,MERGED,1328,3698,4,0,3,179,True,0,0,0,1131,5026,95.43416666666667,Document
Go,789,5551,1064.0584490740741,MERGED,0,9,2,0,1,14,False,0,0,0,2172,9,258.9563888888889,Document
Erlang,2054,12122,3817.169375,MERGED,110,109,7,0,1,65,False,0,0,0,1092,219,17.163611111111113,Document
TypeScript,1297,21107,438.84321759259257,CLOSED,0,1,1,3,3,0,False,1,2,2,1361,1,20.70611111111111,Document
Rust,264,5383,424.9364699074074,MERGED,22,21,11,1,1,428,False,0,1,1,3955,43,3.9252777777777776,Bug
Starlark,440,286,509.2330324074074,MERGED,0,528,2,1,1,0,False,1,0,0,1138,528,109.34916666666666,Document
TypeScript,85,723,335.94278935185184,MERGED,22,154,11,0,1,93,False,0,0,0,5976,176,2.473611111111111,Document
C#,80,125,843.9833333333332,CLOSED,208,977,33,0,20,198,True,0,0,0,1062,1185,0.18583333333333332,Document
Python,2407,12180,261.67141203703704,MERGED,1,1,1,1,4,140,True,0,1,1,1322,2,14.261388888888888,Bug
Starlark,440,286,511.21197916666665,CLOSED,0,188,2,1,10,0,False,1,0,0,1377,188,0.11666666666666667,Feature
Erlang,2054,12122,3816.159490740741,MERGED,168,536,8,0,12,74,True,0,0,0,1012,704,47.85888888888889,Document
Python,2407,12180,261.5734722222222,MERGED,18,37,1,1,6,76,True,0,1,1,1989,55,16.260277777777777,Feature
TypeScript,4,33,786.1686342592593,MERGED,1,5,1,2,1,224,True,1,1,1,1077,6,0.12694444444444444,Bug
TypeScript,4,33,786.1462847222223,MERGED,0,15,1,1,1,59,False,0,1,1,1327,15,0.28055555555555556,Feature
TypeScript,2,3,177.68894675925927,CLOSED,92,96,8,1,2,28,True,0,1,1,6736,188,0.07055555555555555,Bug
Rust,264,5383,424.1787615740741,MERGED,40,266,41,0,7,341,False,0,0,0,4517,306,19.906111111111112,Feature
TypeScript,2147,14722,1492.86,MERGED,58,100,10,0,3,81,False,0,0,0,5578,158,0.3125,Bug
Starlark,440,286,508.6267013888889,MERGED,0,782,2,0,1,60,False,0,0,0,1270,782,123.89222222222222,Document
TypeScript,41368,87412,2960.0649074074076,MERGED,39,191,4,2,12,15,False,0,2,2,3374,230,141.73444444444445,Document
Python,2407,12180,260.23162037037036,MERGED,3,30,1,9,6,0,False,4,5,1,1144,33,18.996111111111112,Document
Go,789,5551,1062.2792361111112,MERGED,1,1,1,4,1,13,False,2,2,1,2024,2,301.6772222222222,Document
Erlang,2054,12122,3816.434976851852,MERGED,20,51,10,0,7,364,False,0,0,0,1160,71,22.55361111111111,Document
Erlang,2054,12122,3816.7604166666665,MERGED,40,86,3,0,1,389,True,0,0,0,1158,126,5.607222222222222,Document
TypeScript,261,3765,697.7985416666667,MERGED,146,848,81,0,3,200,False,0,0,0,5940,994,0.8244444444444444,Document
TypeScript,3393,2334,990.4007060185186,CLOSED,1,1,1,3,1,272,False,0,3,2,1376,2,0.26611111111111113,Feature
TypeScript,2147,14722,1492.2750578703706,MERGED,20,480,9,0,3,174,False,0,0,0,5219,500,13.04861111111111,Document
Rust,264,5383,423.23657407407404,MERGED,41,366,10,0,14,340,False,0,0,0,3772,407,42.48444444444444,Feature
TypeScript,3393,2334,990.3102199074074,MERGED,2,111,2,2,3,466,False,0,2,1,1379,113,1.0516666666666667,Feature
Erlang,2054,12122,3814.2061574074073,CLOSED,12,19,3,0,1,383,True,0,0,0,1277,31,106.445,Document
TypeScript,261,3765,697.5430324074074,MERGED,88,108,4,0,9,173,False,0,0,0,5444,196,2.9880555555555555,Document
TypeScript,85,723,334.9406828703704,MERGED,91,354,16,0,4,91,False,0,0,0,7378,445,22.274444444444445,Document
Erlang,2054,12122,3816.334537037037,CLOSED,3,10,1,1,1,11,False,1,0,0,1116,13,0.3163888888888889,Document
TypeScript,1297,21107,438.7368055555555,MERGED,61,73,8,1,2,1002,True,0,1,1,3372,134,0.08083333333333333,Document
TypeScript,1297,21107,438.7272685185185,MERGED,78,105,11,1,3,1001,True,0,1,1,3393,183,0.041944444444444444,Document
Erlang,2054,12122,3815.972291666667,MERGED,1,113,3,0,1,388,True,0,0,0,1269,114,15.900555555555556,Document
Python,2407,12180,261.0003703703704,MERGED,35,46,14,0,6,299,True,0,0,0,1230,81,1.7202777777777778,Document
TypeScript,3393,2334,989.4933101851852,MERGED,1,1,1,2,1,0,False,0,2,1,1310,2,0.4588888888888889,Bug
TypeScript,2147,14722,1492.2726967592591,CLOSED,20,527,9,0,1,173,False,0,0,0,5859,547,0.04555555555555556,Document
Vue,10806,21162,1044.0998842592592,MERGED,85,139,5,1,3,29,False,0,1,1,4205,224,75.65972222222223,Document
Erlang,2054,12122,3815.681111111111,MERGED,2,20,5,0,1,386,True,0,0,0,1396,22,24.423333333333332,Document
TypeScript,4,33,784.5729976851852,MERGED,8,19,3,2,2,206,False,1,1,1,1210,27,0.21916666666666668,Feature
C++,2234,23694,2376.903923611111,MERGED,111,175,5,1,14,291,False,0,1,1,3600,286,49.217777777777776,Bug
TypeScript,3393,2334,989.8878356481482,MERGED,0,3,1,1,1,126,False,0,1,1,1334,3,0.11555555555555555,Feature
JavaScript,9664,43889,3678.9627662037037,MERGED,99,226,13,0,1,267,True,0,0,0,1001,325,22.043055555555554,Bug
TypeScript,202,107,1166.0939699074074,CLOSED,2,6,1,4,1,128,False,0,4,4,1380,8,7.370555555555556,Document
TypeScript,3393,2334,989.424699074074,MERGED,9,9,1,2,1,271,False,0,2,1,1132,18,11.934722222222222,Feature
Erlang,2054,12122,3815.8310185185182,CLOSED,5,122,5,0,12,242,True,0,0,0,1211,127,0.10583333333333333,Document
Erlang,2054,12122,3815.4983796296297,MERGED,1,1,1,0,1,357,False,0,0,0,1133,2,15.223333333333333,Document
C#,80,125,841.8561226851853,MERGED,11182,37886,372,0,27,178,False,0,0,0,1260,49068,21.616666666666667,Document
TypeScript,4,33,784.2400231481482,MERGED,1,2,1,1,1,221,True,1,0,0,1099,3,0.10722222222222222,Feature
Erlang,2054,12122,3815.4757986111113,CLOSED,9,126,9,1,10,356,False,0,1,1,1174,135,8.676944444444445,Document
JavaScript,5139,7050,1226.7337615740742,MERGED,31,56,19,5,14,100,False,2,3,2,5481,87,116.39833333333333,Bug
Erlang,2054,12122,3815.4601967592594,MERGED,4,4,1,0,1,354,False,0,0,0,1320,8,14.9175,Document
JavaScript,34,25,217.08572916666665,MERGED,25,76,2,6,4,10,False,5,1,1,1773,101,118.26777777777778,Bug
TypeScript,261,3765,695.9607175925926,MERGED,40,389,17,0,2,258,True,0,0,0,6532,429,36.434444444444445,Document
TypeScript,3393,2334,989.3698032407407,CLOSED,42,456,3,5,1,0,False,1,4,3,1528,498,2.9669444444444446,Feature
Go,2083,11769,1540.930162037037,MERGED,128,216,4,10,5,0,False,2,8,3,3512,344,164.11888888888888,Document
TypeScript,261,3765,696.6467708333333,MERGED,22,226,15,0,4,904,True,0,0,0,7083,248,0.9744444444444444,Document
C++,2234,23694,2376.7813194444443,MERGED,51,55,6,1,2,17,False,0,1,1,1835,106,1.218888888888889,Bug
C++,2234,23694,2376.720810185185,MERGED,8,9,1,3,9,289,False,1,2,2,3547,17,29.634166666666665,Feature
Erlang,2054,12122,3814.2116087962963,MERGED,4,31,3,0,7,384,True,0,0,0,1084,35,59.93888888888889,Document
Erlang,2054,12122,3815.2325,MERGED,1,2,2,0,1,481,False,0,0,0,1195,3,10.711944444444445,Document
Python,137,75,704.313298611111,MERGED,5,5,2,0,1,237,False,0,0,0,1484,10,0.2088888888888889,Document
Python,2407,12180,260.0254166666667,MERGED,1,1,1,0,1,297,True,0,0,0,1602,2,0.11611111111111111,Document
Erlang,2054,12122,3815.1006481481486,MERGED,89,144,19,0,16,352,False,0,0,0,1198,233,8.976666666666667,Document
Erlang,2054,12122,3814.9757754629627,MERGED,8986,25,113,0,3,1014,True,0,0,0,1151,9011,7.693611111111111,Document
TypeScript,261,3765,695.9598148148148,MERGED,95,146,10,0,4,197,False,0,0,0,6089,241,12.789444444444445,Document
Erlang,2054,12122,3814.9992361111113,MERGED,1,1,1,0,1,20,True,0,0,0,1036,2,5.5616666666666665,Document
TypeScript,3393,2334,988.9064236111111,MERGED,7,8,2,1,1,713,False,0,1,1,1572,15,0.7208333333333333,Feature
Erlang,2054,12122,3815.044849537037,MERGED,5,4,4,0,2,241,True,0,0,0,1456,9,1.118611111111111,Document
TypeScript,261,3765,695.7758564814816,MERGED,86,177,11,0,3,103,True,0,0,0,5265,263,17.406388888888888,Document
TypeScript,41368,87412,2957.684490740741,MERGED,9,147,6,1,2,593,True,0,1,1,3721,156,145.70833333333334,Document
Erlang,2054,12122,3814.9855902777776,MERGED,70,229,12,0,3,480,False,0,0,0,1509,299,2.047222222222222,Document
TypeScript,4,33,783.2699537037038,MERGED,1,1,1,2,1,219,True,1,1,1,1110,2,0.043055555555555555,Document
TypeScript,3393,2334,988.338738425926,MERGED,7,7,1,2,1,463,False,0,2,1,1209,14,13.125833333333333,Bug
JavaScript,34,25,218.98603009259259,MERGED,4,1,2,0,1,78,False,0,0,0,1178,5,6.304722222222222,Bug
Starlark,440,286,513.3197569444444,MERGED,0,146,2,2,3,0,False,2,0,0,2207,146,180.46777777777777,Document
TypeScript,15,34,511.7827893518518,MERGED,69,109,5,2,4,324,False,1,1,1,1179,178,26.511111111111113,Bug
TypeScript,4,33,783.0404513888889,MERGED,18,26,3,2,2,217,True,1,1,1,1238,44,0.7577777777777778,Feature
TypeScript,3393,2334,988.4101736111111,MERGED,3,3,1,1,1,335,False,0,1,1,1285,6,0.09444444444444444,Bug
TypeScript,202,107,1163.5929398148148,CLOSED,399,313,4,4,3,3,False,1,3,3,1524,712,55.95194444444444,Bug
Python,2407,12180,259.31158564814814,MERGED,1,1,1,0,1,296,True,0,0,0,1560,2,0.005555555555555556,Document
Erlang,2054,12122,3814.200428240741,MERGED,42,73,3,0,2,382,True,0,0,0,1260,115,16.29888888888889,Document
TypeScript,3393,2334,988.2214814814815,MERGED,0,8,1,1,1,334,False,0,1,1,1214,8,0.48277777777777775,Feature
TypeScript,3393,2334,988.1931018518518,MERGED,0,7,1,1,1,333,False,0,1,1,1404,7,0.59,Feature
TypeScript,42,46,790.7333101851851,MERGED,26,80,3,1,24,144,False,0,1,1,1433,106,26.25138888888889,Document
TypeScript,4,33,782.2592129629629,MERGED,67,623,26,1,18,374,False,0,1,1,1332,690,19.372222222222224,Document
C#,80,125,840.735162037037,MERGED,34,22,2,0,1,87,False,0,0,0,1236,56,19.884444444444444,Document
C#,80,125,840.514837962963,MERGED,164,182,26,0,11,37,False,0,0,0,1372,346,23.16888888888889,Document
Starlark,440,286,511.77435185185186,MERGED,0,151,2,4,1,0,False,2,2,2,2085,151,217.54444444444445,Document
TypeScript,4,33,782.3686226851852,MERGED,1,15,2,2,1,604,True,1,1,1,1307,16,0.10861111111111112,Bug
TypeScript,41368,87412,2958.6438310185185,MERGED,6,95,6,0,5,14,True,0,0,0,4265,101,47.98305555555555,Document
TypeScript,41368,87412,2959.4910648148148,MERGED,7,10,2,0,2,24,False,0,0,0,3780,17,1.2866666666666666,Document
TypeScript,1073,11366,1114.6858449074073,MERGED,1,6,1,1,1,171,False,0,1,1,1319,7,0.25166666666666665,Feature
TypeScript,1073,11366,1114.6077083333332,MERGED,1,1,1,1,1,170,False,0,1,1,1644,2,0.3025,Bug
TypeScript,3393,2334,987.2976851851853,MERGED,1,8,1,1,1,708,False,0,1,1,1426,9,0.09833333333333333,Bug
TypeScript,3393,2334,987.2734837962963,MERGED,1,1,1,1,1,706,False,0,1,1,1642,2,0.07777777777777778,Bug
Python,19249,70258,2483.5264930555554,CLOSED,24,12,2,1,3,236,False,1,0,0,1835,36,2.805833333333333,Feature
V,2097,34361,1571.4868749999998,MERGED,7,92,6,0,2,12,True,0,0,0,3747,99,21.73638888888889,Document
Go,789,5551,1063.1006018518517,MERGED,1,1,1,4,3,0,False,2,2,1,1949,2,88.95472222222222,Document
TypeScript,17,33,741.9247685185186,MERGED,255,327,22,1,8,31,True,0,1,1,1166,582,2.910833333333333,Feature
TypeScript,1073,11366,1113.7444675925926,MERGED,4,6,3,1,2,131,True,0,1,1,1654,10,18.008055555555554,Bug
TypeScript,3393,2334,986.8404166666666,MERGED,1,1,1,1,1,701,False,0,1,1,1312,2,0.12666666666666668,Bug
Erlang,2054,12122,3817.86619212963,MERGED,139,255,37,0,6,243,True,0,0,0,1729,394,153.5313888888889,Document
TypeScript,41368,87412,2958.4758101851853,MERGED,2,53,5,0,3,13,True,0,0,0,4155,55,2.6847222222222222,Document
Go,1835,11245,1750.8384143518517,MERGED,1,1,1,0,1,161,False,0,0,0,1613,2,0.18083333333333335,Document
JavaScript,34,25,216.92847222222224,MERGED,2,6,3,0,4,77,False,0,0,0,1664,8,0.2011111111111111,Bug
TypeScript,1297,21107,434.7822106481481,MERGED,277,253,93,1,5,985,True,0,1,1,4726,530,0.5847222222222223,Document
TypeScript,41368,87412,2957.829224537037,MERGED,2,2,2,0,1,1916,True,0,0,0,3017,4,14.7475,Document
TypeScript,41368,87412,2957.037743055556,MERGED,9,173,11,3,8,0,False,1,2,2,3830,182,44.07888888888889,Document
TypeScript,307,2556,557.5426851851852,MERGED,393,481,98,0,15,569,True,0,0,0,1016,874,1.9677777777777778,Bug
TypeScript,41368,87412,2957.4865046296295,MERGED,0,118,6,0,3,74,True,0,0,0,3261,118,1.9422222222222223,Document
TypeScript,4,33,786.4688657407409,MERGED,2,2,2,1,1,612,True,1,0,0,1770,4,65.955,Document
JavaScript,5139,7050,1224.697488425926,MERGED,15,157,4,2,35,107,False,0,2,2,5345,172,5.534722222222222,Bug
Go,789,5551,1062.3882638888888,MERGED,4,4,2,0,1,2,False,0,0,0,1936,8,10.267777777777777,Document
PHP,1334,2960,4227.160046296296,MERGED,7217,25,749,2,5,203,False,0,2,2,10586,7242,405.4575,Document
TypeScript,41368,87413,2956.5216550925925,MERGED,14,43,2,0,1,591,True,0,0,0,3815,57,1.833611111111111,Document
TypeScript,85,723,339.05600694444445,MERGED,23,91,17,0,5,99,False,0,0,0,8892,114,69.32,Document
TypeScript,140,827,769.0202314814815,MERGED,24,74,2,2,6,40,False,0,2,2,1897,98,6.460555555555556,Document
Erlang,2054,12122,3818.421828703704,MERGED,22,81,18,3,1,370,False,1,2,2,1754,103,16.0975,Document
TypeScript,58,78,843.0906944444445,MERGED,93,61,7,1,1,196,True,0,1,1,11424,154,31.226666666666667,Bug
Go,789,5551,1061.9793171296296,MERGED,3,3,1,1,1,193,True,1,0,0,1870,6,0.8872222222222222,Document
Go,789,5551,1061.9793171296296,CLOSED,3,3,1,0,1,193,True,0,0,0,1870,6,0.01861111111111111,Document
Python,2407,12180,262.5272685185185,MERGED,54,54,4,0,6,141,True,0,0,0,1778,108,32.401944444444446,Bug
TypeScript,261,3765,697.5014699074073,MERGED,48,76,12,0,2,216,True,0,0,0,4655,124,0.9466666666666667,Document
C#,80,125,842.8153472222222,MERGED,28,190,11,0,5,198,False,0,0,0,1627,218,113.34416666666667,Document
Starlark,440,286,510.6551851851852,MERGED,1,1,1,1,1,0,False,1,0,0,1899,2,75.22555555555556,Feature
TypeScript,4,33,786.2395370370369,MERGED,231,10,9,2,1,225,True,1,1,1,2185,241,0.04694444444444444,Document
Erlang,2054,12122,3817.2565277777776,MERGED,3,20,1,3,1,365,False,2,1,1,1570,23,24.1025,Document
TypeScript,4,33,786.1047685185185,MERGED,22,23,2,2,11,223,True,1,1,1,1683,45,1.9538888888888888,Bug
JavaScript,0,0,13.943958333333333,CLOSED,13,21,6,0,1,6,False,0,0,0,1764,34,97.92388888888888,Document
Python,2407,12180,262.26273148148147,MERGED,1,1,1,0,1,302,True,0,0,0,1619,2,0.085,Document
TypeScript,41368,87413,2958.829178240741,CLOSED,3201,5025,15,0,10,15,True,0,0,0,6950,8226,617.1908333333333,Document
TypeScript,1073,11366,1117.7459837962963,MERGED,3,6,2,4,4,278,True,2,2,2,2028,9,22.2575,Feature
TypeScript,4,33,785.4360416666667,MERGED,41,150,6,0,1,210,False,0,0,0,1893,191,0.17472222222222222,Document
Python,2407,12180,261.12274305555553,MERGED,1,1,1,0,1,300,True,0,0,0,1892,2,26.939722222222223,Document
Python,137,75,704.125787037037,MERGED,0,78,4,0,4,0,False,0,0,0,1864,78,76.3225,Document
TypeScript,41368,87413,2960.804131944444,MERGED,5,32,2,0,1,1919,True,0,0,0,5587,37,545.2719444444444,Document
Erlang,2054,12122,3815.874074074074,MERGED,7,86,4,0,1,387,True,0,0,0,1926,93,19.796944444444446,Document
Python,14531,41183,1109.3019097222223,MERGED,1,1,1,0,1,1420,True,0,0,0,1836,2,0.10722222222222222,Document
TypeScript,3393,2334,990.346087962963,MERGED,1,227,3,1,2,337,False,0,1,1,2094,228,0.3983333333333333,Feature
TypeScript,85,723,338.03774305555555,MERGED,44,220,31,0,1,98,False,0,0,0,8924,264,0.4625,Document
Erlang,2054,12122,3816.2724999999996,MERGED,0,1,1,0,1,361,False,0,0,0,1704,1,2.4858333333333333,Document
Erlang,2054,12122,3816.1785416666667,MERGED,5,3,4,1,2,359,False,1,0,0,1877,8,4.356944444444444,Document
Python,2407,12180,260.8350810185185,MERGED,8,9,3,3,11,74,True,0,3,1,2029,17,4.9911111111111115,Feature
TypeScript,4,33,784.6135532407408,MERGED,8,17,3,1,2,207,False,0,1,1,1980,25,0.1075,Document
Vue,10806,21162,1042.8540625,MERGED,47,60,2,1,2,28,False,0,1,1,2435,107,94.59777777777778,Document
Go,1835,11245,1750.0794560185186,MERGED,27,0,1,0,3,10,False,0,0,0,1715,27,0.008611111111111111,Document
Java,450,746,4095.0269328703703,MERGED,1,4,2,1,1,45,False,0,1,1,1541,5,0.025,Bug
Go,1835,11245,1749.934212962963,MERGED,21,23,2,0,2,7,False,0,0,0,2206,44,2.94,Document
TypeScript,2147,14722,1494.1561226851852,CLOSED,665,3042,135,0,27,35,False,0,0,0,8393,3707,0.7136111111111111,Document
TypeScript,4,33,783.5559259259259,MERGED,31,31,2,1,3,1,True,0,1,1,2041,62,17.575,Document
TypeScript,1073,11366,1116.5367708333333,MERGED,70,70,8,1,2,176,False,0,1,1,1856,140,3.539722222222222,Bug
Python,2407,12180,260.04019675925923,MERGED,1,1,1,0,1,298,True,0,0,0,1675,2,6.9127777777777775,Document
TypeScript,3393,2334,989.2015972222222,MERGED,5,6,3,3,1,465,False,0,3,2,2064,11,0.25222222222222224,Bug
TypeScript,3393,2334,988.9696296296296,MERGED,1,3,3,1,1,125,False,0,1,1,1986,4,0.3461111111111111,Bug
TypeScript,153,730,251.81057870370373,MERGED,1,6,2,0,1,12,True,0,0,0,1743,7,23.27861111111111,Document
C#,80,125,840.889837962963,MERGED,111,161,7,0,2,197,True,0,0,0,1557,272,49.598055555555554,Document
Python,2407,12180,259.29775462962965,MERGED,17,10,1,0,1,295,True,0,0,0,1913,27,0.07277777777777777,Document
Python,2407,12180,258.92614583333335,MERGED,3,3,2,10,4,0,False,4,6,1,1790,6,1.011388888888889,Document
TypeScript,2147,14722,1491.834675925926,CLOSED,148,444,13,0,5,54,False,0,0,0,10267,592,56.92888888888889,Bug
Java,450,746,4093.1972453703706,MERGED,1,5,2,1,2,43,False,0,1,1,1577,6,21.174166666666668,Feature
Go,1835,11245,1752.196087962963,MERGED,0,4,4,0,1,16,False,0,0,0,1986,4,1.0725,Document
Go,1835,11245,1751.9546643518518,MERGED,16,120,12,0,1,14,False,0,0,0,2259,136,1.0808333333333333,Document
TypeScript,1073,11366,1114.578888888889,MERGED,4,3,2,1,1,168,False,0,1,1,2092,7,0.2427777777777778,Feature
TypeScript,3393,2334,987.2803125,MERGED,4,3,2,1,1,707,False,0,1,1,1823,7,14.019444444444444,Feature
TypeScript,3393,2334,987.4681828703705,MERGED,13,9,3,1,6,331,False,0,1,1,1914,22,1.228888888888889,Feature
Go,1835,11245,1751.9124074074073,MERGED,4,4,4,0,1,164,False,0,0,0,1955,8,0.4697222222222222,Document
TypeScript,3393,2334,987.4928125,MERGED,0,1,1,1,1,332,False,0,1,1,2219,1,0.07694444444444444,Feature
Go,789,5551,1060.1154050925927,MERGED,117,741,33,6,1,11,False,5,1,1,2936,858,402.35527777777776,Document
Go,1835,11245,1751.8508564814813,MERGED,1,1,1,0,1,162,False,0,0,0,1627,2,1.3488888888888888,Document
TypeScript,261,3765,697.8728356481482,MERGED,244,279,29,0,2,607,True,0,0,0,7718,523,0.38555555555555554,Document
TypeScript,3393,2334,986.8751736111111,MERGED,6,5,3,1,2,703,False,0,1,1,1927,11,0.44972222222222225,Bug
Python,14531,41183,1110.5127430555556,MERGED,13,15,6,2,10,1421,True,1,1,1,3324,28,307.7630555555556,Document
TypeScript,3393,2334,986.8502314814815,MERGED,18,44,8,2,5,702,False,0,2,2,3290,62,506.81555555555553,Bug
TypeScript,1073,11366,1112.8695486111112,MERGED,11,2,2,1,1,754,True,0,1,1,2040,13,18.10638888888889,Feature
Go,1835,11245,1750.2342476851852,CLOSED,2,2,2,0,1,160,False,0,0,0,2191,4,0.051944444444444446,Document
Go,1835,11245,1750.2296643518519,MERGED,0,6,2,0,1,159,False,0,0,0,1698,6,0.011666666666666667,Document
Go,1835,11245,1750.1993402777778,MERGED,1,1,1,0,1,9,False,0,0,0,1674,2,0.029722222222222223,Document
Go,1835,11245,1750.101585648148,MERGED,1,327,9,0,1,11,False,0,0,0,2080,328,0.19805555555555557,Document
JavaScript,8844,63474,4101.507685185185,MERGED,57,82,7,1,1,2,False,0,1,1,7653,139,2.0694444444444446,Bug
TypeScript,261,3765,695.7164351851852,MERGED,171,510,14,0,3,102,True,0,0,0,8765,681,24.122222222222224,Document
Go,1835,11245,1749.8581018518519,MERGED,1,1,1,0,1,156,False,0,0,0,1566,2,0.025,Document
Go,1835,11245,1749.8464467592594,MERGED,0,95,2,0,1,155,False,0,0,0,1783,95,0.19805555555555557,Document
Go,1835,11245,1749.7691550925927,MERGED,132,24,1,0,1,154,False,0,0,0,1684,156,1.7294444444444443,Document
Go,1835,11245,1749.7541550925926,MERGED,40,39,1,0,1,5,False,0,0,0,1681,79,0.2847222222222222,Document
Go,1835,11245,1749.5975810185184,MERGED,0,57,10,0,3,5,False,0,0,0,1952,57,7.512777777777778,Document
Starlark,440,286,509.95633101851854,MERGED,0,163,5,6,6,0,False,3,3,2,3061,163,336.7658333333333,Document
TypeScript,261,3765,695.5902893518519,MERGED,213,468,24,0,1,102,False,0,0,0,8430,681,2.985,Document
Rust,264,5383,425.84596064814815,MERGED,38,449,23,2,5,245,True,1,1,1,5319,487,27.61722222222222,Feature
Go,1835,11245,1749.1632407407408,MERGED,0,149,1,0,1,153,False,0,0,0,1964,149,0.12527777777777777,Document
TypeScript,4,33,784.6927314814815,MERGED,76,78,3,1,1,208,False,0,1,1,2057,154,0.14694444444444443,Bug
Go,1835,11245,1750.5988657407406,CLOSED,4,2875,50,1,62,10,False,0,1,1,2746,2879,3.273888888888889,Document
TypeScript,1073,11366,1116.9960069444444,MERGED,5,5,1,0,1,4,False,0,0,0,2453,10,259.3047222222222,Document
Python,137,75,705.6156018518518,MERGED,117,531,18,1,16,22,False,1,0,0,3598,648,943.9061111111112,Document
Python,137,75,706.9044097222222,MERGED,0,80,5,0,2,3,False,0,0,0,2434,80,145.51777777777778,Document
Go,1835,11245,1747.6135416666666,MERGED,4,4,3,0,2,4,False,0,0,0,1705,8,4.733333333333333,Document
Go,1835,11245,1747.6166087962963,MERGED,6,6,1,0,1,61,False,0,0,0,1882,12,3.371111111111111,Document
Rust,264,5383,427.0042476851852,MERGED,5,103,12,0,1,168,False,0,0,0,6954,108,0.6225,Feature
Rust,264,5383,426.9057060185185,MERGED,11,32,3,0,1,265,True,0,0,0,5913,43,0.6802777777777778,Bug
Java,450,746,4096.005833333334,MERGED,4,4472,29,0,27,750,False,0,0,0,5219,4476,119.59333333333333,Feature
TypeScript,3393,2334,991.4992824074075,MERGED,20,12,4,3,1,0,False,0,3,2,2743,32,25.961666666666666,Bug
TypeScript,3393,2334,991.1633333333333,MERGED,52,4,2,2,1,0,False,0,2,1,3521,56,90.355,Bug
TypeScript,7,6,666.107974537037,MERGED,2039,5868,144,0,7,274,False,0,0,0,5560,7907,22.141666666666666,Feature
TypeScript,7,6,666.1414120370371,MERGED,215,139,9,0,1,275,False,0,0,0,7215,354,16.35,Feature
Rust,264,5383,425.94629629629634,MERGED,83,91,8,0,2,166,False,0,0,0,5337,174,2.508888888888889,Bug
Python,4516,54986,944.4295601851851,MERGED,16,20,1,6,4,1,False,2,4,3,6053,36,569.8013888888889,Document
Go,11875,71339,2718.9030555555555,MERGED,176,355,17,0,1,288,True,0,0,0,8602,531,19.018333333333334,Feature
Go,11875,71339,2715.9417824074076,MERGED,68,230,16,4,1,284,True,2,2,1,7388,298,12.8975,Document
TypeScript,1297,21107,439.7098379629629,MERGED,418,382,20,1,1,1004,True,0,1,1,7640,800,2.2827777777777776,Document
Go,789,5551,1062.0521643518518,MERGED,3,4,1,1,1,8,False,1,0,0,2655,7,4.045,Document
C++,2234,23695,2377.8841550925927,MERGED,827,203,7,1,17,292,False,0,1,1,7468,1030,42.3325,Bug
Erlang,2054,12122,3817.4531597222226,MERGED,3,5,3,1,1,366,False,1,0,0,2652,8,16.45861111111111,Document
Vue,10806,21162,1042.0843865740742,MERGED,29,0,14,1,3,0,False,0,1,1,3413,29,191.33916666666667,Bug
Python,72,25,1658.7359259259258,CLOSED,588,1364,11,7,7,29,False,4,3,1,9944,1952,498.21972222222223,Bug
C++,2234,23695,2376.8085069444446,MERGED,102,161,4,1,13,290,False,0,1,1,6144,263,43.719166666666666,Bug
TypeScript,1297,21107,438.5407986111111,MERGED,1513,1542,421,1,13,999,True,0,1,1,6714,3055,1.1355555555555557,Document
Python,2407,12180,262.0193865740741,MERGED,8,25,9,0,11,301,True,0,0,0,2424,33,5.5875,Document
TypeScript,4,33,785.1699189814814,MERGED,18,16,2,6,1,607,True,4,2,1,2545,34,29.509722222222223,Bug
Go,789,5551,1059.8858101851852,MERGED,4,25,2,3,1,7,False,1,2,2,3157,29,46.29138888888889,Document
TypeScript,58,78,843.3650231481482,MERGED,465,391,29,1,17,201,True,0,1,1,14725,856,94.82527777777777,Bug
JavaScript,34,25,220.15547453703707,MERGED,9,17,3,0,1,79,False,0,0,0,2652,26,0.30833333333333335,Bug
Python,2407,12180,259.9619560185185,MERGED,6,23,2,6,6,139,True,2,4,1,2923,29,54.8025,Bug
Rust,413,5117,489.80037037037033,MERGED,3,3,1,0,1,150,False,0,0,0,2388,6,0.7380555555555556,Document
Erlang,2054,12122,3816.284224537037,MERGED,3,9,3,0,3,362,False,0,0,0,2599,12,3.622777777777778,Document
Erlang,2054,12122,3816.170636574074,MERGED,6,8,4,0,3,358,False,0,0,0,2355,14,2.436111111111111,Document
Go,11875,71339,2715.0348263888886,MERGED,35,45,11,0,1,280,True,0,0,0,7356,80,0.20555555555555555,Feature
Go,1835,11245,1749.804398148148,MERGED,26,59,15,0,1,6,False,0,0,0,2244,85,2.4855555555555555,Document
Erlang,2054,12122,3815.467453703704,MERGED,5,6,1,0,1,355,False,0,0,0,2432,11,15.689444444444444,Document
TypeScript,4,33,784.1208217592592,MERGED,61,107,27,2,23,220,True,1,1,1,2485,168,3.2466666666666666,Bug
Python,2407,12180,259.71533564814814,MERGED,0,9,1,8,9,138,True,3,5,1,2165,9,31.56361111111111,Bug
TypeScript,4,33,783.869525462963,MERGED,696,1175,25,1,7,204,False,0,1,1,2518,1871,1.5280555555555555,Feature
TypeScript,3393,2334,988.0659375,MERGED,117,155,23,2,6,711,False,0,2,2,2710,272,46.44,Bug
Python,137,75,704.0150578703705,MERGED,4,16,4,0,1,216,False,0,0,0,2285,20,0.14722222222222223,Bug
Go,1835,11245,1752.244097222222,MERGED,5,5,5,0,1,165,False,0,0,0,2359,10,56.29527777777778,Document
TypeScript,3393,2334,988.3461342592592,MERGED,16,163,2,3,2,464,False,0,3,2,3037,179,12.95138888888889,Bug
TypeScript,2147,14722,1494.2068749999999,CLOSED,0,0,0,0,0,36,False,0,0,0,11292,0,111.59527777777778,Document
TypeScript,4,33,783.1888888888889,MERGED,108,647,23,2,1,605,True,1,1,1,2546,755,0.25,Bug
Java,450,746,4093.110300925926,MERGED,2,6,2,1,4,42,False,0,1,1,2187,8,23.243333333333332,Feature
Python,2407,12180,258.9455555555556,MERGED,18,34,3,1,2,292,True,1,0,0,2874,52,0.3275,Document
TypeScript,1073,11366,1114.8771296296297,MERGED,42,25,4,1,2,173,False,0,1,1,2909,67,20.216944444444444,Feature
Python,2407,12180,258.86641203703704,MERGED,327,335,8,0,13,136,True,0,0,0,2488,662,0.8052777777777778,Bug
Vue,293,495,849.1256365740741,MERGED,49,162,17,4,21,311,True,0,4,3,2059,211,19.404722222222222,Bug
TypeScript,3393,2334,987.214837962963,MERGED,29,57,3,1,4,704,False,0,1,1,2538,86,15.79861111111111,Bug
TypeScript,1073,11366,1114.8761342592593,MERGED,0,11,1,1,1,172,False,0,1,1,2435,11,3.8230555555555554,Bug
Go,1835,11245,1752.0984722222222,MERGED,6,10,3,0,1,15,False,0,0,0,2397,16,0.07527777777777778,Document
Go,1835,11245,1752.1170486111112,MERGED,165,0,22,0,1,12,False,0,0,0,2159,165,0.07805555555555556,Document
TypeScript,261,3765,699.7802777777778,MERGED,111,1696,20,0,4,610,True,0,0,0,10190,1807,91.38222222222223,Document
TypeScript,3393,2334,987.2241435185184,MERGED,4,8,6,1,3,705,False,0,1,1,2355,12,0.4875,Bug
TypeScript,3393,2334,987.1942708333332,MERGED,16,17,2,1,1,330,False,0,1,1,2488,33,1.2647222222222223,Bug
Go,1835,11245,1751.8510300925927,MERGED,57,730,5,0,1,163,False,0,0,0,3044,787,4.613333333333333,Document
Go,1835,11245,1751.827662037037,MERGED,0,90,16,0,8,1,False,0,0,0,2815,90,1.6619444444444444,Document
TypeScript,41368,87413,2957.4349074074075,MERGED,2,48,3,0,8,592,True,0,0,0,5921,50,2.7844444444444445,Document
Go,1835,11245,1750.2477662037036,MERGED,76,21,10,0,1,13,False,0,0,0,2339,97,0.5141666666666667,Document
Go,1835,11245,1750.7928009259258,MERGED,0,222,4,0,1,538,False,0,0,0,2297,222,8.526388888888889,Document
Go,1835,11245,1750.7479629629631,MERGED,34,136,2,0,1,536,False,0,0,0,2561,170,9.610833333333334,Document
Erlang,2054,12122,3818.133414351852,MERGED,251,107,55,3,6,367,False,1,2,1,3096,358,30.012777777777778,Document
Go,1835,11245,1750.7535069444446,MERGED,104,13,2,0,1,537,False,0,0,0,2166,117,1.701111111111111,Document
Go,1835,11245,1750.1579050925927,CLOSED,58,3,1,0,1,534,False,0,0,0,2320,61,8.83,Document
Go,1835,11245,1750.0674074074075,MERGED,0,291,40,1,1,27,False,1,0,0,2269,291,1.9955555555555555,Document
Go,1835,11245,1749.9412268518518,MERGED,12,12,8,0,1,19,True,0,0,0,3271,24,0.17527777777777778,Document
Go,1835,11245,1749.9961342592594,MERGED,0,63,15,0,1,9,False,0,0,0,2438,63,1.4616666666666667,Document
Go,1835,11245,1749.9805787037037,CLOSED,26,218,25,0,1,4,False,0,0,0,2293,244,0.7952777777777778,Document
Go,1835,11245,1749.948125,CLOSED,0,0,0,0,0,8,False,0,0,0,2720,0,1.1094444444444445,Document
Go,1835,11245,1749.8436921296297,MERGED,2,17,6,0,1,531,False,0,0,0,2486,19,0.08416666666666667,Document
TypeScript,261,3765,695.6478703703705,MERGED,3,146,11,0,2,255,True,0,0,0,4671,149,0.23333333333333334,Document
TypeScript,184,377,1932.1922800925925,MERGED,50,36,5,1,2,31,False,1,0,0,7419,86,138.2613888888889,Document
Rust,264,5383,426.36532407407407,MERGED,0,110,11,0,1,0,False,0,0,0,7190,110,20.016111111111112,Feature
Rust,264,5383,426.04431712962963,MERGED,61,522,21,0,6,264,True,0,0,0,9560,583,19.73472222222222,Feature
Starlark,440,286,514.0744444444445,MERGED,0,314,8,2,18,2,False,0,2,2,3493,314,162.47083333333333,Document
Rust,264,5383,426.0540277777778,MERGED,12,149,12,0,1,69,False,0,0,0,9936,161,3.524722222222222,Feature
Go,54,353,756.864236111111,MERGED,447,841,14,1,2,38,True,1,0,0,9522,1288,3.226111111111111,Feature
TypeScript,7,6,664.2487731481482,CLOSED,389,442,20,0,7,224,False,0,0,0,10712,831,20.647777777777776,Feature
Vue,10806,21162,1045.9144097222222,MERGED,211,217,32,1,16,157,False,0,1,1,10861,428,0.49916666666666665,Document
V,2097,34361,1573.6342708333334,MERGED,9,54,2,0,1,1,False,0,0,0,7798,63,37.759166666666665,Document
TypeScript,3393,2334,990.1446412037036,MERGED,49,68,3,1,8,128,False,0,1,1,3911,117,160.54472222222222,Bug
Rust,264,5383,423.1148611111111,MERGED,145,49,3,0,1,423,False,0,0,0,8767,194,0.12055555555555555,Bug
TypeScript,1297,21107,437.89979166666666,MERGED,263,194,54,1,5,996,True,0,1,1,11433,457,0.7716666666666666,Document
TypeScript,1073,11366,1116.6134953703704,MERGED,13,39,5,1,3,177,False,0,1,1,4101,52,139.3386111111111,Bug
TypeScript,42,46,793.8832407407408,MERGED,14,14,5,1,29,24,False,0,1,1,3352,28,71.69416666666666,Bug
TypeScript,1073,11366,1115.7933217592592,MERGED,17,34,1,1,1,175,False,0,1,1,4892,51,159.04583333333332,Document
Python,4516,54986,948.1693055555555,MERGED,2,9,1,4,4,144,False,2,2,2,3594,11,46.11888888888889,Document
Python,4516,54986,948.7159027777778,MERGED,1,8,2,5,3,92,True,2,3,2,3762,9,16.093055555555555,Document
TypeScript,3393,2334,991.1970717592593,CLOSED,15,25,7,2,1,0,False,0,2,1,3940,40,6.707222222222223,Document
TypeScript,3706,54074,1380.0210532407407,MERGED,10,21,2,0,1,168,True,0,0,0,3881,31,25.176666666666666,Feature
TypeScript,4,33,785.1699768518519,MERGED,13,13,11,5,1,609,True,4,1,1,3602,26,29.725555555555555,Feature
Python,4516,54986,947.8808101851852,MERGED,0,3,1,2,3,1,False,0,2,1,3673,3,5.073611111111111,Document
C#,80,125,843.8530787037038,MERGED,1,1,1,0,1,183,False,0,0,0,3734,2,0.2902777777777778,Document
TypeScript,4,33,785.6799074074074,MERGED,78,107,16,1,1,212,False,0,1,1,3674,185,0.125,Bug
TypeScript,4,33,785.1842013888889,MERGED,166,507,44,2,19,222,True,1,1,1,4033,673,2.229722222222222,Bug
Python,4516,54986,946.4157986111112,MERGED,2,6,1,0,1,91,True,0,0,0,3324,8,1.356111111111111,Document
TypeScript,1297,21107,434.55810185185186,MERGED,0,420,12,1,3,984,True,0,1,1,8369,420,4.336111111111111,Document
TypeScript,3393,2334,989.717488425926,MERGED,11,120,10,1,6,336,False,0,1,1,3619,131,14.131666666666666,Feature
Java,450,746,4094.188078703704,MERGED,62,87,8,1,15,44,False,0,1,1,4984,149,42.53277777777778,Bug
Python,968,6760,74.9333449074074,MERGED,22,56,1,0,2,113,False,0,0,0,3616,78,0.1025,Document
TypeScript,3393,2334,987.7428240740741,MERGED,5,16,1,2,1,0,False,0,2,1,3552,21,56.943333333333335,Bug
Go,789,5551,1058.906273148148,MERGED,7,113,2,0,1,6,False,0,0,0,3779,120,23.945555555555554,Document
Python,2407,12180,258.9051851851852,MERGED,348,417,9,10,50,137,True,2,8,2,4054,765,51.021388888888886,Document
Java,450,746,4092.9495254629633,MERGED,59,43,4,1,5,41,False,0,1,1,4276,102,27.06388888888889,Feature
Python,2407,12180,259.0254166666667,MERGED,9,34,1,0,2,294,True,0,0,0,3149,43,0.8488888888888889,Document
Python,2407,12180,258.98199074074074,MERGED,7,30,7,0,3,293,True,0,0,0,3873,37,0.11444444444444445,Document
Python,4516,54986,943.8345949074073,MERGED,12,14,1,2,3,142,False,2,0,0,4288,26,78.72888888888889,Document
TypeScript,3393,2334,987.8717361111111,MERGED,24,24,2,2,1,709,False,0,2,2,4196,48,0.1825,Bug
TypeScript,4,33,782.1884953703703,MERGED,39,163,11,2,11,216,True,1,1,1,4618,202,0.13027777777777777,Bug
Go,1835,11245,1752.1411689814815,MERGED,62,186,2,0,2,541,False,0,0,0,3415,248,2.4205555555555556,Document
TypeScript,1073,11366,1113.7796527777778,MERGED,43,81,2,1,7,2,True,0,1,1,4563,124,16.260277777777777,Bug
Go,1835,11245,1750.1176273148149,MERGED,12,12,2,0,1,12,False,0,0,0,3530,24,0.03111111111111111,Document
TypeScript,1073,11366,1112.6327546296295,MERGED,12,111,5,1,8,130,True,0,1,1,4929,123,5.478055555555556,Bug
Go,1835,11245,1750.1897222222224,MERGED,17,308,58,0,1,28,False,0,0,0,3972,325,0.017777777777777778,Document
Go,1835,11245,1750.2173032407409,MERGED,0,85,22,0,1,158,False,0,0,0,4937,85,0.035555555555555556,Document
Go,1835,11245,1750.070810185185,MERGED,873,12,17,0,1,157,False,0,0,0,3532,885,0.020555555555555556,Document
Go,1835,11245,1750.014502314815,MERGED,26,218,25,0,1,5,False,0,0,0,3387,244,0.075,Document
Go,1835,11245,1749.734537037037,MERGED,0,180,23,0,1,3,False,0,0,0,3495,180,4.191388888888889,Document
Go,1835,11245,1748.6777083333334,MERGED,62,2,5,0,1,529,False,0,0,0,3960,64,1.8447222222222222,Document
Go,1835,11245,1748.225787037037,MERGED,2414,5,61,1,1,151,False,0,1,1,4513,2419,8.544722222222223,Document
Python,14531,41183,1106.259513888889,MERGED,335,116,23,2,24,74,True,1,1,1,6035,451,874.8027777777778,Feature
JavaScript,3618,9017,2306.4247337962966,MERGED,629,1914,51,13,73,347,False,4,9,6,12653,2543,532.4658333333333,Document
TypeScript,184,377,1933.9738425925925,MERGED,1,93,3,0,15,33,False,0,0,0,8934,94,22.76888888888889,Document
C++,2234,23696,2380.4649189814813,MERGED,29,173,21,1,10,2,False,0,1,1,11924,202,33.26972222222222,Document
Rust,264,5383,425.10377314814815,MERGED,463,560,51,0,1,165,False,0,0,0,11576,1023,45.51444444444444,Bug
Go,421,1654,1530.2059606481482,MERGED,60,992,15,0,11,91,False,0,0,0,14211,1052,70.72277777777778,Document
Rust,264,5383,423.14543981481484,MERGED,198,1021,37,0,1,144,False,0,0,0,10288,1219,23.71472222222222,Bug
TypeScript,1297,21107,438.59231481481487,MERGED,116,200,9,1,1,1000,True,0,1,1,13077,316,0.39666666666666667,Document
TypeScript,1073,11366,1115.6187499999999,MERGED,734,1073,94,1,78,132,True,0,1,1,8249,1807,3.2316666666666665,Document
TypeScript,1073,11366,1112.8990046296296,MERGED,83,30,10,1,5,755,True,0,1,1,6094,113,495.75555555555553,Bug
TypeScript,184,377,1934.0797453703706,MERGED,0,23,1,0,17,35,False,0,0,0,5759,23,85.58444444444444,Document
Go,1835,11245,1750.8391898148147,CLOSED,0,252042,2774,1,1,11,False,0,1,1,6827,252042,449.57,Document
TypeScript,3393,2334,987.9636689814815,MERGED,208,1765,33,3,37,462,False,0,3,2,5617,1973,314.77166666666665,Feature
TypeScript,3706,54074,1381.1796296296297,MERGED,0,62,31,0,1,170,True,0,0,0,7077,62,120.91694444444444,Feature
TypeScript,4,33,786.3018981481482,MERGED,533,699,49,4,11,611,True,2,2,2,5907,1232,96.26166666666667,Document
TypeScript,4,33,786.468900462963,MERGED,121,119,45,2,3,613,True,1,1,1,5801,240,67.03916666666667,Bug
JavaScript,34,25,218.5348263888889,CLOSED,59,45,15,0,1,3,False,0,0,0,6431,104,192.4686111111111,Feature
TypeScript,3393,2334,991.0910995370369,MERGED,70,92,14,2,1,715,False,0,2,2,5878,162,0.6088888888888889,Feature
TypeScript,3393,2334,991.0954861111112,MERGED,87,161,8,2,1,129,False,0,2,2,7055,248,0.1761111111111111,Bug
Python,4516,54986,949.001087962963,MERGED,7,20,1,0,2,4,False,0,0,0,4938,27,10.624166666666667,Document
TypeScript,3393,2334,990.132800925926,MERGED,56,450,13,2,5,127,False,0,2,2,5254,506,20.084722222222222,Feature
Python,2407,12180,261.49240740740737,MERGED,60,158,2,1,12,75,True,0,1,1,6342,218,18.189166666666665,Document
TypeScript,4,33,785.0912962962963,MERGED,258,218,22,4,1,606,True,3,1,1,7237,476,31.294166666666666,Feature
TypeScript,3393,2334,989.4274189814814,MERGED,595,0,4,6,1,0,False,2,4,2,5532,595,14.023888888888889,Bug
Java,450,746,4095.0728703703703,MERGED,13,73,6,1,7,46,False,0,1,1,4868,86,21.163888888888888,Feature
Python,968,6760,74.87201388888889,MERGED,14,61,9,0,3,112,False,0,0,0,5889,75,0.7269444444444444,Document
Python,4516,54986,947.1427430555556,MERGED,29,46,2,0,6,143,False,0,0,0,4788,75,24.91777777777778,Document
Python,4516,54986,946.500787037037,MERGED,0,60,2,1,8,3,False,0,1,1,5405,60,20.814722222222223,Document
TypeScript,4,33,783.3606481481482,MERGED,666,1638,34,1,5,375,False,0,1,1,5367,2304,19.789166666666667,Bug
Go,1835,11245,1751.8225810185186,MERGED,59,408,10,0,3,540,False,0,0,0,6904,467,90.33805555555556,Document
Go,1835,11245,1751.9562847222223,CLOSED,0,0,0,1,0,1,False,0,1,1,6244,0,63.17388888888889,Document
Python,4516,54986,945.7601967592592,MERGED,0,35,2,3,8,2,False,2,1,1,4753,35,15.055555555555555,Document
Python,2407,12180,258.32087962962964,MERGED,47,76,17,0,20,291,True,0,0,0,6039,123,1.5,Document
Go,1835,11245,1750.953773148148,MERGED,0,172,12,0,1,539,False,0,0,0,4976,172,15.13861111111111,Document
Go,1835,11245,1751.8366203703702,MERGED,215,372,12,0,3,21,True,0,0,0,12333,587,138.2563888888889,Document
Go,1835,11245,1750.146377314815,MERGED,68,68,74,0,2,20,True,0,0,0,7358,136,0.04888888888888889,Document
Go,1835,11245,1750.7088194444443,MERGED,12,192,22,0,1,535,False,0,0,0,5163,204,1.0791666666666666,Document
Go,1835,11245,1750.171122685185,MERGED,7,7,4,0,1,8,False,0,0,0,5454,14,0.49666666666666665,Document
Go,1835,11245,1750.1383101851852,MERGED,43,54,89,0,1,7,False,0,0,0,7153,97,0.2588888888888889,Document
Go,1835,11245,1750.1332060185186,MERGED,1009,2727,107,1,1,533,False,0,1,1,6234,3736,0.06972222222222223,Document
Go,1835,11245,1750.1232291666665,CLOSED,43,54,89,0,1,6,False,0,0,0,6157,97,0.21166666666666667,Document
Go,1835,11245,1749.9124189814813,MERGED,91,86,44,0,3,532,False,0,0,0,7206,177,3.6925,Document
Go,54,353,756.8494907407407,MERGED,23,87,4,0,1,219,True,0,0,0,23928,110,0.38555555555555554,Bug
Go,1835,11245,1749.1512268518518,MERGED,1062,242,156,1,1,152,False,0,1,1,5228,1304,0.13,Document
Go,1835,11245,1746.9816666666666,MERGED,458,1522,48,1,2,528,False,0,1,1,7232,1980,26.800833333333333,Document
C++,2234,23696,2380.9660995370373,MERGED,34,73,8,1,3,324,False,0,1,1,10025,107,65.89333333333333,Bug
Java,450,746,4096.1655902777775,MERGED,183,443,23,1,38,47,False,0,1,1,9172,626,121.20444444444445,Feature
TypeScript,3393,2334,987.9891319444445,MERGED,380,563,22,1,4,124,False,0,1,1,9857,943,25.66638888888889,Bug
Go,1835,11245,1747.843275462963,MERGED,172,1013,21,1,3,17,True,0,1,1,8462,1185,234.8436111111111,Bug
Python,4516,54986,944.8381250000001,MERGED,0,93,2,0,14,1,False,0,0,0,8138,93,14.823611111111111,Document
TypeScript,3393,2334,986.9557754629631,MERGED,718,612,17,2,2,122,False,0,2,2,9503,1330,5.006388888888889,Feature
Go,1835,11245,1751.8482638888888,MERGED,88,118,18,0,4,32,False,0,0,0,9290,206,1.3927777777777777,Document
Go,1835,11245,1750.6449074074073,MERGED,5519,4151,26,1,8,62,False,0,1,1,8011,9670,35.57055555555556,Document
TypeScript,3393,2334,991.5137731481482,CLOSED,55,332,5,3,1,0,False,0,3,2,12656,387,110.57388888888889,Bug
TypeScript,3393,2334,990.891886574074,MERGED,84,74,22,2,2,714,False,0,2,2,12036,158,0.6180555555555556,Bug
Python,4516,54986,943.9183796296296,MERGED,5,52,1,0,3,35,False,0,0,0,9280,57,37.085277777777776,Document
Go,1835,11245,1749.7293518518518,MERGED,6894,5783,176,1,1,530,False,0,1,1,13143,12677,2.200277777777778,Document
Go,1835,11245,1747.9063425925926,MERGED,171,251,9,0,1,150,False,0,0,0,11541,422,2.2994444444444446,Document
TypeScript,1073,11366,1117.0723611111111,MERGED,970,8999,57,5,221,277,True,2,3,2,16802,9969,693.1825,Bug
C,5530,39709,79.95533564814815,MERGED,93,1676,17,135,49,42,True,20,115,26,24876,1769,146.68027777777777,Document
TypeScript,1073,11366,1116.0027662037037,MERGED,116,528,41,7,20,756,True,2,5,3,18270,644,260.0541666666667,Document
TypeScript,4,33,785.5447337962963,MERGED,977,648,42,1,7,211,False,0,1,1,15413,1625,2.4433333333333334,Bug
Go,1835,11245,1751.6388541666665,MERGED,5972,4622,47,1,4,63,False,0,1,1,15281,10594,101.03305555555555,Document
JavaScript,5139,7050,1231.6393287037038,MERGED,1,211,3,1,5,109,False,0,1,1,1340,212,1872.8638888888888,Document
V,2097,34361,1579.8896296296298,MERGED,0,21,2,3,1,27,True,1,2,1,846,21,22.608055555555556,Bug
Rust,264,5383,432.51869212962964,CLOSED,0,43,1,1,2,1,False,0,1,1,1015,43,1686.9927777777777,Feature
Rust,264,5383,430.82310185185185,MERGED,12,51,7,3,1,269,True,1,2,1,1820,63,1541.0,Feature
PHP,883,2338,1860.7789351851852,CLOSED,2,13,2,1,2,0,False,0,1,1,2202,15,1998.9855555555555,Document
TypeScript,2071,16640,1270.9235532407408,MERGED,1,1,1,0,4,0,False,0,0,0,2510,2,1907.7475,Bug
TypeScript,2147,14722,1501.7174305555554,MERGED,2,15,1,0,1,727,False,0,0,0,1011,17,24.19388888888889,Bug
TypeScript,2147,14722,1500.1722800925927,MERGED,1,17,1,0,1,726,False,0,0,0,848,18,61.31166666666667,Bug
TypeScript,3393,2334,996.385925925926,CLOSED,1,1,1,1,1,352,False,0,1,1,852,2,0.03222222222222222,Bug
Go,1835,11245,1755.7539814814816,MERGED,9,34,2,0,3,114,False,0,0,0,165,43,2.026111111111111,Feature
,0,1,47.60371527777778,CLOSED,0,27,1,0,1,2,False,0,0,0,622,27,193.92194444444445,Feature
Rust,264,5383,431.21931712962964,CLOSED,56,171,18,1,2,437,False,1,0,0,734,227,805.2616666666667,Feature
TypeScript,2147,14722,1500.008101851852,MERGED,8,14,2,0,2,725,False,0,0,0,1262,22,65.27666666666667,Document
TypeScript,2147,14722,1499.9446064814813,MERGED,5,9,1,0,1,724,False,0,0,0,1413,14,72.53722222222223,Bug
TypeScript,2147,14722,1501.8925,MERGED,1,0,1,0,1,47,False,0,0,0,696,1,0.7477777777777778,Bug
TypeScript,2147,14722,1502.1400347222223,MERGED,21,215,5,0,1,728,False,0,0,0,2383,236,13.956388888888888,Document
TypeScript,2147,14722,1499.0639583333334,MERGED,0,6,1,0,1,176,False,0,0,0,680,6,169.8486111111111,Bug
TypeScript,2147,14722,1501.9200231481482,MERGED,1,1,1,1,1,2,False,1,0,0,604,2,19.325833333333332,Bug
Go,30,295,375.9097337962963,MERGED,0,10,1,1,1,103,True,0,1,1,1307,10,0.1272222222222222,Feature
Go,30,295,375.88743055555557,MERGED,0,40,2,1,2,102,True,0,1,1,1584,40,0.12333333333333334,Bug
TypeScript,12,11,1017.2668402777778,MERGED,7,2,2,0,3,107,False,0,0,0,1038,9,124.23944444444444,Bug
,0,1,46.08166666666667,CLOSED,0,142,1,0,1,0,False,0,0,0,735,142,0.011666666666666667,Feature
TypeScript,12,11,1017.5280439814815,MERGED,12,18,1,0,1,162,False,0,0,0,1079,30,17.217777777777776,Feature
PHP,1334,2960,4231.634247685185,MERGED,1,1,1,6,2,205,False,3,3,2,728,2,317.9505555555556,Bug
TypeScript,85,723,344.0538773148148,MERGED,0,7,2,0,3,104,False,0,0,0,1122,7,51.07138888888889,Document
TypeScript,12,11,1017.2445717592592,MERGED,6,8,2,0,14,106,False,0,0,0,1141,14,217.1563888888889,Feature
TypeScript,261,3765,703.6908101851851,MERGED,279,291,18,0,2,611,True,0,0,0,931,570,0.6438888888888888,Document
TypeScript,12,11,1016.3111689814815,MERGED,8,8,1,0,1,151,False,0,0,0,895,16,2.2622222222222224,Feature
TypeScript,12,11,1015.486724537037,MERGED,1,1,1,0,1,149,False,0,0,0,795,2,16.245277777777776,Feature
V,2097,34361,1575.8581828703702,CLOSED,3,4,1,2,1,211,True,0,2,2,312,7,288.2238888888889,Bug
Go,421,1654,1538.128287037037,MERGED,11,11,1,0,1,66,False,0,0,0,842,22,114.57944444444445,Bug
PHP,1334,2960,4234.911284722222,CLOSED,1,2,2,1,1,872,False,0,1,1,1074,3,172.88722222222222,Feature
Go,30,295,376.9406597222223,MERGED,4,102,3,0,2,104,True,0,0,0,2385,106,0.1425,Bug
JavaScript,5139,7050,1233.5522337962964,MERGED,2,2,2,1,2,266,False,0,1,1,688,4,0.16277777777777777,Feature
TypeScript,178,1359,347.2774537037037,MERGED,1,1,1,1,1,10,False,0,1,1,1062,2,14.67361111111111,Bug
TypeScript,2147,14722,1502.2473032407406,MERGED,171,625,14,0,21,48,False,0,0,0,1762,796,87.3338888888889,Feature
Go,421,1654,1538.9134375,MERGED,0,13,1,0,1,0,False,0,0,0,1001,13,26.510555555555555,Document
Vue,10806,21162,1051.0613541666667,MERGED,21,22,1,2,1,2,False,1,1,1,1215,43,378.06388888888887,Document
TypeScript,12,11,1018.296724537037,MERGED,2,3,1,0,2,109,False,0,0,0,1346,5,21.442777777777778,Feature
Vue,10806,21162,1051.8018981481482,MERGED,1,1,1,1,2,7,False,0,1,1,1223,2,341.83,Document
C++,2234,23696,2384.665497685185,MERGED,0,1,1,1,1,210,False,0,1,1,513,1,9.78138888888889,Feature
TypeScript,261,3765,705.9221643518518,MERGED,2,2,1,0,1,926,True,0,0,0,1458,4,0.34805555555555556,Document
TypeScript,2147,14722,1501.897476851852,MERGED,1,111,5,1,3,1,False,1,0,0,3390,112,526.3905555555556,Document
TypeScript,12,11,1017.3420023148147,MERGED,9,10,2,0,2,160,False,0,0,0,1808,19,45.785833333333336,Feature
TypeScript,261,3765,705.8458217592593,MERGED,1,1,1,0,1,39,False,0,0,0,1053,2,0.3761111111111111,Document
TypeScript,12,11,1018.1800925925926,MERGED,3,3,1,0,1,108,False,0,0,0,1361,6,3.2930555555555556,Feature
TypeScript,12,11,1018.2389699074074,MERGED,1,3,1,0,4,378,False,0,0,0,1729,4,0.24916666666666668,Bug
TypeScript,261,3765,705.6743518518518,MERGED,0,12,2,0,1,184,False,0,0,0,1416,12,0.025833333333333333,Document
TypeScript,12,11,1016.5353125,MERGED,7,31,2,0,3,156,False,0,0,0,1797,38,64.46583333333334,Feature
TypeScript,12,11,1016.4920833333334,MERGED,7,15,2,0,5,155,False,0,0,0,1363,22,65.50027777777778,Feature
C++,2234,23696,2385.6566550925927,MERGED,0,1,1,1,1,2,False,0,1,1,586,1,1.2844444444444445,Bug
TypeScript,261,3765,704.7857291666666,MERGED,3,25,4,0,1,38,False,0,0,0,1111,28,20.80527777777778,Document
PHP,1334,2960,4233.957326388889,MERGED,2,2,1,5,1,13,False,2,3,3,1663,4,219.00555555555556,Document
TypeScript,2147,14722,1502.0927199074074,MERGED,0,17,2,0,1,303,False,0,0,0,1293,17,3.3097222222222222,Bug
TypeScript,12,11,1016.4148726851853,MERGED,3,4,1,0,1,153,False,0,0,0,1515,7,1.2019444444444445,Feature
TypeScript,261,3765,703.8583449074075,MERGED,4,55,7,0,13,67,False,0,0,0,1596,59,46.653333333333336,Document
TypeScript,85,723,344.90694444444443,MERGED,16,5893,5,0,2,105,False,0,0,0,1389,5909,1.33,Document
TypeScript,261,3765,704.7272800925925,MERGED,195,7,3,0,5,213,False,0,0,0,1628,202,0.5336111111111111,Document
TypeScript,2147,14722,1501.2544675925926,MERGED,5,11,1,0,1,300,False,0,0,0,1129,16,35.32277777777778,Feature
JavaScript,8844,63474,4104.494085648148,CLOSED,9,37,10,11,1,0,False,4,7,3,827,46,0.1802777777777778,Feature
Java,450,746,4100.234282407408,MERGED,267,2148,28,2,43,418,False,0,2,2,1128,2415,576.2263888888889,Document
TypeScript,261,3765,704.5185416666667,MERGED,0,1,1,0,2,613,True,0,0,0,1182,1,0.3825,Document
Rust,264,5383,432.13086805555554,MERGED,75,356,22,1,7,439,False,0,1,1,736,431,142.2538888888889,Feature
TypeScript,12,11,1016.5436111111111,MERGED,19,21,1,0,2,157,False,0,0,0,1674,40,16.761944444444445,Feature
TypeScript,12,11,1016.4626504629629,MERGED,2,17,3,0,5,154,False,0,0,0,1384,19,18.576944444444443,Feature
TypeScript,7,6,673.1592129629629,CLOSED,0,36,3,1,1,276,False,1,0,0,1542,36,452.9197222222222,Feature
C++,2234,23696,2385.6779745370372,MERGED,2,3,3,2,5,3,False,1,1,1,727,5,5.780833333333334,Feature
TypeScript,2147,14722,1501.297152777778,MERGED,18,139,10,0,1,302,False,0,0,0,1411,157,16.857222222222223,Bug
Rust,264,5383,431.00487268518515,MERGED,0,0,1,0,1,436,False,0,0,0,690,0,0.016944444444444446,Bug
,0,1,46.7496875,CLOSED,0,114,1,0,1,1,False,0,0,0,2198,114,20.155,Feature
TypeScript,261,3765,703.9423263888889,MERGED,2,14,2,0,2,210,False,0,0,0,1217,16,13.048055555555555,Document
TypeScript,178,1359,349.3121064814815,MERGED,4,6,3,1,1,13,True,0,1,1,1555,10,8.100555555555555,Feature
TypeScript,261,3765,703.8589583333334,MERGED,0,4,2,0,1,1,True,0,0,0,1331,4,0.2611111111111111,Document
Python,547,7160,2261.7312037037036,MERGED,0,375,8,1,86,29,False,0,1,1,1659,375,978.3211111111111,Bug
TypeScript,261,3765,703.6358564814815,MERGED,0,13,2,0,1,209,False,0,0,0,1609,13,0.725,Document
C++,2234,23696,2384.821111111111,MERGED,0,2,2,1,1,1,False,0,1,1,774,2,4.775833333333333,Feature
TypeScript,261,3765,703.5102314814816,MERGED,15,10,2,0,1,914,True,0,0,0,1462,25,0.09166666666666666,Document
Go,395,660,1294.1828703703704,CLOSED,17,19,1,0,1,339,False,0,0,0,263,36,452.8186111111111,Bug
TypeScript,12,11,1015.1359375000001,MERGED,2,12,2,0,1,48,False,0,0,0,1359,14,24.190555555555555,Feature
C++,2234,23696,2384.0116087962965,MERGED,0,16,2,1,1,555,False,0,1,1,625,16,15.57611111111111,Bug
TypeScript,85,723,342.1821296296296,MERGED,14,62,12,0,3,102,False,0,0,0,1762,76,23.476388888888888,Document
TypeScript,261,3765,702.8573495370371,MERGED,14,17,5,0,1,912,True,0,0,0,1705,31,0.6097222222222223,Document
TypeScript,261,3765,702.7582986111111,MERGED,0,504,25,0,7,910,True,0,0,0,1438,504,1.656388888888889,Document
Rust,264,5383,432.98085648148145,MERGED,4,1,1,3,2,17,False,0,3,3,809,5,0.7108333333333333,Bug
TypeScript,261,3765,702.7334606481481,MERGED,18,26,5,0,1,108,False,0,0,0,1614,44,0.255,Document
TypeScript,261,3765,702.6029513888889,MERGED,1,1,1,0,1,27,True,0,0,0,1068,2,0.21916666666666668,Document
JavaScript,5139,7050,1232.7147106481482,MERGED,20,277,11,5,8,265,False,2,3,2,2721,297,643.9227777777778,Bug
TypeScript,85,723,342.0328587962963,MERGED,27,14,3,0,5,101,False,0,0,0,1935,41,0.051666666666666666,Document
TypeScript,85,723,342.0014814814815,MERGED,7,61,3,0,3,100,False,0,0,0,1645,68,0.3641666666666667,Document
TypeScript,85,723,341.97290509259255,MERGED,2,2,1,0,1,100,False,0,0,0,1444,4,1.3841666666666668,Document
TypeScript,261,3765,701.9730324074075,MERGED,1,6,2,3,1,0,False,1,2,1,1414,7,11.850555555555555,Document
TypeScript,2147,14723,1498.9405787037037,MERGED,25,31,1,0,1,723,False,0,0,0,1247,56,0.11055555555555556,Feature
Python,547,7160,2265.688020833333,MERGED,0,4,4,0,2,32,False,0,0,0,815,4,0.4761111111111111,Bug
Python,547,7160,2264.815300925926,MERGED,0,20,2,1,6,291,True,1,0,0,1349,20,4.978055555555556,Bug
Go,54,353,762.8230787037037,MERGED,0,1,1,0,1,43,True,0,0,0,790,1,0.31055555555555553,Bug
Python,547,7160,2265.4573379629633,MERGED,735,3,26,0,1,292,True,0,0,0,759,738,0.016944444444444446,Bug
Java,450,746,4100.2074999999995,MERGED,1,4,1,1,2,33,False,0,1,1,664,5,1.7058333333333333,Bug
TypeScript,2147,14723,1502.0947685185185,MERGED,5,6,5,0,1,85,False,0,0,0,1888,11,15.123888888888889,Bug
Python,19249,70258,2487.5350231481484,CLOSED,11,50,2,8,18,245,False,8,0,0,733,61,79.27777777777777,Feature
C++,2234,23696,2386.853923611111,MERGED,2,8,2,5,2,4,False,4,1,1,1565,10,308.21555555555557,Feature
Python,547,7160,2264.9813541666667,MERGED,1,1,1,0,2,31,False,0,0,0,727,2,10.839444444444444,Bug
TypeScript,261,3765,705.7593518518519,CLOSED,0,30,4,1,1,923,True,1,0,0,1778,30,0.5475,Document
V,2097,34361,1579.3819907407408,MERGED,0,24,2,0,2,216,True,0,0,0,709,24,4.841944444444445,Bug
Go,395,660,1293.022939814815,MERGED,3,15,1,0,1,338,False,0,0,0,171,18,24.56361111111111,Feature
TypeScript,202,107,1173.065625,MERGED,1,1,1,3,4,230,True,0,3,3,1199,2,113.59694444444445,Document
TypeScript,261,3765,705.4854050925925,MERGED,6,6,6,0,1,921,True,0,0,0,2170,12,0.37555555555555553,Document
Python,547,7160,2264.751053240741,MERGED,1,1,1,0,1,234,False,0,0,0,664,2,0.16583333333333333,Bug
Rust,264,5383,430.97140046296295,MERGED,1,8,2,0,3,249,True,0,0,0,1166,9,0.22777777777777777,Feature
Go,421,1654,1538.223888888889,MERGED,2,2,1,0,1,605,False,0,0,0,1151,4,1.7077777777777778,Bug
Rust,264,5383,430.7757060185185,MERGED,0,10,1,0,1,435,False,0,0,0,745,10,0.0925,Feature
JavaScript,5139,7050,1230.886898148148,MERGED,2,18,3,1,2,105,False,0,1,1,420,20,0.1322222222222222,Feature
Rust,264,5383,430.7648148148148,MERGED,0,114,1,0,1,434,False,0,0,0,1017,114,0.03944444444444444,Bug
TypeScript,261,3765,704.7509722222222,MERGED,10059,11982,4,0,4,616,True,0,0,0,1910,22041,0.9022222222222223,Document
TypeScript,261,3765,704.5278819444444,MERGED,10,20,4,0,2,917,True,0,0,0,1844,30,0.26305555555555554,Document
TypeScript,12,11,1016.4085532407407,MERGED,7,8,1,0,1,152,False,0,0,0,2060,15,1.3586111111111112,Feature
Vue,293,495,858.0626041666666,MERGED,3,7,1,11,3,385,False,3,8,5,922,10,44.08888888888889,Bug
TypeScript,12,11,1014.304675925926,MERGED,9,13,4,0,2,39,False,0,0,0,2703,22,96.55472222222222,Feature
Rust,264,5383,429.78898148148147,MERGED,14,6,1,0,1,148,False,0,0,0,983,20,1.183888888888889,Feature
TypeScript,2147,14723,1502.2510069444445,MERGED,3,15,6,0,3,729,False,0,0,0,4307,18,17.168333333333333,Bug
TypeScript,85,723,344.16349537037036,MERGED,5,5879,6,0,4,104,False,0,0,0,3037,5884,241.03916666666666,Document
TypeScript,261,3765,703.7746180555555,MERGED,15,22,2,0,2,179,False,0,0,0,1896,37,0.21416666666666667,Document
C++,2234,23696,2384.024490740741,MERGED,2,20,3,1,1,556,False,0,1,1,938,22,18.303055555555556,Feature
C++,2234,23696,2383.9581597222223,MERGED,1,16,3,1,1,325,False,0,1,1,1005,17,19.269166666666667,Bug
JavaScript,8844,63474,4105.625127314815,MERGED,74,384,19,8,14,115,True,4,4,2,1494,458,183.43444444444444,Bug
TypeScript,261,3765,703.4920023148148,MERGED,1,9,2,0,1,913,True,0,0,0,1934,10,0.20833333333333334,Document
Python,547,7160,2266.6222685185185,MERGED,29,120,3,1,4,296,True,1,0,0,886,149,3.022777777777778,Bug
Java,450,746,4101.247465277777,MERGED,51,100,6,1,7,376,False,0,1,1,421,151,333.9372222222222,Feature
TypeScript,85,723,342.355,MERGED,4,124,3,0,3,103,False,0,0,0,2242,128,0.6822222222222222,Document
Vue,293,495,857.166412037037,MERGED,13,47,4,8,3,64,False,0,8,4,1189,60,16.069166666666668,Bug
Vue,293,495,854.9660300925925,MERGED,167,196,10,32,24,63,False,9,23,8,1512,363,431.6355555555556,Bug
JavaScript,8844,63474,4106.226863425926,MERGED,8,450,55,4,29,6,True,1,3,2,1492,458,167.6497222222222,Feature
Vue,10806,21162,1049.8229282407408,MERGED,1,1,1,1,1,12,False,0,1,1,1246,2,79.38444444444444,Bug
TypeScript,261,3765,702.761388888889,MERGED,1,9,2,0,1,208,False,0,0,0,2126,10,0.22416666666666665,Document
Vue,293,495,856.7594560185184,MERGED,96,1127,8,4,2,171,True,1,3,3,970,1223,21.779722222222222,Bug
TypeScript,41368,87413,2966.1958449074077,MERGED,0,1,1,0,2,0,False,0,0,0,1097,1,38.041666666666664,Bug
Python,547,7160,2265.6405555555557,MERGED,19,11,2,0,2,295,True,0,0,0,783,30,0.025277777777777777,Bug
Python,547,7160,2265.4777314814814,MERGED,5,7,1,1,6,293,True,0,1,1,816,12,0.5886111111111111,Bug
TypeScript,12,11,1015.1718055555556,MERGED,44,260,5,1,17,41,False,1,0,0,2861,304,192.65333333333334,Bug
JavaScript,5139,7050,1230.812314814815,MERGED,4,10,1,1,3,12,False,0,1,1,1376,14,1.5072222222222222,Feature
Go,54,353,760.0217361111112,MERGED,5,7,1,1,1,41,True,0,1,1,974,12,0.3622222222222222,Feature
Rust,264,5383,432.9508796296296,CLOSED,5,20,3,0,1,440,False,0,0,0,1653,25,72.75111111111111,Bug
Python,547,7160,2264.624664351852,CLOSED,31,22,1,1,1,290,True,1,0,0,862,53,3.8925,Bug
JavaScript,5139,7050,1230.8807175925926,CLOSED,1,16,2,1,2,104,False,0,1,1,1811,17,0.28194444444444444,Feature
Python,547,7160,2264.5582986111112,MERGED,11,11,6,1,1,289,True,1,0,0,878,22,0.18305555555555555,Bug
Vue,293,495,857.9670717592593,MERGED,635,173,13,6,11,172,True,1,5,5,1212,808,215.7513888888889,Bug
Go,395,660,1292.9374074074074,MERGED,16,7,1,0,2,103,False,0,0,0,200,23,29.42861111111111,Feature
Go,395,660,1294.2033217592593,CLOSED,61,20,3,0,1,340,False,0,0,0,395,81,137.6038888888889,Feature
TypeScript,261,3765,704.6908333333334,MERGED,12,23,3,0,3,615,True,0,0,0,2967,35,118.12694444444445,Document
Rust,264,5383,433.0946412037037,CLOSED,12,11,4,1,1,273,True,1,0,0,1694,23,0.4072222222222222,Bug
TypeScript,12,11,1017.3966898148147,MERGED,17,22,3,0,2,161,False,0,0,0,2961,39,44.49138888888889,Bug
TypeScript,202,107,1171.8663425925927,CLOSED,29,14,1,3,1,0,False,0,3,3,1607,43,242.68333333333334,Document
TypeScript,15,34,516.7609606481482,CLOSED,1,1,1,0,1,974,False,0,0,0,271,2,7.273611111111111,Feature
JavaScript,9664,43889,3685.2005787037037,CLOSED,8,8,1,3,1,1,False,0,3,2,695,16,839.7488888888889,Feature
TypeScript,1297,21107,444.8492708333333,CLOSED,8,4,1,2,1,0,False,0,2,2,1647,12,136.175,Document
Python,137,75,714.3422106481481,MERGED,0,174,5,0,21,5,False,0,0,0,2061,174,1463.8041666666666,Bug
V,2097,34361,1577.6614583333333,MERGED,1,5,2,0,1,214,True,0,0,0,916,6,5.0616666666666665,Bug
Go,395,660,1293.9952777777778,MERGED,1,1,1,0,1,12,False,0,0,0,225,2,119.32222222222222,Feature
Python,19249,70258,2490.2914814814817,CLOSED,8,0,3,2,1,113,False,2,0,0,589,8,328.2711111111111,Feature
V,2097,34361,1576.9340393518517,MERGED,1,19,2,3,2,213,True,0,3,2,936,20,36.39361111111111,Bug
TypeScript,85,723,344.9553125,MERGED,4,4,4,0,1,106,False,0,0,0,1665,8,0.16694444444444445,Document
TypeScript,0,0,180.073125,MERGED,1,40,1,0,1,6,False,0,0,0,183,41,0.07444444444444444,Document
TypeScript,261,3765,705.868287037037,MERGED,3,21,2,0,2,262,True,0,0,0,2431,24,16.924166666666668,Document
Rust,264,5383,432.1579976851852,MERGED,63,72,6,0,2,272,True,0,0,0,1341,135,16.204166666666666,Bug
V,2097,34361,1575.8480092592592,MERGED,1,14,3,1,1,210,True,0,1,1,921,15,12.103055555555555,Bug
Go,421,1654,1535.9363194444443,MERGED,0,15,3,0,1,451,True,0,0,0,2032,15,47.67888888888889,Bug
TypeScript,2147,14723,1502.0450462962963,MERGED,4,11,3,0,1,84,False,0,0,0,3505,15,0.31972222222222224,Feature
TypeScript,261,3765,705.8704976851851,MERGED,4,14,3,0,2,216,False,0,0,0,2345,18,0.6544444444444445,Document
TypeScript,261,3765,705.8405787037037,MERGED,2,44,3,0,1,110,False,0,0,0,2318,46,0.23444444444444446,Document
TypeScript,261,3765,705.7871759259259,MERGED,18,23,5,0,1,924,True,0,0,0,2310,41,0.3655555555555556,Document
Rust,264,5383,432.0096412037037,MERGED,3,26,2,2,1,251,True,1,1,1,1642,29,2.0027777777777778,Feature
Python,137,75,711.9894097222223,MERGED,0,117,5,0,21,4,False,0,0,0,2050,117,1520.7094444444444,Document
Rust,264,5383,431.91877314814815,MERGED,3,3,1,0,1,438,False,0,0,0,1360,6,0.5288888888888889,Bug
TypeScript,41368,87413,2965.475613425926,MERGED,13,583,10,17,14,18,True,6,11,4,2619,596,839.2130555555556,Document
TypeScript,202,107,1171.8374884259258,CLOSED,1,1,1,3,12,3,False,0,3,3,267,2,207.28083333333333,Bug
TypeScript,58,78,848.1008564814815,MERGED,2,13,2,1,1,203,True,0,1,1,1563,15,2.368611111111111,Feature
Go,395,660,1292.0676041666668,MERGED,2,3,1,0,3,10,False,0,0,0,221,5,164.2536111111111,Bug
TypeScript,202,107,1173.0867824074073,MERGED,2,2,1,3,2,233,True,0,3,3,1390,4,112.75888888888889,Document
TypeScript,202,107,1173.0782407407407,MERGED,20,10,1,3,2,232,True,0,3,3,1757,30,112.97722222222222,Document
TypeScript,202,107,1173.070162037037,MERGED,3,3,1,3,2,231,True,0,3,3,1592,6,113.17833333333333,Document
TypeScript,202,107,1173.0353009259259,MERGED,15,14,1,3,4,228,True,0,3,3,1992,29,114.33777777777777,Document
TypeScript,202,107,1173.0284143518518,MERGED,45,25,1,3,1,227,True,0,3,3,1560,70,114.5125,Document
TypeScript,261,3765,704.8138425925927,MERGED,1,25,5,0,4,617,True,0,0,0,2783,26,15.662222222222223,Document
PHP,1334,2960,4233.970335648149,CLOSED,2,2,1,2,1,0,False,0,2,2,1804,4,0.3413888888888889,Document
JavaScript,5139,7050,1231.8086689814816,MERGED,97,107,10,1,10,298,False,0,1,1,2572,204,24.100277777777777,Document
TypeScript,261,3765,704.7625578703704,MERGED,2,9,2,0,8,214,False,0,0,0,2383,11,0.3327777777777778,Document
TypeScript,261,3765,704.7195601851853,MERGED,456,87,16,0,9,181,False,0,0,0,2976,543,2.1886111111111113,Document
Rust,264,5383,430.0714004629629,MERGED,228,820,28,0,9,170,False,0,0,0,1601,1048,65.26027777777777,Feature
TypeScript,15,34,518.4366087962964,MERGED,3,198,3,0,4,486,True,0,0,0,246,201,30.43138888888889,Feature
Vue,10806,21162,1047.4672106481482,CLOSED,4,3,2,2,2,1,False,1,1,1,1602,7,280.28777777777776,Bug
TypeScript,178,1359,348.90517361111114,MERGED,81,33,3,2,1,42,True,0,2,2,3053,114,4.808888888888889,Bug
TypeScript,58,78,847.3317245370371,MERGED,2,9,2,1,2,202,True,0,1,1,258,11,20.80388888888889,Feature
TypeScript,41369,87413,2965.6373148148145,CLOSED,1,6,2,1,2,1921,True,0,1,1,2101,7,224.27083333333334,Document
TypeScript,12,11,1015.5124421296296,MERGED,32,30,6,0,5,150,False,0,0,0,2742,62,18.32611111111111,Feature
C++,2234,23696,2383.8742361111113,MERGED,0,18,3,1,6,36,False,0,1,1,1538,18,73.92222222222222,Document
Rust,264,5383,430.9997685185185,MERGED,4,13,3,0,1,250,True,0,0,0,1761,17,0.049166666666666664,Feature
Go,395,660,1293.2055324074074,MERGED,23,51,2,0,1,64,False,0,0,0,344,74,208.81944444444446,Feature
Rust,264,5383,430.76138888888886,MERGED,20,43,5,0,1,268,True,0,0,0,1840,63,0.79,Bug
TypeScript,15,34,518.166111111111,MERGED,1329,4760,2,0,2,980,False,0,0,0,217,6089,7.075833333333334,Bug
TypeScript,261,3765,703.8432060185186,CLOSED,19,57,2,0,1,0,True,0,0,0,3004,76,0.38333333333333336,Document
TypeScript,15,34,519.3857523148148,MERGED,7,18,1,0,1,487,True,0,0,0,246,25,101.7325,Feature
Go,395,660,1294.1673148148147,MERGED,2,33,5,1,5,14,False,0,1,1,324,35,143.00416666666666,Feature
C++,2234,23696,2384.665625,MERGED,54,0,9,1,1,211,False,0,1,1,1540,54,7.758611111111111,Feature
Go,395,660,1294.0584490740741,MERGED,1,1,1,0,1,13,False,0,0,0,274,2,140.68138888888888,Feature
Go,395,660,1292.0018634259259,MERGED,24,20,5,0,2,62,False,0,0,0,406,44,238.6925,Bug
Go,1835,11245,1754.6677662037036,CLOSED,39,21,4,3,5,11,False,2,1,1,1373,60,51.551944444444445,Feature
Vue,10806,21162,1051.9415509259259,MERGED,1,4,2,0,1,196,True,0,0,0,1826,5,8.330555555555556,Document
TypeScript,2071,16640,1271.9003240740742,MERGED,2,2,1,0,3,0,False,0,0,0,2494,4,485.3230555555556,Bug
TypeScript,12,11,1016.2350810185185,MERGED,69,3072,11,1,19,49,False,1,0,0,3533,3141,360.1016666666667,Feature
Rust,264,5383,429.8977777777778,MERGED,1,11,3,0,1,70,False,0,0,0,1611,12,1.696388888888889,Feature
TypeScript,2071,16640,1271.7872453703703,MERGED,1,1,1,0,2,0,False,0,0,0,2563,2,488.07694444444445,Bug
Go,395,660,1292.004097222222,MERGED,0,16,1,0,3,9,False,0,0,0,263,16,48.05888888888889,Feature
Python,19249,70258,2488.053275462963,CLOSED,2,4,1,3,2,1606,False,3,0,0,285,6,13.403888888888888,Feature
Vue,10806,21162,1051.1075347222222,MERGED,12,12,1,1,1,0,False,0,1,1,1675,24,28.5875,Bug
Go,54,353,761.0542013888889,MERGED,1,118,2,0,2,75,True,0,0,0,1567,119,21.275833333333335,Feature
JavaScript,9664,43889,3686.168657407407,CLOSED,0,52,3,0,1,192,True,0,0,0,363,52,2.254722222222222,Feature
V,2097,34361,1580.5580092592593,MERGED,0,1,1,0,1,0,False,0,0,0,1410,1,6.550277777777778,Document
Vue,293,495,857.8740740740741,MERGED,13,35,4,3,8,313,True,0,3,2,1077,48,2.511111111111111,Bug
JavaScript,9664,43889,3686.0530902777778,CLOSED,2,2,2,0,1,251,True,0,0,0,361,4,0.2627777777777778,Bug
Python,137,75,712.145636574074,MERGED,9,136,12,0,31,2,False,0,0,0,2354,145,1397.1872222222223,Document
JavaScript,9664,43889,3685.853622685185,CLOSED,3,6,3,0,1,250,True,0,0,0,282,9,4.938888888888889,Bug
TypeScript,15,34,516.6815393518518,MERGED,2,20,4,0,2,973,False,0,0,0,194,22,1.7097222222222221,Feature
TypeScript,15,34,516.5582523148148,MERGED,5,15,1,0,3,971,False,0,0,0,218,20,5.054166666666666,Document
Rust,264,5383,427.9760185185185,CLOSED,4,0,1,2,1,10,False,1,1,1,1095,4,44.47472222222222,Document
Go,395,660,1294.0504282407408,MERGED,24,65,6,0,1,104,False,0,0,0,508,89,2.7419444444444445,Bug
Vue,293,495,856.9146875,MERGED,17,89,8,3,8,312,True,0,3,2,1325,106,0.13583333333333333,Bug
Go,1835,11245,1755.5825694444445,MERGED,0,3,1,0,1,113,False,0,0,0,225,3,0.2980555555555556,Feature
TypeScript,1297,21107,442.64650462962965,CLOSED,2,0,2,1,1,1019,True,0,1,1,1487,2,0.10027777777777777,Document
TypeScript,3706,54074,1386.8986574074072,CLOSED,11,52,3,1,1,173,True,1,0,0,2040,63,1341.0391666666667,Feature
Go,54,353,759.9798611111111,MERGED,4,14,2,0,1,40,True,0,0,0,1447,18,0.5030555555555556,Bug
TypeScript,307,2556,566.6617824074074,MERGED,0,1,1,0,1,1,False,0,0,0,983,1,1.7027777777777777,Bug
Java,450,746,4100.242152777778,MERGED,158,38,2,1,3,153,False,0,1,1,1156,196,0.8838888888888888,Bug
TypeScript,307,2556,566.6447569444445,MERGED,0,3,1,0,1,573,True,0,0,0,1093,3,2.0972222222222223,Feature
TypeScript,307,2556,566.6361226851851,MERGED,1,2,2,0,1,572,True,0,0,0,1164,3,2.3369444444444443,Feature
TypeScript,202,107,1169.536087962963,MERGED,1,1,1,5,3,2,False,0,5,4,1220,2,77.20194444444445,Document
Rust,264,5383,433.1441550925926,MERGED,3,38,3,2,3,0,False,1,1,1,1973,41,2.857222222222222,Document
Rust,264,5383,433.11899305555556,MERGED,3,45,5,0,3,0,False,0,0,0,1960,48,1.7341666666666666,Bug
TypeScript,85,723,345.0083680555556,MERGED,3,4,1,0,3,3,False,0,0,0,655,7,101.02444444444444,Feature
Rust,264,5383,433.0436574074074,MERGED,1,31,2,0,3,171,False,0,0,0,1765,32,2.9669444444444446,Feature
Go,54,353,759.6349537037037,MERGED,2,11,1,0,1,39,True,0,0,0,1308,13,0.5033333333333333,Feature
C++,2234,23696,2387.0412384259257,MERGED,0,11,3,1,1,328,False,0,1,1,2114,11,18.31222222222222,Feature
Go,54,353,759.6815856481481,MERGED,11,17,2,0,2,222,True,0,0,0,2639,28,4.154166666666667,Document
Rust,264,5383,432.1188773148148,MERGED,9,82,11,3,3,2,False,2,1,1,5550,91,144.63333333333333,Feature
TypeScript,42,46,796.6737499999999,MERGED,132,144,13,1,13,145,False,0,1,1,331,276,51.80361111111111,Feature
TypeScript,307,2556,565.6433912037037,MERGED,3,9,1,0,1,304,True,0,0,0,1001,12,23.064722222222223,Bug
TypeScript,1297,21107,441.69653935185187,MERGED,6,9,2,1,1,1014,True,0,1,1,1692,15,0.005833333333333334,Document
Python,19249,70258,2488.283113425926,CLOSED,30,15,4,1,3,267,False,0,1,1,398,45,33.3375,Document
TypeScript,202,107,1173.0612152777778,MERGED,21,18,1,4,4,229,True,0,4,3,2522,39,135.085,Document
V,2097,34361,1577.6889583333334,MERGED,1,37,3,0,1,215,True,0,0,0,1427,38,18.29361111111111,Bug
TypeScript,15,34,517.1173032407407,MERGED,559,425,45,0,12,977,False,0,0,0,335,984,24.968333333333334,Feature
JavaScript,9664,43889,3686.0649189814812,CLOSED,0,1,1,0,1,252,True,0,0,0,471,1,0.3347222222222222,Bug
Python,137,75,713.2657407407409,MERGED,0,309,14,0,16,22,False,0,0,0,1624,309,885.4891666666666,Document
Go,395,660,1292.1535069444444,MERGED,15,28,1,0,1,11,False,0,0,0,262,43,42.001666666666665,Feature
JavaScript,9664,43889,3686.2634143518517,MERGED,1,144,8,1,6,193,True,1,0,0,560,145,162.83,Feature
TypeScript,17,33,747.7812152777778,MERGED,40,18,5,1,1,46,False,0,1,1,425,58,1.9425,Feature
JavaScript,8844,63474,4104.726932870371,MERGED,4,76,11,1,8,0,False,0,1,1,1893,80,35.435833333333335,Feature
Rust,433,2229,260.3761689814815,MERGED,16,41,8,1,2,893,False,0,1,1,404,57,43.2425,Feature
TypeScript,2147,14723,1501.2506944444447,MERGED,60,738,14,0,1,299,False,0,0,0,6570,798,827.6616666666666,Document
Go,421,1654,1535.9498726851853,MERGED,12,18,1,0,1,92,False,0,0,0,2582,30,2.575277777777778,Document
Go,395,660,1292.1606597222224,MERGED,3,34,2,0,4,102,False,0,0,0,278,37,18.669444444444444,Feature
Go,395,660,1291.938263888889,MERGED,10,14,4,0,1,61,False,0,0,0,391,24,27.875,Feature
JavaScript,9664,43889,3685.846678240741,MERGED,0,189,3,3,5,0,False,1,2,1,516,189,170.92222222222222,Feature
JavaScript,5139,7050,1230.6631018518517,MERGED,12,158,5,5,5,85,False,2,3,2,2626,170,92.82472222222222,Feature
Java,450,746,4101.071215277778,MERGED,18,104,12,1,12,6,False,0,1,1,642,122,4.167222222222223,Feature
Java,450,746,4101.048055555556,CLOSED,35,126,10,1,4,5,False,0,1,1,782,161,0.5333333333333333,Feature
Go,1835,11245,1756.6347800925926,MERGED,44,19,6,0,1,116,False,0,0,0,276,63,0.46555555555555556,Feature
Rust,264,5383,431.0450347222222,MERGED,25,66,12,0,1,71,False,0,0,0,1901,91,2.335277777777778,Feature
Go,1835,11245,1756.5998726851851,MERGED,3,20,2,0,1,115,False,0,0,0,281,23,0.31333333333333335,Feature
TypeScript,15,34,514.6789583333333,MERGED,0,125,1,1,1,328,False,1,0,0,412,125,213.77194444444444,Feature
JavaScript,9664,43889,3686.1364120370367,CLOSED,2,4,1,1,1,253,True,1,0,0,652,6,119.36888888888889,Bug
Go,30,295,374.31319444444443,MERGED,87,885,8,5,7,164,True,2,3,1,3642,972,65.57166666666667,Feature
Rust,264,5383,430.03078703703704,MERGED,82,45,4,0,3,248,True,0,0,0,2183,127,1.7391666666666667,Feature
Erlang,2054,12122,3825.121782407407,MERGED,22,123,4,3,3,166,False,1,2,1,823,145,1.9172222222222222,Document
TypeScript,12,11,1017.3340393518519,MERGED,18,27,3,0,2,159,False,0,0,0,3856,45,45.98027777777778,Feature
TypeScript,2147,14723,1502.1906712962964,MERGED,196,333,7,0,1,12,False,0,0,0,3285,529,18.551944444444445,Bug
TypeScript,17,33,746.9061342592591,MERGED,75,204,23,1,4,45,False,0,1,1,491,279,75.29555555555555,Feature
TypeScript,2147,14723,1502.1841782407407,CLOSED,198,333,7,0,1,11,False,0,0,0,4250,531,0.12916666666666668,Bug
TypeScript,178,1359,350.15819444444446,MERGED,48,49,2,1,1,23,True,0,1,1,4553,97,16.785833333333333,Bug
JavaScript,9664,43889,3682.878483796296,MERGED,5,5,1,2,3,1,False,1,1,1,375,10,27.618055555555557,Feature
Go,395,660,1293.0923148148147,MERGED,96,175,4,0,3,63,False,0,0,0,521,271,189.88833333333332,Bug
TypeScript,15,34,516.6901388888889,MERGED,97,1356,34,2,35,484,True,0,2,1,495,1453,28.5675,Feature
JavaScript,9664,43889,3684.917881944444,CLOSED,5,5,1,1,1,0,False,0,1,1,608,10,21.789444444444445,Feature
TypeScript,2147,14723,1501.2614814814815,MERGED,14,97,4,0,1,301,False,0,0,0,3929,111,18.5725,Feature
TypeScript,261,3765,705.8468055555555,MERGED,145,94,17,0,5,925,True,0,0,0,4211,239,16.2275,Document
JavaScript,9664,43889,3685.9694791666666,MERGED,29,144,7,2,2,317,True,1,1,1,579,173,51.797222222222224,Bug
TypeScript,1297,21107,443.0227893518518,MERGED,382,29,5,1,8,1021,True,0,1,1,2286,411,1.0697222222222222,Document
V,2097,34361,1579.8273958333332,MERGED,4,5,1,0,2,39,True,0,0,0,1642,9,0.20444444444444446,Document
TypeScript,15,34,516.6248958333333,MERGED,3,3,2,0,2,329,False,0,0,0,385,6,0.9719444444444445,Feature
TypeScript,41369,87413,2966.5000347222226,MERGED,17,0,1,0,1,1923,True,0,0,0,2075,17,0.41638888888888886,Document
TypeScript,261,3765,705.62875,MERGED,53,259,105,0,7,619,True,0,0,0,4623,312,5.347777777777778,Document
TypeScript,85,723,344.003912037037,MERGED,4,102,6,0,1,6,False,0,0,0,3936,106,0.3636111111111111,Document
TypeScript,261,3765,705.6068865740741,MERGED,134,55,12,0,5,922,True,0,0,0,3505,189,0.8452777777777778,Document
TypeScript,261,3765,705.4962615740741,MERGED,5,71,4,0,2,183,False,0,0,0,3183,76,0.30944444444444447,Document
TypeScript,261,3765,705.4863425925927,MERGED,135,29,13,0,2,182,False,0,0,0,4400,164,0.3491666666666667,Document
TypeScript,202,107,1173.6683680555554,MERGED,84,72,2,9,8,0,False,1,8,5,3023,156,260.4938888888889,Document
TypeScript,261,3765,704.8677314814814,MERGED,4,30,9,0,3,217,True,0,0,0,3621,34,24.268333333333334,Document
TypeScript,4,33,791.3614467592593,MERGED,0,3,2,3,1,621,True,2,1,1,645,3,1.4427777777777777,Bug
TypeScript,261,3765,704.7492708333333,MERGED,107,149,12,0,2,109,False,0,0,0,4227,256,21.653055555555557,Document
TypeScript,261,3765,704.752349537037,MERGED,1522,23,30,0,6,920,True,0,0,0,4238,1545,1.991111111111111,Document
TypeScript,261,3765,704.6563657407409,MERGED,10,22,2,0,3,211,False,0,0,0,4188,32,0.3561111111111111,Document
TypeScript,12,11,1015.2720370370371,MERGED,12,80,10,0,1,147,False,0,0,0,3700,92,21.407777777777778,Feature
TypeScript,261,3765,704.628912037037,MERGED,31,104,9,0,1,918,True,0,0,0,3527,135,0.4747222222222222,Document
TypeScript,41369,87413,2961.7416203703706,MERGED,9,16,3,1,7,22,False,0,1,1,2692,25,522.7533333333333,Document
TypeScript,41369,87413,2961.681504629629,MERGED,14,22,3,0,4,18,False,0,0,0,3146,36,524.33,Document
TypeScript,41369,87413,2961.6564814814815,MERGED,9,17,3,1,13,17,False,0,1,1,2981,26,525.0661111111111,Document
JavaScript,9664,43889,3684.9556828703703,MERGED,70,83,10,0,13,630,False,0,0,0,595,153,27.014444444444443,Feature
TypeScript,41369,87413,2961.731030092593,MERGED,3,2,1,0,3,21,False,0,0,0,2324,5,521.0766666666667,Document
TypeScript,41369,87413,2961.6860069444447,CLOSED,1,1,1,1,3,19,False,0,1,1,2163,2,522.4113888888888,Document
TypeScript,261,3765,703.6308101851852,MERGED,70,76,10,0,3,915,True,0,0,0,4417,146,0.1238888888888889,Document
TypeScript,261,3765,703.5759490740742,MERGED,5,31,4,0,2,261,True,0,0,0,3822,36,1.3219444444444444,Document
TypeScript,15,34,518.2566087962963,MERGED,78,204,6,0,3,136,False,0,0,0,537,282,9.633611111111112,Feature
TypeScript,41369,87413,2966.3841203703705,MERGED,5,2,1,9,2,22,False,3,6,2,2299,7,269.76472222222225,Document
Go,421,1654,1538.943101851852,MERGED,22,25,2,0,2,95,False,0,0,0,3816,47,23.77722222222222,Document
TypeScript,261,3765,702.9116782407408,MERGED,7,29,3,0,1,106,True,0,0,0,3332,36,16.236666666666668,Document
TypeScript,15,34,518.0643518518518,MERGED,30,18,5,0,2,979,False,0,0,0,542,48,1.7372222222222222,Feature
Go,421,1654,1539.182037037037,MERGED,20,31,1,0,2,453,True,0,0,0,4152,51,2.9633333333333334,Bug
Rust,264,5383,433.0641898148148,MERGED,1,46,7,0,1,19,False,0,0,0,3098,47,0.6147222222222222,Bug
TypeScript,41369,87413,2963.688969907407,CLOSED,0,1,1,1,1,0,False,0,1,1,2095,1,0.10138888888888889,Document
TypeScript,41369,87413,2964.8322337962964,MERGED,45,1002,11,1,13,17,True,0,1,1,3200,1047,311.8975,Document
TypeScript,261,3765,702.8475694444445,MERGED,18,23,11,0,1,911,True,0,0,0,3487,41,0.8491666666666666,Document
TypeScript,41369,87413,2963.4708449074074,MERGED,1,1,1,0,1,2,False,0,0,0,1759,2,1.5902777777777777,Document
TypeScript,41369,87413,2963.436875,MERGED,3,4,2,0,8,1920,True,0,0,0,2068,7,2.953888888888889,Document
C#,80,125,846.4799768518519,MERGED,4,3,1,0,1,182,False,0,0,0,686,7,0.8902777777777777,Document
TypeScript,15,34,517.4585069444445,MERGED,45,520,23,0,8,330,False,0,0,0,548,565,2.921111111111111,Bug
TypeScript,15,34,517.0907060185185,MERGED,208,359,24,0,4,976,False,0,0,0,583,567,10.788333333333334,Feature
TypeScript,2071,16640,1271.4709027777778,MERGED,1,13,2,0,2,0,False,0,0,0,2699,14,1.065,Document
Go,421,1654,1537.9836342592591,CLOSED,1,359,8,2,2,93,False,1,1,1,4386,360,13.011111111111111,Document
Go,54,353,759.9578703703704,MERGED,16,22,7,0,1,224,True,0,0,0,4106,38,0.34444444444444444,Bug
Erlang,2054,12122,3825.045081018519,MERGED,2,2,1,0,1,78,True,0,0,0,857,4,19.79861111111111,Document
Python,137,75,713.4143402777778,MERGED,0,260,8,0,26,1,False,0,0,0,2623,260,1371.1730555555555,Document
Erlang,2054,12122,3824.9868171296293,MERGED,0,1,1,0,1,165,False,0,0,0,751,1,1.5216666666666667,Document
JavaScript,8844,63474,4104.5363310185185,MERGED,5,207,10,0,1,114,True,0,0,0,3206,212,40.1025,Bug
TypeScript,2071,16640,1270.3859143518519,MERGED,1,1,1,0,1,0,False,0,0,0,2235,2,0.09833333333333333,Bug
TypeScript,41369,87413,2961.665439814815,CLOSED,0,2,2,5,2,0,False,3,2,1,2834,2,367.05833333333334,Document
Erlang,2054,12122,3824.018298611111,MERGED,3,24,2,0,1,72,False,0,0,0,762,27,1.178611111111111,Document
C#,80,125,847.1401736111111,MERGED,3,287,20,2,15,137,True,1,1,1,952,290,157.11138888888888,Feature
TypeScript,149,2900,408.9694907407407,MERGED,1,1,1,1,1,112,False,0,1,1,854,2,0.04388888888888889,Document
TypeScript,41369,87413,2965.7049884259263,MERGED,0,7,1,0,2,27,False,0,0,0,2209,7,139.46805555555557,Document
TypeScript,1297,21107,444.9862268518518,MERGED,68,20,3,1,2,1031,True,0,1,1,3136,88,0.014444444444444444,Document
Rust,264,5383,429.9281134259259,MERGED,33,86,7,0,3,247,True,0,0,0,2609,119,1.99,Feature
TypeScript,1297,21107,444.7004050925926,MERGED,176,305,15,1,5,1030,True,0,1,1,3239,481,6.474166666666667,Document
JavaScript,8844,63474,4103.5841666666665,MERGED,16,76,2,0,1,113,True,0,0,0,3395,92,16.525833333333335,Document
TypeScript,41369,87413,2965.9824189814813,MERGED,0,100,2,0,6,444,True,0,0,0,2333,100,113.50027777777778,Document
TypeScript,41369,87413,2965.9829398148145,MERGED,4,276,8,1,6,447,True,1,0,0,3077,280,112.53166666666667,Document
C#,80,125,848.7231597222222,MERGED,1,1,1,0,1,217,False,0,0,0,765,2,18.561666666666667,Document
JavaScript,9664,43889,3686.4186111111107,MERGED,105,105,3,1,5,1,False,0,1,1,836,210,14.33611111111111,Feature
C#,655,7879,1857.0234837962962,MERGED,4,10,1,2,1,1491,True,1,1,1,957,14,1.323611111111111,Document
Erlang,2054,12122,3822.435520833333,MERGED,1,3,1,0,1,71,False,0,0,0,715,4,11.622777777777777,Document
TypeScript,1297,21107,444.1011921296296,MERGED,4,24,5,1,2,1026,True,0,1,1,2473,28,0.03972222222222222,Document
JavaScript,5139,7050,1230.581736111111,MERGED,53,142,30,3,16,264,False,0,3,3,4713,195,69.84166666666667,Feature
JavaScript,5139,7050,1232.0299305555557,MERGED,26,44,27,1,2,58,False,0,1,1,3979,70,0.8111111111111111,Feature
JavaScript,5139,7050,1231.574710648148,MERGED,7,18,4,2,3,86,False,0,2,2,3454,25,20.58861111111111,Feature
TypeScript,3393,2334,996.0764120370371,MERGED,1,1,1,1,1,340,False,0,1,1,1161,2,0.3952777777777778,Feature
JavaScript,8844,63474,4101.549675925926,MERGED,204,259,15,0,8,111,True,0,0,0,2792,463,65.24194444444444,Bug
JavaScript,9664,43889,3686.1493981481485,MERGED,1,4,1,0,1,1,False,0,0,0,664,5,0.355,Feature
TypeScript,41369,87413,2963.926724537037,MERGED,7,7,3,0,2,34,False,0,0,0,2351,14,156.32361111111112,Document
TypeScript,41369,87413,2966.5880555555555,MERGED,1,17,1,0,6,107,True,0,0,0,2388,18,28.61138888888889,Document
TypeScript,41369,87413,2966.025706018518,MERGED,4,6,1,0,4,448,True,0,0,0,2654,10,39.500277777777775,Document
TypeScript,1297,21107,443.07158564814813,MERGED,12,14,3,1,2,1022,True,0,1,1,2832,26,0.03777777777777778,Document
TypeScript,15,34,519.4266087962964,MERGED,19,491,10,0,2,331,False,0,0,0,809,510,0.8347222222222223,Bug
TypeScript,85,723,345.09199074074075,MERGED,54,1030,23,0,19,101,False,0,0,0,6074,1084,269.15222222222224,Document
TypeScript,3393,2334,994.903298611111,MERGED,1,1,1,1,1,131,False,0,1,1,1041,2,0.13944444444444445,Bug
TypeScript,202,107,1171.1175231481482,MERGED,1,1,1,4,3,129,False,0,4,4,1060,2,39.25611111111111,Document
JavaScript,9664,43889,3684.4931712962966,MERGED,13,13,2,1,2,0,False,0,1,1,733,26,31.968888888888888,Feature
TypeScript,41369,87413,2965.5143634259257,MERGED,1,1,1,5,23,443,True,4,1,1,2420,2,29.371666666666666,Document
TypeScript,202,107,1170.7246875,MERGED,36,68,2,4,4,6,True,1,3,3,2736,104,20.345277777777778,Document
TypeScript,41369,87413,2966.0158333333334,MERGED,2,2,1,0,1,0,False,0,0,0,2370,4,0.7902777777777777,Document
PHP,883,2338,1857.0675347222223,CLOSED,2,30,4,1,1,66,False,0,1,1,2768,32,42.08638888888889,Document
TypeScript,41369,87413,2965.7464004629633,CLOSED,0,43,2,0,2,0,False,0,0,0,2361,43,0.6225,Document
TypeScript,41369,87413,2965.677662037037,MERGED,2,2,1,1,3,26,False,0,1,1,2387,4,1.0647222222222221,Document
TypeScript,41369,87413,2965.6841319444447,MERGED,0,3,1,0,1,1922,True,0,0,0,2196,3,0.47833333333333333,Document
TypeScript,41369,87413,2965.4938194444444,MERGED,32,31,2,1,5,19,True,0,1,1,2166,63,6.015833333333333,Document
TypeScript,41369,87413,2965.6037037037036,MERGED,2,2,1,0,1,106,True,0,0,0,2725,4,0.4247222222222222,Document
Java,450,746,4098.989328703704,MERGED,28,113,9,3,9,4,False,1,2,2,997,141,22.613333333333333,Feature
TypeScript,3706,54074,1381.9185185185186,MERGED,1,1,1,0,1,171,True,0,0,0,825,2,102.98916666666666,Bug
Erlang,2054,12122,3824.0065972222224,MERGED,9,75,5,2,5,498,True,0,2,1,1288,84,86.8725,Document
Erlang,2054,12122,3824.9532175925924,MERGED,21,238,6,3,3,499,True,1,2,1,1347,259,16.784444444444443,Document
TypeScript,41369,87413,2965.4078819444444,MERGED,3,103,3,3,2,25,False,1,2,1,2246,106,1.4819444444444445,Document
TypeScript,3393,2334,992.1358564814815,MERGED,3,10,1,2,1,0,False,0,2,1,1073,13,11.643611111111111,Bug
TypeScript,41369,87413,2965.322326388889,MERGED,15,45,2,0,3,104,True,0,0,0,2863,60,2.700833333333333,Document
Python,137,75,711.0233217592591,CLOSED,2,194,9,1,9,1,False,0,1,1,2678,196,1254.4794444444444,Document
C#,80,125,846.8388773148148,MERGED,1,5,1,0,1,200,True,0,0,0,920,6,0.22194444444444444,Document
TypeScript,307,2556,565.4467361111111,MERGED,19,28,1,2,1,302,True,1,1,1,1556,47,4.971388888888889,Bug
Go,1835,11245,1754.9787152777778,MERGED,3,3,1,0,1,23,True,0,0,0,1747,6,0.11916666666666667,Document
Erlang,2054,12122,3823.109953703704,MERGED,4,96,4,2,1,17,False,0,2,1,1306,100,1.7136111111111112,Document
Erlang,2054,12122,3823.011851851852,MERGED,58,110,4,2,5,495,True,0,2,1,1287,168,69.36861111111111,Document
JavaScript,9664,43889,3683.244039351852,CLOSED,4,4,1,3,1,0,False,1,2,2,681,8,18.878888888888888,Feature
TypeScript,41369,87413,2964.8530208333336,MERGED,1,133,3,2,3,598,True,0,2,2,2329,134,1.7219444444444445,Document
Erlang,2054,12122,3823.7301620370367,MERGED,411,429,10,5,7,497,True,1,4,2,1253,840,117.97722222222222,Document
TypeScript,307,2556,564.7630902777778,MERGED,0,16,3,0,1,301,True,0,0,0,2123,16,15.753055555555555,Feature
TypeScript,41369,87413,2964.689375,MERGED,2,2,2,0,1,103,True,0,0,0,2366,4,0.43,Document
Erlang,2054,12122,3823.0267476851855,MERGED,3,50,4,2,2,496,True,0,2,1,1295,53,14.892222222222221,Document
Erlang,2054,12122,3822.954849537037,MERGED,1,44,8,2,3,494,True,0,2,1,1308,45,44.611111111111114,Document
Vue,0,1,272.4777314814815,CLOSED,1,1,1,0,1,195,True,0,0,0,923,2,0.04416666666666667,Bug
TypeScript,15,34,516.6006018518518,MERGED,1,12,1,0,3,972,False,0,0,0,989,13,22.70138888888889,Document
Python,19249,70258,2487.4924421296296,MERGED,11,47,2,1,3,243,False,1,0,0,2052,58,0.7688888888888888,Bug
TypeScript,41369,87413,2963.8778125000003,MERGED,2,7,3,0,2,595,True,0,0,0,2526,9,14.200555555555555,Document
TypeScript,15,34,516.0673263888889,MERGED,88,91,33,0,7,970,False,0,0,0,925,179,35.35305555555556,Bug
JavaScript,9664,43889,3681.484849537037,MERGED,42,42,1,0,1,1,False,0,0,0,732,84,60.516666666666666,Bug
TypeScript,41369,87413,2963.815671296296,MERGED,0,58,2,0,1,594,True,0,0,0,2429,58,1.2333333333333334,Document
TypeScript,2147,14723,1501.2089004629631,MERGED,25,232,145,0,1,298,False,0,0,0,5597,257,184.09027777777777,Bug
TypeScript,41369,87413,2963.0767592592597,MERGED,6,9,2,11,4,5,False,0,11,4,2607,15,8.315555555555555,Document
Starlark,440,286,518.8185532407407,MERGED,0,103,4,2,6,1,False,1,1,1,1710,103,197.0125,Document
Go,2083,11769,1545.7813773148148,MERGED,24,48,3,1,1,919,True,0,1,1,2857,72,0.12194444444444444,Document
Erlang,2054,12122,3824.3345023148145,MERGED,99,166,20,2,8,50,False,0,2,1,1158,265,40.69972222222222,Document
TypeScript,7,6,673.1360763888889,MERGED,11,322,18,0,11,245,False,0,0,0,4124,333,148.095,Feature
Erlang,2054,12122,3823.868113425926,MERGED,8,5,2,1,1,145,False,1,0,0,1167,13,176.05305555555555,Document
TypeScript,85,723,344.3738657407407,MERGED,2,8,2,0,3,2,False,0,0,0,1662,10,116.2388888888889,Feature
Erlang,2054,12122,3822.1200462962966,MERGED,3,10,3,2,2,1026,True,0,2,1,1277,13,41.5325,Document
TypeScript,41369,87413,2961.5594791666667,MERGED,2,13,1,0,1,440,True,0,0,0,2362,15,5.223611111111111,Document
TypeScript,12,11,1014.4252662037037,MERGED,145,568,17,1,27,40,False,1,0,0,5406,713,210.7525,Bug
TypeScript,41369,87413,2961.753090277778,MERGED,18,19,2,1,5,23,False,0,1,1,3595,37,522.5980555555556,Document
TypeScript,41369,87413,2961.7298958333336,MERGED,63,66,5,3,19,20,False,1,2,2,4314,129,521.1263888888889,Document
Python,72,25,1664.6616550925926,MERGED,14,123,4,0,3,32,False,0,0,0,3717,137,141.0988888888889,Feature
TypeScript,58,78,849.2327430555556,MERGED,13,62,3,1,1,204,True,0,1,1,5767,75,7.529722222222222,Feature
TypeScript,3393,2334,996.6919328703704,MERGED,6,4,1,2,1,0,False,0,2,1,1441,10,4.4675,Bug
TypeScript,85,723,344.25015046296295,MERGED,697,694,21,0,14,17,False,0,0,0,6734,1391,41.397222222222226,Document
Go,421,1654,1538.8897106481481,MERGED,3,510,7,0,3,94,False,0,0,0,5493,513,168.5625,Document
C#,80,125,847.8728935185185,MERGED,2072,11342,87,0,35,183,False,0,0,0,1485,13414,212.78722222222223,Document
Rust,264,5383,432.9717708333333,MERGED,96,115,95,0,7,22,True,0,0,0,4240,211,3.3725,Bug
TypeScript,85,723,344.2071064814815,MERGED,183,828,39,0,2,98,False,0,0,0,8739,1011,0.35388888888888886,Document
Erlang,2054,12122,3825.058148148148,MERGED,0,35,1,0,1,146,False,0,0,0,1183,35,19.94638888888889,Document
Erlang,2054,12122,3825.0022106481483,MERGED,2,43,2,0,1,500,True,0,0,0,1350,45,21.58972222222222,Document
Rust,264,5383,432.88266203703705,MERGED,30,116,15,1,3,72,False,1,0,0,4157,146,3.816666666666667,Feature
Java,450,746,4101.259201388889,MERGED,56,225,2,1,4,12,False,0,1,1,1649,281,144.1836111111111,Bug
Erlang,2054,12122,3824.4315625,MERGED,21,75,11,0,3,74,False,0,0,0,1082,96,36.257222222222225,Document
Erlang,2054,12122,3824.3125694444443,MERGED,7,11,1,0,1,376,False,0,0,0,1247,18,8.158333333333333,Document
Starlark,440,286,519.2679398148148,MERGED,41,222,1,0,1,64,False,0,0,0,1707,263,17.413333333333334,Bug
Erlang,2054,12122,3824.7071527777775,MERGED,1,12,3,0,1,394,True,0,0,0,1143,13,22.745555555555555,Document
Starlark,440,286,518.7861226851852,MERGED,1,1,1,0,1,1,False,0,0,0,1221,2,28.924444444444443,Feature
C#,80,125,849.4385532407408,MERGED,4,1053,46,0,18,38,False,0,0,0,1043,1057,102.43111111111111,Document
Erlang,2054,12122,3824.4230902777776,CLOSED,30,215,4,3,1,77,True,2,1,1,998,245,13.941944444444445,Document
Python,2407,12182,266.5999537037037,CLOSED,1,4,1,6,2,0,False,3,3,2,1546,5,127.61611111111111,Document
TypeScript,3706,54074,1385.9179861111113,MERGED,381,328,9,0,2,172,True,0,0,0,4689,709,1658.7222222222222,Bug
Erlang,2054,12122,3824.2141435185185,MERGED,81,96,5,0,2,73,False,0,0,0,1080,177,4.705,Document
Erlang,2054,12122,3823.505543981482,MERGED,72,197,9,2,7,393,True,0,2,1,1380,269,22.820555555555554,Document
C#,80,125,847.5554976851853,MERGED,1831,10785,79,0,85,182,True,0,0,0,1879,12616,529.9183333333333,Document
TypeScript,3393,2334,997.2801041666667,MERGED,24,24,2,2,1,273,False,0,2,1,1755,48,14.821111111111112,Feature
TypeScript,3393,2334,997.2824884259259,MERGED,9,9,1,2,1,274,False,0,2,1,1273,18,14.697777777777778,Feature
TypeScript,4,33,790.6524074074074,CLOSED,1,1,1,1,1,217,False,0,1,1,1683,2,489.30916666666667,Bug
Go,421,1654,1538.1522106481482,MERGED,131,192,7,0,1,452,True,0,0,0,7125,323,114.95472222222222,Bug
C++,2234,23696,2385.8302083333333,MERGED,10,65,8,1,1,557,False,0,1,1,4680,75,1.0647222222222221,Feature
TypeScript,261,3765,704.8388541666667,MERGED,39,38,18,0,10,215,False,0,0,0,6108,77,15.158611111111112,Document
Starlark,440,286,516.304375,MERGED,76,92,2,0,2,1,False,0,0,0,1596,168,88.46166666666667,Bug
Starlark,440,286,516.1692592592593,MERGED,25,0,1,1,1,0,False,1,0,0,1111,25,91.57916666666667,Bug
Erlang,2054,12122,3823.245671296296,MERGED,8,16,1,0,1,18,False,0,0,0,1228,24,16.186666666666667,Document
TypeScript,3706,54074,1386.4764814814814,MERGED,3,9,1,0,1,38,True,0,0,0,1544,12,27.477222222222224,Bug
TypeScript,261,3765,704.690462962963,MERGED,8,95,5,0,3,212,False,0,0,0,6091,103,0.5027777777777778,Document
TypeScript,261,3765,704.5167013888889,MERGED,64,427,25,0,14,180,False,0,0,0,5055,491,5.561944444444444,Document
TypeScript,3393,2334,996.5874421296297,CLOSED,0,26,1,2,1,0,False,0,2,1,1247,26,5.92,Document
TypeScript,261,3765,704.5107523148148,MERGED,50,256,18,0,3,916,True,0,0,0,6862,306,0.3625,Document
TypeScript,4,33,792.1317708333332,MERGED,0,4,1,2,1,230,True,1,1,1,1461,4,0.060833333333333336,Bug
Erlang,2054,12122,3824.270439814815,MERGED,53,98,9,2,3,135,False,0,2,1,1663,151,12.874166666666667,Document
C#,655,7879,1857.1335416666668,MERGED,0,20,2,2,4,43,False,0,2,2,1749,20,2.624722222222222,Document
TypeScript,4,33,790.4668634259259,MERGED,2,2,1,3,5,2,True,2,1,1,1609,4,71.49888888888889,Bug
Erlang,2054,12122,3821.837986111111,MERGED,4,4,2,0,1,246,True,0,0,0,1156,8,50.12222222222222,Document
JavaScript,34,25,227.0161226851852,MERGED,0,104,3,0,1,81,False,0,0,0,1509,104,0.1225,Document
TypeScript,3393,2334,996.3811226851852,MERGED,1,1,1,2,1,351,False,0,2,1,1386,2,0.13277777777777777,Bug
TypeScript,3393,2334,996.3785995370371,CLOSED,1,1,1,2,1,350,False,0,2,1,1385,2,0.21,Bug
Starlark,440,286,514.2180902777778,MERGED,6,21,1,0,2,62,False,0,0,0,1654,27,138.45111111111112,Document
Erlang,2054,12122,3822.432534722222,MERGED,20,70,7,0,2,70,False,0,0,0,1006,90,14.07,Document
TypeScript,4,33,790.6068055555555,MERGED,79,101,33,3,2,617,True,2,1,1,1650,180,41.60666666666667,Document
TypeScript,4,33,791.3092013888889,MERGED,80,112,6,2,1,619,True,1,1,1,1528,192,3.8544444444444443,Feature
TypeScript,261,3765,703.7408101851852,MERGED,357,299,39,0,5,178,False,0,0,0,7315,656,2.2983333333333333,Document
TypeScript,41369,87413,2965.9828125,MERGED,258,150,4,0,7,446,True,0,0,0,3669,408,114.63833333333334,Document
Rust,264,5383,429.87620370370365,MERGED,61,47,5,0,2,246,True,0,0,0,5331,108,0.6102777777777778,Bug
TypeScript,41369,87413,2965.982650462963,MERGED,171,11,2,0,4,445,True,0,0,0,3440,182,113.55972222222222,Document
Erlang,2054,12122,3821.909340277778,MERGED,69,425,5,0,1,392,True,0,0,0,1214,494,18.825,Document
Go,789,5551,1064.850914351852,MERGED,15427,0,1,0,1,195,True,0,0,0,1245,15427,47.50111111111111,Document
TypeScript,1297,21107,444.63034722222227,MERGED,43,169,8,1,3,1029,True,0,1,1,4873,212,0.5022222222222222,Document
Python,72,25,1662.5898032407406,MERGED,35,135,2,1,3,31,False,0,1,1,3801,170,0.7302777777777778,Bug
Go,1835,11245,1752.5682754629631,MERGED,4,4,2,0,1,33,False,0,0,0,1876,8,4.145,Document
C#,80,125,848.703587962963,CLOSED,1,1,1,0,1,216,False,0,0,0,1000,2,0.3927777777777778,Document
Erlang,2054,12122,3821.879016203704,MERGED,2,8,4,2,5,493,True,0,2,1,1682,10,78.35555555555555,Document
C#,655,7879,1856.117488425926,MERGED,2,18,1,0,1,1489,True,0,0,0,1413,20,0.042222222222222223,Document
TypeScript,3393,2334,995.3494791666667,MERGED,0,5,2,2,1,347,False,0,2,1,1609,5,1.7047222222222222,Feature
Erlang,2054,12122,3821.0838310185186,MERGED,123,590,8,0,3,391,True,0,0,0,1331,713,36.03861111111111,Document
JavaScript,8844,63474,4102.202083333334,MERGED,40,78,9,5,3,1,False,1,4,2,3630,118,49.50694444444444,Feature
V,2097,34362,1580.3296412037037,MERGED,8,12,2,0,3,21,True,0,0,0,3110,20,12.04111111111111,Document
C#,655,7879,1855.3156018518519,MERGED,53,84,4,2,4,13,False,0,2,2,1875,137,19.607777777777777,Document
TypeScript,4,33,790.4888078703704,MERGED,0,4,2,2,1,616,True,1,1,1,1192,4,0.09361111111111112,Document
C#,655,7879,1856.8408680555556,MERGED,0,3,1,0,1,588,True,0,0,0,2155,3,4.816666666666666,Document
TypeScript,4,33,790.4180671296295,MERGED,1,1,1,1,1,216,False,0,1,1,1392,2,0.21388888888888888,Document
TypeScript,41369,87413,2963.7575231481483,MERGED,12,460,9,1,10,22,False,0,1,1,3544,472,167.54472222222222,Document
Vue,0,1,273.9381712962963,CLOSED,2,2,1,0,1,43,False,0,0,0,1444,4,24.15,Feature
Go,1835,11245,1756.0678587962964,MERGED,15,14,4,0,1,4,False,0,0,0,2749,29,0.3786111111111111,Document
TypeScript,4,33,789.1335648148148,MERGED,55,212,16,1,6,61,False,0,1,1,1304,267,50.53333333333333,Document
TypeScript,4,33,790.1130902777778,MERGED,32,79,14,2,9,227,True,1,1,1,1328,111,3.1327777777777777,Document
TypeScript,307,2556,567.4348958333334,MERGED,60,134,61,0,2,574,True,0,0,0,3769,194,0.2225,Bug
TypeScript,1297,21107,443.5156944444445,MERGED,3780,8710,16,1,5,1023,True,0,1,1,4020,12490,3.9980555555555557,Document
TypeScript,1073,11366,1121.7555092592593,MERGED,6,4,2,1,1,135,True,0,1,1,1170,10,0.3047222222222222,Bug
PHP,1334,2960,4235.248090277778,CLOSED,988765,91052,9319,1,1221,2,False,0,1,1,5981,1079817,0.03777777777777778,Document
C#,80,125,846.3752199074074,MERGED,69758,350,331,0,13,181,True,0,0,0,1047,70108,29.905555555555555,Document
Starlark,440,286,516.8022106481482,MERGED,1,11,1,0,1,47,False,0,0,0,1767,12,76.43583333333333,Feature
Python,2407,12182,269.65452546296297,CLOSED,9,529,6,5,70,142,True,4,1,1,2904,538,685.7811111111112,Document
Vue,0,1,273.0004050925926,CLOSED,2,2,1,0,1,42,False,0,0,0,1293,4,0.57,Document
TypeScript,41369,87413,2965.752002314815,MERGED,1,23,3,1,1,600,True,0,1,1,3523,24,0.4125,Document
TypeScript,307,2556,565.7594444444445,MERGED,15,40,8,2,2,305,True,1,1,1,3709,55,4.118055555555555,Feature
TypeScript,41369,87413,2965.524467592593,MERGED,10,10,7,0,1,105,True,0,0,0,3888,20,1.6147222222222222,Document
Go,1835,11245,1755.8877430555556,MERGED,5,9,2,0,1,24,True,0,0,0,2478,14,0.17305555555555555,Document
TypeScript,307,2556,565.5058564814815,MERGED,204,245,45,2,6,303,True,1,1,1,4372,449,8.706944444444444,Feature
Java,450,746,4098.927465277778,MERGED,16,13,6,1,2,78,True,0,1,1,3759,29,2.7711111111111113,Bug
TypeScript,41369,87413,2965.111388888889,MERGED,2,2,2,0,5,441,True,0,0,0,3261,4,7.7725,Document
Erlang,2054,12122,3822.3325810185183,MERGED,163,273,7,2,1,373,False,0,2,1,1730,436,42.25861111111111,Document
TypeScript,15,34,516.5333101851852,MERGED,50,820,22,0,13,135,False,0,0,0,1301,870,26.18888888888889,Bug
JavaScript,5139,7050,1227.984652777778,MERGED,4,895,23,6,7,0,False,2,4,2,5053,899,256.1386111111111,Feature
TypeScript,1073,11366,1119.7140162037037,MERGED,6,10,1,1,1,134,True,0,1,1,1511,16,0.6719444444444445,Bug
TypeScript,3393,2334,992.1566087962964,MERGED,4,4,2,1,2,338,False,0,1,1,1665,8,11.713888888888889,Feature
TypeScript,41369,87413,2964.869351851852,MERGED,22,22,6,0,1,599,True,0,0,0,3255,44,0.32555555555555554,Document
Go,1835,11245,1756.9130902777779,MERGED,12,12,2,0,2,555,False,0,0,0,1421,24,2.2622222222222224,Document
TypeScript,3393,2334,996.6910532407406,MERGED,4,4,3,2,1,0,False,0,2,1,2014,8,5.559444444444445,Bug
TypeScript,41369,87413,2963.909872685185,MERGED,63,67,3,1,1,101,True,1,0,0,3458,130,12.443888888888889,Document
TypeScript,3393,2334,995.7276041666668,MERGED,2,2,1,2,1,0,False,0,2,1,1743,4,51.83138888888889,Bug
TypeScript,41369,87413,2963.7964930555554,MERGED,25,24,2,0,3,6,False,0,0,0,3365,49,3.828611111111111,Document
Go,1835,11245,1755.6252083333331,MERGED,2,2,1,0,1,169,False,0,0,0,1572,4,0.03722222222222222,Document
Erlang,2054,12122,3824.2863541666666,CLOSED,0,3,1,2,1,375,False,2,0,0,1717,3,48.908611111111114,Document
Python,2407,12182,269.77585648148147,CLOSED,0,1,1,1,1,0,False,0,1,1,1936,1,1.5733333333333333,Document
TypeScript,149,2900,408.9410069444445,MERGED,17,21,5,1,1,111,False,0,1,1,1616,38,0.3536111111111111,Bug
TypeScript,41369,87413,2961.740370370371,MERGED,8,14,3,1,2,97,True,0,1,1,3426,22,44.10666666666667,Document
TypeScript,41369,87413,2961.773738425926,MERGED,10,13,3,1,3,98,True,0,1,1,3205,23,40.61472222222222,Document
TypeScript,41369,87413,2961.726134259259,MERGED,126,127,8,1,4,96,True,0,1,1,4153,253,40.906666666666666,Document
TypeScript,41369,87413,2961.69630787037,MERGED,14,17,3,1,2,95,True,0,1,1,3214,31,41.604166666666664,Document
Go,1835,11245,1754.688263888889,MERGED,0,34,1,0,1,546,False,0,0,0,1452,34,1.0394444444444444,Document
Starlark,440,286,518.1963425925926,MERGED,27,33,1,0,1,1,False,0,0,0,2438,60,43.17944444444444,Feature
TypeScript,85,723,342.9979398148148,MERGED,429,737,40,1,3,96,False,0,1,1,10831,1166,22.67888888888889,Document
Erlang,2054,12122,3824.237048611111,CLOSED,42,95,9,0,3,134,False,0,0,0,1768,137,0.7644444444444445,Document
C#,655,7879,1856.2968287037038,CLOSED,1,1,1,1,2,619,True,0,1,1,2124,2,70.65305555555555,Document
TypeScript,1073,11366,1121.9077546296296,MERGED,1,1,1,2,1,1,False,1,1,1,1975,2,139.3,Bug
Python,2407,12182,267.90746527777776,MERGED,1,1,1,0,1,310,True,0,0,0,1831,2,15.83361111111111,Document
TypeScript,4,33,790.4839236111111,MERGED,6,8,1,1,1,73,False,0,1,1,1565,14,70.74916666666667,Document
TypeScript,3393,2334,996.2832754629629,MERGED,0,24,1,2,1,348,False,0,2,1,1731,24,0.27194444444444443,Feature
Starlark,440,286,514.1452314814815,MERGED,1,1,1,1,1,0,False,1,0,0,1486,2,140.4111111111111,Bug
TypeScript,4,33,791.3091782407408,MERGED,20,37,3,2,1,618,True,1,1,1,1910,57,3.7802777777777776,Bug
Python,2407,12182,266.9961689814815,MERGED,5,7,4,1,1,307,True,1,0,0,2067,12,6.551944444444445,Document
Python,14531,41183,1115.4654166666667,MERGED,1,6,1,1,2,0,False,0,1,1,1693,7,6.5441666666666665,Document
TypeScript,3393,2334,994.8397106481481,MERGED,8,8,7,2,1,0,False,0,2,1,2194,16,24.041666666666668,Bug
TypeScript,4,33,791.1190740740741,MERGED,45,85,7,2,12,228,True,1,1,1,1893,130,3.2288888888888887,Feature
Python,2407,12182,266.27255787037035,MERGED,4,5,2,0,2,306,True,0,0,0,1939,9,0.42277777777777775,Document
Python,2407,12182,266.1590277777778,CLOSED,1,1,1,1,1,304,True,1,0,0,1588,2,0.07833333333333334,Document
TypeScript,12,11,1015.3909027777778,MERGED,63,228,25,0,1,148,False,0,0,0,9301,291,18.55027777777778,Bug
Python,14531,41183,1114.3680439814814,MERGED,13,10,1,0,3,1422,True,0,0,0,1966,23,0.2175,Document
TypeScript,3393,2334,992.2228819444445,MERGED,8,2,2,2,1,0,False,0,2,1,1871,10,39.79055555555556,Bug
TypeScript,4,33,789.3762152777778,MERGED,2,8,4,2,1,615,True,1,1,1,2063,10,22.72861111111111,Feature
Python,2407,12182,264.96947916666664,MERGED,2,2,1,1,1,78,True,1,0,0,1792,4,28.6625,Document
TypeScript,1073,11366,1121.4684143518518,MERGED,5,5,1,1,1,0,False,0,1,1,2064,10,0.3788888888888889,Document
Python,2407,12182,264.4154398148148,MERGED,13,35,3,0,7,77,True,0,0,0,2027,48,41.92166666666667,Document
TypeScript,3393,2334,993.8975810185185,MERGED,1,16,3,1,1,130,False,0,1,1,2303,17,3.7397222222222224,Feature
TypeScript,261,3765,704.6648726851853,MERGED,76,88,7,0,4,614,True,0,0,0,8327,164,4.101388888888889,Document
TypeScript,261,3765,704.6862615740741,MERGED,216,378,15,0,2,919,True,0,0,0,9738,594,0.09055555555555556,Document
Go,1835,11245,1757.8189814814814,MERGED,1,1,1,0,1,171,False,0,0,0,1816,2,0.30444444444444446,Document
Go,1835,11245,1757.7943981481483,MERGED,13,19,1,0,1,559,False,0,0,0,1752,32,0.05333333333333334,Document
Go,1835,11245,1757.7653819444442,MERGED,1,5,2,0,1,558,False,0,0,0,1658,6,0.14,Document
TypeScript,261,3765,703.7757986111111,MERGED,117,98,16,0,4,612,True,0,0,0,9553,215,0.5875,Document
Go,1835,11245,1757.022291666667,MERGED,23,24,3,0,1,556,False,0,0,0,1697,47,17.335555555555555,Document
TypeScript,7,6,673.043125,MERGED,6,380,14,1,20,227,False,0,1,1,6144,386,167.47916666666666,Feature
TypeScript,7,6,672.9073611111111,MERGED,47,457,10,0,42,22,True,0,0,0,6952,504,172.88194444444446,Feature
JavaScript,34,25,222.36842592592595,MERGED,9,16,1,0,1,80,False,0,0,0,1947,25,0.185,Bug
Go,1835,11245,1756.0990625000002,MERGED,0,9,2,0,1,552,False,0,0,0,1689,9,12.871944444444445,Document
Go,1835,11245,1755.8726041666666,MERGED,1,4,1,0,1,170,False,0,0,0,1736,5,0.20555555555555555,Document
Go,1835,11245,1755.6092592592593,MERGED,0,2,1,0,1,548,False,0,0,0,1935,2,5.309166666666667,Document
TypeScript,7,6,674.0593287037037,MERGED,393,278,40,1,9,288,False,0,1,1,7363,671,23.2125,Bug
TypeScript,4,33,790.6923263888889,MERGED,64,999,52,1,19,218,False,0,1,1,4738,1063,360.325,Document
Go,421,1654,1534.2029976851852,MERGED,722,764,7,0,1,450,True,0,0,0,9435,1486,47.382777777777775,Document
TypeScript,4803,40785,3789.6073842592596,CLOSED,3,110,3,1,1,137,True,0,1,1,2569,113,1.1152777777777778,Feature
Rust,264,5383,433.02583333333337,MERGED,19,55,6,1,2,18,False,0,1,1,6207,74,0.7075,Bug
Rust,264,5383,432.8908912037037,MERGED,50,189,15,0,2,252,True,0,0,0,6525,239,3.2083333333333335,Feature
Go,1835,11245,1753.0920023148149,MERGED,0,83,2,0,1,544,False,0,0,0,1719,83,0.9827777777777778,Document
Go,1835,11245,1753.0562268518518,MERGED,32,3,2,0,1,543,False,0,0,0,1752,35,0.39111111111111113,Document
JavaScript,22,26,945.6086458333333,MERGED,23,47,5,0,2,11,True,0,0,0,2792,70,12.879722222222222,Feature
TypeScript,3393,2334,993.430775462963,MERGED,106,143,1,5,3,0,False,2,3,2,3077,249,224.06444444444443,Feature
TypeScript,202,107,1172.1661689814816,MERGED,24,27,2,4,3,0,False,0,4,3,3022,51,156.57583333333332,Document
Go,1835,11245,1756.0763310185184,MERGED,0,346,40,5,1,3,False,2,3,3,2688,346,330.7369444444444,Document
TypeScript,1073,11366,1122.7793981481482,MERGED,0,153,5,12,9,0,False,4,8,4,2641,153,119.4,Bug
TypeScript,4803,40785,3788.7301967592593,MERGED,7,31,11,1,6,135,True,0,1,1,3379,38,19.476944444444445,Bug
Python,137,75,713.1926388888888,CLOSED,0,192,13,0,18,1,False,0,0,0,3139,192,0.17583333333333334,Feature
TypeScript,1073,11366,1122.5920717592592,MERGED,13,5,1,1,1,85,True,0,1,1,2417,18,126.14138888888888,Bug
Erlang,2054,12122,3824.1403356481483,MERGED,6,31,4,0,1,374,False,0,0,0,2678,37,3.51,Document
TypeScript,41369,87413,2966.8295138888893,MERGED,9,50,6,0,3,108,True,0,0,0,5615,59,90.80472222222222,Document
Rust,413,5118,492.8068171296297,MERGED,246,294,4,0,7,124,False,0,0,0,2679,540,215.64055555555555,Document
Python,2407,12183,268.3845138888889,MERGED,3,4,1,1,1,79,True,0,1,1,2575,7,4.341666666666667,Document
Rust,264,5383,429.89585648148153,MERGED,110,632,24,0,1,169,False,0,0,0,6042,742,5.428055555555556,Document
TypeScript,3393,2334,997.1120138888888,MERGED,6,13,5,1,1,342,False,0,1,1,3068,19,0.4494444444444444,Bug
TypeScript,3393,2334,997.0928356481481,MERGED,0,42,3,1,1,341,False,0,1,1,2289,42,0.19166666666666668,Feature
Python,2407,12183,267.8982638888889,MERGED,9,10,3,2,3,309,True,1,1,1,2472,19,16.073611111111113,Feature
TypeScript,3393,2334,996.8626388888889,MERGED,2,2,2,2,1,353,False,0,2,1,2344,4,0.5091666666666667,Feature
Go,54,353,760.6930787037037,MERGED,126,687,14,2,4,42,True,2,0,0,6831,813,22.98361111111111,Bug
Starlark,440,286,515.9924421296297,MERGED,1,37,2,7,1,0,False,4,3,2,2770,38,95.83222222222223,Feature
TypeScript,2071,16640,1266.7054513888888,MERGED,1,3,1,0,1,0,False,0,0,0,4267,4,92.98194444444445,Document
C++,2234,23696,2384.0056944444445,MERGED,21,20,3,1,4,326,False,0,1,1,3193,41,20.783333333333335,Feature
TypeScript,3393,2334,995.8385879629631,MERGED,13,51,7,2,3,469,False,0,2,1,3252,64,27.011388888888888,Feature
Vue,10806,21162,1051.1498148148148,CLOSED,2,4,1,3,3,1,False,1,2,2,2539,6,46.17722222222222,Bug
TypeScript,3393,2334,995.9917939814815,MERGED,23,23,2,2,1,718,False,0,2,2,3096,46,0.12083333333333333,Bug
Python,2407,12183,267.11324074074076,MERGED,0,2,1,1,6,1,False,0,1,1,2523,2,3.726111111111111,Document
TypeScript,3706,54075,1384.0132407407407,MERGED,3,13,3,10,10,37,True,5,5,2,2562,16,86.53694444444444,Bug
Python,2407,12183,265.79449074074074,MERGED,0,274,3,6,4,3,False,2,4,2,2384,274,29.220833333333335,Document
TypeScript,3393,2334,995.5164583333334,CLOSED,17,168,1,2,1,0,False,0,2,1,2375,185,0.3219444444444444,Bug
TypeScript,149,2900,405.7782291666667,MERGED,363,370,6,3,2,110,False,2,1,1,2611,733,76.45527777777778,Bug
Java,450,746,4100.932199074075,MERGED,0,1,1,1,1,50,False,0,1,1,2066,1,0.17,Document
Rust,413,5118,493.8530787037037,MERGED,7,55,5,3,8,152,False,1,2,2,2488,62,70.60638888888889,Document
JavaScript,22,26,942.1588194444445,MERGED,1,11,1,0,1,11,True,0,0,0,2602,12,0.09083333333333334,Feature
TypeScript,3393,2334,994.9546412037038,MERGED,14,3,4,1,3,717,False,0,1,1,3237,17,0.27805555555555556,Bug
TypeScript,3393,2334,994.8959837962963,MERGED,274,268,19,2,3,716,False,0,2,2,3075,542,0.2708333333333333,Bug
TypeScript,3393,2334,992.2524189814816,MERGED,4,12,2,2,1,0,False,0,2,1,2570,16,39.06916666666667,Bug
Java,450,746,4100.014548611111,MERGED,8,23,3,1,9,49,False,0,1,1,2181,31,2.3777777777777778,Bug
TypeScript,41369,87413,2965.6162962962967,CLOSED,1098,1100,852,0,2,201,False,0,0,0,5653,2198,1.0638888888888889,Document
TypeScript,41369,87413,2965.46505787037,MERGED,58,58,1,0,2,442,True,0,0,0,5474,116,0.47444444444444445,Document
Rust,413,5118,492.7637268518518,MERGED,1,11,1,0,2,123,False,0,0,0,2909,12,2.1475,Document
TypeScript,3393,2334,994.0689930555556,MERGED,158,49,3,2,1,468,False,0,2,1,2357,207,0.2152777777777778,Feature
TypeScript,1297,21107,441.63482638888894,MERGED,314,229,63,1,4,1012,True,0,1,1,8324,543,0.8744444444444445,Document
TypeScript,1073,11366,1120.530023148148,MERGED,2,13,2,1,1,3,True,0,1,1,2466,15,23.851388888888888,Bug
TypeScript,41369,87413,2964.5328125,MERGED,78,96,5,0,6,102,True,0,0,0,5028,174,5.331111111111111,Document
TypeScript,85,723,343.97995370370376,MERGED,281,802,45,0,7,97,False,0,0,0,10783,1083,21.645555555555557,Document
Go,1835,11245,1753.6826504629628,MERGED,3,175,17,0,1,17,False,0,0,0,2858,178,0.11138888888888888,Document
TypeScript,2147,14723,1501.1679050925925,MERGED,675,3055,137,0,33,37,False,0,0,0,11714,3730,0.8133333333333334,Document
V,2097,34362,1576.0447337962962,MERGED,13,116,4,0,7,212,True,0,0,0,5189,129,36.1475,Bug
Go,1835,11245,1757.922372685185,MERGED,0,1,1,0,1,560,False,0,0,0,2018,1,1.0783333333333334,Document
Go,1835,11245,1757.6417939814817,MERGED,7,36,4,0,1,557,False,0,0,0,2322,43,4.008333333333334,Document
TypeScript,41369,87413,2963.6493750000004,MERGED,13,39,5,8,2,16,True,4,4,3,5073,52,1.176111111111111,Document
Go,1835,11245,1756.8517824074072,MERGED,7,57,4,0,1,554,False,0,0,0,2990,64,1.1961111111111111,Document
TypeScript,85,723,343.2280324074074,MERGED,246,767,50,0,3,169,False,0,0,0,12292,1013,2.2744444444444443,Document
TypeScript,41369,87413,2961.9604745370366,CLOSED,7,450,8,2,1,28,False,1,1,1,5450,457,17.753055555555555,Document
Go,1835,11245,1756.0592476851853,MERGED,8,38,1,0,1,551,False,0,0,0,2210,46,0.25194444444444447,Document
Go,1835,11245,1755.7352314814816,MERGED,0,272,4,0,1,550,False,0,0,0,2163,272,1.3194444444444444,Document
Go,1835,11245,1755.6325694444442,MERGED,12,39,2,0,1,549,False,0,0,0,2484,51,2.5097222222222224,Document
Go,1835,11245,1754.9630092592595,MERGED,14,2,6,0,2,168,False,0,0,0,2521,16,0.31527777777777777,Document
Go,1835,11245,1754.9450694444442,MERGED,2,15,2,0,1,547,False,0,0,0,2545,17,0.4475,Document
Go,1835,11245,1754.9025231481482,MERGED,497,0,2,0,2,3,False,0,0,0,2186,497,0.16444444444444445,Document
Go,1835,11245,1752.8223842592595,MERGED,232,204,8,0,1,542,False,0,0,0,2906,436,67.10861111111112,Document
Go,1835,11245,1753.5961458333334,MERGED,44,34,3,0,1,64,False,0,0,0,2735,78,28.898055555555555,Document
Go,1835,11245,1753.6310532407408,MERGED,29,77,9,0,1,545,False,0,0,0,2858,106,5.724722222222222,Document
Go,1835,11245,1752.580787037037,MERGED,56,58,15,0,1,34,False,0,0,0,2772,114,3.8966666666666665,Document
TypeScript,3706,54075,1386.5187152777778,MERGED,577,378,43,1,10,39,True,1,0,0,5825,955,304.9488888888889,Bug
Rust,264,5383,431.99040509259254,MERGED,31,31,12,0,1,270,True,0,0,0,8006,62,0.785,Feature
Python,4516,54988,949.9778703703704,MERGED,101,125,2,4,8,0,False,3,1,1,3356,226,452.1641666666667,Document
TypeScript,1297,21107,445.21754629629635,MERGED,177,851,12,11,8,3,False,3,8,2,9304,1028,55.97805555555556,Document
Go,54,353,761.725613425926,MERGED,1740,627,18,1,6,227,True,0,1,1,8346,2367,23.40111111111111,Document
C++,2234,23696,2383.875347222222,MERGED,19,213,15,1,3,554,False,0,1,1,8820,232,46.485,Feature
Java,450,746,4100.067418981482,MERGED,1355,3371,17,2,9,79,True,0,2,1,7919,4726,69.42111111111112,Bug
Go,789,5551,1070.1524652777778,MERGED,0,9,4,0,3,10,False,0,0,0,3579,9,15.861944444444445,Document
TypeScript,3393,2334,996.7994907407407,MERGED,11,28,2,2,1,0,False,0,2,1,3382,39,3.6797222222222223,Bug
Starlark,440,286,519.4420833333334,MERGED,4,172,1,0,1,26,False,0,0,0,3250,176,13.255833333333333,Feature
Python,4516,54988,953.1121064814815,CLOSED,10,148,3,6,4,0,False,2,4,3,6692,158,384.965,Document
TypeScript,3393,2334,994.8266087962962,MERGED,120,256,2,3,1,0,False,0,3,2,4037,376,77.83305555555556,Feature
Python,4516,54988,953.9151041666668,MERGED,0,93,2,1,16,0,False,1,0,0,3562,93,135.85833333333332,Document
Starlark,440,286,518.852962962963,MERGED,0,361,2,2,1,0,False,1,1,1,3775,361,48.2125,Document
TypeScript,58,78,846.4303240740741,MERGED,79,190,6,1,5,123,False,0,1,1,4670,269,75.06222222222222,Feature
Starlark,440,286,519.1173032407407,MERGED,60,40,3,1,1,82,False,0,1,1,3257,100,21.020833333333332,Bug
Python,2407,12183,267.8940277777778,CLOSED,3,26,2,9,2,0,False,5,4,1,3239,29,37.26305555555555,Document
Starlark,440,286,518.2440046296296,CLOSED,0,103,4,6,4,0,False,6,0,0,4101,103,13.532222222222222,Feature
Python,4516,54988,954.7449652777777,MERGED,15,198,1,0,5,104,True,0,0,0,4404,213,20.52611111111111,Document
TypeScript,4,33,792.0980208333334,MERGED,24,23,6,2,4,229,True,1,1,1,4110,47,0.2602777777777778,Document
TypeScript,3393,2334,997.0375,MERGED,27,55,8,2,2,470,False,0,2,1,5297,82,2.004722222222222,Feature
TypeScript,41369,87413,2964.463391203704,MERGED,108,892,12,1,6,596,True,0,1,1,8225,1000,5.443611111111111,Document
TypeScript,4,33,791.3092361111111,MERGED,60,239,9,2,2,620,True,1,1,1,4369,299,3.942222222222222,Bug
Java,450,746,4101.103055555555,MERGED,57,60,5,1,2,26,False,0,1,1,4633,117,34.75055555555556,Document
Starlark,440,286,514.1755324074074,MERGED,2,2,1,3,8,2,False,0,3,2,3475,4,160.2422222222222,Document
Starlark,440,286,514.1740393518519,MERGED,0,261,2,1,8,0,False,1,0,0,3160,261,160.20694444444445,Document
Python,2407,12183,267.26944444444445,MERGED,14,72,11,0,9,308,True,0,0,0,4470,86,0.028333333333333332,Document
Starlark,440,286,514.2473842592593,MERGED,47,121,2,0,6,63,False,0,0,0,4546,168,137.745,Feature
TypeScript,140,827,776.3109722222222,MERGED,2,76,3,2,5,48,False,0,2,2,3792,78,20.940277777777776,Feature
TypeScript,3393,2334,994.9989930555556,MERGED,11,64,6,1,3,339,False,0,1,1,5121,75,1.2466666666666666,Feature
Java,450,746,4100.174710648148,MERGED,10,24,5,1,1,380,True,0,1,1,3872,34,0.5766666666666667,Document
TypeScript,4,33,789.6956828703704,MERGED,26,32,9,1,2,215,False,0,1,1,4562,58,0.06694444444444445,Document
TypeScript,41369,87413,2962.487523148148,MERGED,574,617,57,4,30,100,True,1,3,2,9233,1191,1.0325,Document
TypeScript,1073,11366,1121.7179282407408,MERGED,16,14,3,1,1,4,True,0,1,1,4003,30,0.14277777777777778,Document
Python,4516,54988,951.6176157407408,MERGED,25,40,1,0,1,102,True,0,0,0,4437,65,20.674722222222222,Document
Starlark,440,286,514.2136689814814,CLOSED,4,38,2,0,2,61,False,0,0,0,3063,42,0.3616666666666667,Bug
Python,4516,54988,950.7977662037038,MERGED,4,30,1,0,2,101,True,0,0,0,3423,34,14.949444444444444,Document
Python,4516,54988,950.7113194444445,MERGED,1,5,1,0,1,98,True,0,0,0,3316,6,16.365833333333335,Document
Go,1835,11245,1757.8953935185184,MERGED,17,32,5,0,1,67,False,0,0,0,3424,49,0.10861111111111112,Document
Go,1835,11245,1757.8613657407407,MERGED,24,53,7,0,2,5,False,0,0,0,4652,77,0.6383333333333333,Document
Python,4516,54988,950.5933333333334,MERGED,12,50,1,0,6,96,True,0,0,0,4343,62,17.630555555555556,Document
Python,4516,54988,950.570162037037,MERGED,7,7,1,0,2,95,True,0,0,0,3681,14,17.996666666666666,Document
Python,4516,54988,950.5633101851853,MERGED,3,5,1,0,1,94,True,0,0,0,4011,8,17.273611111111112,Document
TypeScript,184,377,1938.2067939814815,CLOSED,0,18,1,3,3,36,False,2,1,1,5154,18,832.2905555555556,Document
TypeScript,1073,11366,1119.612824074074,MERGED,540,48,7,1,1,757,True,0,1,1,4376,588,2.986111111111111,Feature
Python,4516,54988,950.1536226851853,MERGED,6,28,1,2,2,3,False,1,1,1,3544,34,24.011111111111113,Document
TypeScript,202,107,1168.5138078703703,CLOSED,30,52,2,3,1,0,False,0,3,3,5093,82,0.40166666666666667,Document
Go,1835,11245,1756.744386574074,MERGED,62,48,13,0,3,553,False,0,0,0,4179,110,4.003611111111111,Document
Go,1835,11245,1754.9540046296297,MERGED,33,84,29,0,2,167,False,0,0,0,4976,117,0.17805555555555555,Document
Go,1835,11245,1754.6061111111112,MERGED,73,9,6,0,1,65,False,0,0,0,4723,82,0.2011111111111111,Document
Go,1835,11245,1753.1877662037039,MERGED,7,57,13,0,2,166,False,0,0,0,3280,64,22.670833333333334,Document
JavaScript,34,25,226.60087962962962,MERGED,5,51,20,0,1,4,False,0,0,0,7792,56,9.07611111111111,Bug
Rust,264,5383,430.03075231481483,MERGED,306,756,35,0,35,350,False,0,0,0,10719,1062,219.94333333333333,Bug
Rust,264,5383,432.0451851851852,MERGED,346,160,44,2,2,271,True,2,0,0,13930,506,1.993611111111111,Feature
Rust,264,5383,430.8992476851852,MERGED,3,3,1,0,1,119,True,0,0,0,10149,6,0.6,Bug
TypeScript,1297,21107,445.0235416666667,MERGED,67,262,13,1,8,1032,True,0,1,1,11127,329,0.6311111111111111,Document
TypeScript,3393,2334,993.973611111111,MERGED,345,2167,64,2,55,467,False,0,2,1,6317,2512,513.6152777777778,Feature
TypeScript,41369,87413,2964.948657407407,MERGED,3830,4119,482,1,20,200,False,0,1,1,10007,7949,13.985833333333334,Document
TypeScript,4803,40785,3789.5910995370373,CLOSED,37,147,8,1,1,136,True,0,1,1,5435,184,1.5025,Document
Go,2,11,1171.8699305555556,MERGED,61,154,12,0,24,36,False,0,0,0,5637,215,4.958888888888889,Bug
TypeScript,3393,2334,996.9060532407407,MERGED,1038,1705,17,3,2,720,False,0,3,2,7006,2743,22.998055555555556,Feature
Python,4516,54988,951.7288541666667,MERGED,2,2,1,1,2,1,False,0,1,1,6173,4,165.09222222222223,Document
Python,4516,54988,954.7433449074074,MERGED,48,81,1,0,1,103,True,0,0,0,4855,129,20.380555555555556,Document
TypeScript,3393,2334,995.9963194444445,MERGED,197,328,18,2,3,719,False,0,2,2,6971,525,20.113055555555555,Bug
Python,4516,54988,950.5612037037037,MERGED,13,43,1,0,3,93,True,0,0,0,6125,56,191.2588888888889,Document
Python,4516,54988,950.7639699074074,MERGED,61,122,1,1,5,100,True,1,0,0,5689,183,166.00555555555556,Document
Go,789,5551,1070.118425925926,CLOSED,2788,134,55,1,1,387,False,1,0,0,9910,2922,89.70027777777777,Document
Python,4516,54988,950.7109722222222,MERGED,24,62,2,0,1,97,True,0,0,0,5850,86,16.18777777777778,Document
Go,1835,11245,1757.9259953703704,MERGED,3924,1376,16,1,2,68,False,0,1,1,5368,5300,2.5605555555555557,Document
Go,1835,11245,1757.1269212962964,MERGED,499,572,9,1,4,66,False,0,1,1,6620,1071,17.681944444444444,Document
TypeScript,1297,21107,445.7855555555555,MERGED,32,601,12,1,13,1034,True,0,1,1,20874,633,4.653611111111111,Document
C++,2234,23696,2386.0199189814816,MERGED,74,223,11,1,5,327,False,0,1,1,7715,297,112.59527777777778,Document
JavaScript,8844,63474,4102.322627314815,MERGED,153,442,23,0,2,112,True,0,0,0,19478,595,46.77388888888889,Bug
TypeScript,41369,87413,2965.9175694444443,MERGED,3491,3579,444,1,1,601,True,0,1,1,18967,7070,0.3441666666666667,Document
TypeScript,41369,87413,2964.7047453703703,MERGED,6350,31817,300,1,78,597,True,0,1,1,17261,38167,1.0825,Document
TypeScript,1297,21107,441.07372685185186,CLOSED,315,1018,65,1,2,1011,True,0,1,1,15474,1333,13.315555555555555,Document
Java,450,746,4101.479120370371,MERGED,4417,11257,128,2,5,27,False,0,2,1,8915,15674,40.06861111111111,Document
TypeScript,4,33,791.7056944444445,MERGED,271,746,21,1,7,219,False,0,1,1,7842,1017,0.19611111111111112,Document
TypeScript,4,33,791.2243518518518,MERGED,9069,733,12,1,10,378,False,0,1,1,8673,9802,1.448611111111111,Document
TypeScript,1073,11366,1121.7696875,MERGED,711,544,28,0,39,32,True,0,0,0,10279,1255,0.25194444444444447,Document
Java,450,746,4099.1194444444445,MERGED,198,12,11,1,16,48,False,0,1,1,8803,210,3.6569444444444446,Feature
Go,1835,11245,1757.882141203704,MERGED,1493,4290,17,1,2,35,False,0,1,1,8260,5783,0.18055555555555555,Document
Go,1835,11245,1754.6189930555556,MERGED,140,1623,46,1,1,2,False,0,1,1,9749,1763,24.6925,Document
Go,1835,11245,1754.0186342592594,MERGED,120,93,38,0,1,13,False,0,0,0,9732,213,20.421666666666667,Document
TypeScript,3393,2334,994.8878125,MERGED,539,4849,89,3,104,1,False,0,3,2,12635,5388,395.98,Document
TypeScript,1073,11366,1122.7244675925926,MERGED,144,611,37,1,58,136,True,0,1,1,15316,755,166.1472222222222,Bug
Python,4516,54988,950.1638541666666,MERGED,27,102,1,2,11,145,False,0,2,1,11506,129,120.24361111111111,Document
TypeScript,1073,11366,1120.7814930555555,MERGED,761,631,22,1,7,84,True,0,1,1,13261,1392,42.87888888888889,Bug
TypeScript,1073,11366,1119.6855787037036,MERGED,64,340,15,1,8,133,True,0,1,1,13007,404,26.334444444444443,Bug
Go,1835,11245,1753.1566666666668,MERGED,2813,137,34,1,3,22,True,0,1,1,13069,2950,42.015277777777776,Document
V,2097,34362,1586.104386574074,MERGED,11,128,14,5,17,32,True,2,3,1,685,139,104.19583333333334,Bug
V,2097,34362,1585.4629513888888,MERGED,19,22,4,0,3,30,True,0,0,0,1182,41,15.814444444444444,Bug
TypeScript,15,34,523.7698263888889,MERGED,15,18,3,0,7,52,False,0,0,0,326,33,1848.701111111111,Bug
TypeScript,15,34,519.644386574074,MERGED,322,1664,56,0,15,333,False,0,0,0,366,1986,1965.0244444444445,Feature
V,2097,34362,1585.641747685185,MERGED,5,0,4,0,1,31,True,0,0,0,1419,5,11.533333333333333,Bug
PHP,883,2338,1864.8382291666667,CLOSED,3,27,3,7,1,67,False,4,3,2,2295,30,1799.5952777777777,Document
Python,547,7160,2271.482523148148,MERGED,0,4,1,0,3,298,True,0,0,0,811,4,1202.6566666666668,Bug
Python,547,7160,2268.6775231481483,CLOSED,24,24,2,0,1,0,False,0,0,0,803,48,1241.9022222222222,Bug
TypeScript,2147,14723,1507.0980439814814,MERGED,65,5,3,0,6,731,False,0,0,0,949,70,67.42055555555555,Bug
Vue,10806,21162,1053.356261574074,MERGED,1,1,1,2,2,1,False,0,2,2,1316,2,1017.395,Bug
TypeScript,2147,14723,1507.0377430555554,MERGED,10,22,1,0,1,180,False,0,0,0,660,32,0.07277777777777777,Feature
TypeScript,202,107,1179.0430439814816,CLOSED,0,0,0,5,2,255,True,1,4,4,1574,0,179.65333333333334,Document
C++,2234,23696,2388.7972916666668,MERGED,0,39,2,5,13,4,False,1,4,2,1038,39,766.3430555555556,Feature
TypeScript,12,11,1022.4421874999999,MERGED,1,1,1,0,1,114,False,0,0,0,767,2,31.0575,Bug
Go,1835,11245,1762.602013888889,MERGED,52,63,3,0,2,117,False,0,0,0,368,115,10.567222222222222,Feature
TypeScript,2147,14723,1506.025486111111,MERGED,0,1,1,0,1,177,False,0,0,0,590,1,2.546388888888889,Feature
TypeScript,2147,14723,1505.9352662037036,CLOSED,0,10,1,0,1,38,False,0,0,0,637,10,1.3841666666666668,Bug
Python,547,7160,2271.4664583333333,MERGED,28,28,1,1,6,13,False,0,1,1,1069,56,552.9008333333334,Document
TypeScript,178,1359,355.76708333333335,MERGED,1,1,1,1,1,12,False,0,1,1,713,2,0.5413888888888889,Bug
TypeScript,2147,14723,1506.1969907407408,MERGED,2,2,1,0,1,179,False,0,0,0,976,4,0.4413888888888889,Bug
TypeScript,85,723,349.04428240740737,MERGED,8,12,1,0,2,22,False,0,0,0,1035,20,4.400277777777778,Document
TypeScript,178,1359,352.5662037037037,MERGED,0,1,1,1,1,11,False,0,1,1,840,1,79.58777777777777,Feature
TypeScript,85,723,349.0216898148148,MERGED,0,2,1,0,1,21,False,0,0,0,1104,2,0.25194444444444447,Document
TypeScript,2147,14723,1506.0734722222223,MERGED,2,10,2,0,1,178,False,0,0,0,851,12,1.3788888888888888,Feature
Go,30,295,378.0413078703704,MERGED,0,1,1,0,1,106,True,0,0,0,1136,1,0.11888888888888889,Bug
TypeScript,2147,14723,1505.8226504629629,MERGED,0,1,1,0,1,2,False,0,0,0,733,1,4.331944444444445,Bug
Python,547,7160,2272.5056712962964,MERGED,54,353,7,0,3,14,False,0,0,0,850,407,0.2608333333333333,Bug
V,2097,34362,1586.530150462963,MERGED,0,46,2,1,2,228,True,0,1,1,490,46,63.073055555555555,Bug
PHP,1334,2960,4242.4609375,MERGED,0,1,1,1,2,21,False,0,1,1,766,1,18.32138888888889,Document
Vue,10806,21162,1055.3866087962963,CLOSED,16,16,1,4,1,7,False,2,2,2,1331,32,1329.4577777777777,Bug
Go,421,1654,1544.126145833333,MERGED,0,2,1,0,1,67,False,0,0,0,1069,2,1.4541666666666666,Bug
TypeScript,2147,14723,1502.9913310185184,MERGED,2,3,1,0,1,41,False,0,0,0,1128,5,0.7686111111111111,Feature
TypeScript,261,3765,709.6849421296297,MERGED,24,3,1,0,2,42,False,0,0,0,1264,27,72.11805555555556,Document
TypeScript,2147,14723,1506.8211226851852,MERGED,7,11,3,0,2,676,False,0,0,0,1516,18,48.19722222222222,Feature
V,2097,34362,1586.4020138888889,MERGED,2,6,2,2,2,227,True,1,1,1,509,8,19.14666666666667,Bug
Go,421,1654,1543.0607060185184,MERGED,1,1,1,0,1,248,False,0,0,0,790,2,20.833055555555557,Bug
TypeScript,261,3765,710.8429398148147,MERGED,1,8,2,0,1,626,True,0,0,0,1526,9,0.3202777777777778,Document
TypeScript,261,3765,710.7572222222221,MERGED,0,20,2,0,5,189,False,0,0,0,1542,20,0.5277777777777778,Document
Rust,264,5383,436.7670949074074,MERGED,9,187,11,4,7,0,False,2,2,1,2214,196,772.5127777777777,Feature
TypeScript,261,3765,710.6419097222223,MERGED,55,62,3,0,1,188,False,0,0,0,1357,117,0.6488888888888888,Document
TypeScript,85,723,349.3990856481482,CLOSED,3,3,1,1,5,4,False,1,0,0,1304,6,45.97805555555556,Feature
TypeScript,85,723,345.28065972222225,MERGED,12,3,1,0,1,18,False,0,0,0,1284,15,0.19361111111111112,Document
TypeScript,261,3765,710.5333101851852,MERGED,204,45,2,0,1,936,True,0,0,0,1277,249,0.295,Document
TypeScript,178,1359,355.6990856481482,MERGED,11,2,4,1,1,11,False,0,1,1,1418,13,1.35,Feature
V,2097,34362,1584.7677430555557,CLOSED,2,2,1,1,1,225,True,0,1,1,503,4,7.377777777777778,Bug
TypeScript,261,3765,709.8422916666667,MERGED,4,9,2,0,1,222,False,0,0,0,1567,13,0.2813888888888889,Document
TypeScript,12,11,1023.1140393518518,MERGED,15,44,6,0,45,42,False,0,0,0,2315,59,146.89138888888888,Feature
TypeScript,261,3765,709.7242361111112,MERGED,5,5,2,0,2,68,False,0,0,0,1177,10,0.5430555555555555,Document
TypeScript,261,3765,709.7052083333333,CLOSED,1,1,1,0,1,0,False,0,0,0,1149,2,0.05444444444444444,Document
Vue,293,495,864.5987847222223,MERGED,2,2,1,3,2,175,True,0,3,2,545,4,4.336666666666667,Bug
TypeScript,85,723,349.1636226851852,MERGED,3,3,2,0,2,171,False,0,0,0,1385,6,2.2730555555555556,Document
V,2097,34362,1586.0786458333332,MERGED,0,3,1,6,1,0,False,3,3,1,709,3,73.91527777777777,Document
C++,2234,23696,2390.970659722222,MERGED,1,3,1,1,1,5,False,0,1,1,734,4,16.951944444444443,Feature
V,2097,34362,1582.5580787037036,MERGED,121,131,11,1,6,28,True,0,1,1,4793,252,16.199166666666667,Bug
TypeScript,2147,14723,1506.0016666666668,MERGED,6,20,1,0,4,39,False,0,0,0,1257,26,2.221388888888889,Bug
TypeScript,2147,14723,1505.8296180555556,MERGED,9,19,7,0,2,42,False,0,0,0,1535,28,3.1469444444444443,Bug
Go,30,295,378.02373842592596,MERGED,1,33,2,0,1,105,True,0,0,0,1915,34,0.1325,Bug
Python,547,7160,2272.4078587962963,CLOSED,36,61,4,1,4,228,False,0,1,1,805,97,173.75861111111112,Bug
Rust,417,2801,958.0160185185185,MERGED,1,255,5,2,7,28,False,0,2,2,370,256,7.971388888888889,Document
C++,2234,23696,2391.744722222222,MERGED,3,5,1,1,1,332,False,0,1,1,870,8,2.2925,Bug
JavaScript,8844,63474,4111.303703703704,MERGED,474,1052,83,0,5,116,True,0,0,0,1015,1526,48.77916666666667,Document
Rust,264,5383,438.1034375,MERGED,1,1,1,0,2,0,False,0,0,0,856,2,1.49,Bug
Vue,293,495,860.8563078703704,MERGED,9,34,3,7,2,174,True,1,6,4,620,43,90.98027777777777,Bug
Rust,264,5383,437.8663888888889,CLOSED,2,2,1,4,1,174,False,1,3,1,1012,4,0.8588888888888889,Feature
TypeScript,2147,14723,1502.9917824074073,MERGED,16,55,2,1,1,104,False,0,1,1,1287,71,70.92166666666667,Document
TypeScript,42,46,799.7491782407407,MERGED,4,8,2,1,4,25,False,0,1,1,364,12,2.6902777777777778,Feature
PHP,1334,2960,4241.0827430555555,MERGED,34,56,3,5,6,873,False,2,3,2,1793,90,93.4725,Bug
TypeScript,261,3765,706.8828935185185,MERGED,1,1,1,0,1,144,True,0,0,0,1202,2,0.006388888888888889,Document
TypeScript,261,3765,706.7571296296296,MERGED,2,2,1,0,1,219,False,0,0,0,1277,4,0.49083333333333334,Document
V,2097,34362,1584.6702199074073,MERGED,3,24,2,0,2,29,True,0,0,0,751,27,15.55861111111111,Bug
TypeScript,261,3765,706.6596643518519,MERGED,6,1,1,0,1,620,True,0,0,0,1174,7,0.24388888888888888,Document
TypeScript,12,11,1018.5150810185186,MERGED,4,4,2,0,1,163,False,0,0,0,1159,8,15.228055555555555,Feature
TypeScript,261,3765,709.6416087962963,MERGED,19,20,1,0,1,41,False,0,0,0,2395,39,361.4247222222222,Document
TypeScript,2147,14723,1503.033148148148,MERGED,5,145,5,0,1,86,False,0,0,0,1629,150,1.2255555555555555,Bug
TypeScript,261,3765,710.5469675925925,MERGED,19,28,4,0,1,937,True,0,0,0,1853,47,0.7986111111111112,Document
TypeScript,2147,14723,1502.8707060185186,MERGED,5,13,1,0,1,40,False,0,0,0,1571,18,2.3088888888888888,Bug
Vue,293,495,864.0228819444445,MERGED,7,24,4,6,2,390,False,1,5,4,969,31,48.24611111111111,Bug
C++,2234,23696,2390.8496180555553,MERGED,6,32,2,2,3,329,False,1,1,1,859,38,2.648888888888889,Feature
TypeScript,7,6,674.9671296296297,MERGED,0,8,1,0,1,277,False,0,0,0,792,8,99.98777777777778,Document
TypeScript,261,3765,709.767037037037,MERGED,328,94,8,0,2,221,False,0,0,0,2153,422,0.5847222222222223,Document
TypeScript,202,107,1174.048611111111,MERGED,68,69,4,3,3,239,True,0,3,3,3446,137,89.61694444444444,Document
Go,395,660,1299.3092476851853,MERGED,2,2,1,0,1,126,False,0,0,0,252,4,325.1816666666667,Feature
Go,421,1654,1543.9588425925924,MERGED,44,44,1,2,1,99,False,1,1,1,1969,88,143.21444444444444,Document
TypeScript,261,3765,709.5120138888889,MERGED,24,31,4,0,2,623,True,0,0,0,1701,55,2.4347222222222222,Document
JavaScript,5139,7050,1233.965474537037,MERGED,1,1,1,1,1,0,False,0,1,1,774,2,0.16666666666666666,Document
Vue,293,495,860.0931134259259,MERGED,1,1,2,4,1,387,False,0,4,3,678,2,3.2466666666666666,Bug
JavaScript,8844,63474,4107.196458333333,MERGED,2,2,1,0,1,7,True,0,0,0,1059,4,95.92833333333333,Bug
TypeScript,202,107,1178.6002083333333,MERGED,8,19,2,3,3,260,True,1,2,2,1047,27,1.7744444444444445,Document
Vue,293,495,860.8529166666667,MERGED,616,379,27,13,18,173,True,4,9,6,1301,995,456.77472222222224,Bug
Vue,293,495,860.1261805555555,MERGED,13,30,2,8,5,388,False,1,7,5,871,43,167.26527777777778,Bug
Java,450,746,4102.183333333333,MERGED,1,1,1,1,1,80,True,0,1,1,768,2,18.828333333333333,Bug
Python,19248,70258,2494.5604282407407,CLOSED,0,1,1,2,3,313,False,2,0,0,133,1,10.30888888888889,Feature
TypeScript,41369,87413,2967.7731597222223,MERGED,39,360,9,1,11,77,True,0,1,1,4487,399,1585.1463888888889,Document
Go,395,660,1300.019826388889,MERGED,6,4,1,0,1,127,False,0,0,0,222,10,0.29694444444444446,Feature
TypeScript,261,3765,706.7984375,MERGED,1,10,2,0,1,112,False,0,0,0,1951,11,0.6802777777777778,Document
TypeScript,261,3765,706.7436458333333,MERGED,2,18,2,0,1,111,False,0,0,0,2185,20,0.28888888888888886,Document
PHP,1334,2960,4241.111608796296,MERGED,1,1,1,1,1,163,False,0,1,1,1705,2,46.93861111111111,Document
TypeScript,261,3765,706.4855324074074,MERGED,20,7,5,0,1,927,True,0,0,0,1808,27,0.8061111111111111,Document
Go,395,660,1298.8553819444444,MERGED,0,79,1,0,2,123,False,0,0,0,213,79,8.660277777777777,Feature
TypeScript,85,723,346.1610069444444,MERGED,5,43,2,0,2,19,False,0,0,0,2437,48,0.6947222222222222,Document
TypeScript,202,107,1179.0515625,MERGED,87,41,2,3,3,257,True,0,3,3,1856,128,179.40083333333334,Document
TypeScript,202,107,1179.0199305555554,MERGED,17,14,2,3,4,253,True,0,3,3,2039,31,180.55555555555554,Document
TypeScript,202,107,1178.9350925925926,MERGED,92,89,1,3,1,248,True,0,3,3,1411,181,182.88833333333332,Document
TypeScript,202,107,1178.6786689814815,MERGED,321,145,2,4,6,243,True,0,4,3,1282,466,188.8713888888889,Document
TypeScript,202,107,1178.5745949074073,MERGED,45,22,1,3,3,242,True,0,3,3,1865,67,191.3802777777778,Document
V,2097,34362,1582.4140625,MERGED,0,42,3,5,3,219,True,1,4,3,706,42,54.07083333333333,Bug
TypeScript,261,3765,710.8765856481482,CLOSED,0,0,0,0,0,263,True,0,0,0,2911,0,66.18888888888888,Document
V,2097,34362,1582.9263773148148,MERGED,2,35,2,0,2,221,True,0,0,0,1177,37,20.708333333333332,Bug
V,2097,34362,1582.9365162037038,MERGED,1,16,2,0,1,222,True,0,0,0,770,17,13.620277777777778,Bug
Python,19248,70258,2495.4409953703703,CLOSED,13,14,3,3,6,1614,False,3,0,0,1293,27,13.668611111111112,Bug
JavaScript,8844,63474,4111.757361111111,MERGED,0,3,1,0,1,8,True,0,0,0,1122,3,34.63944444444444,Document
Vue,10806,21162,1053.7992245370372,CLOSED,0,1,1,1,1,3,False,0,1,1,1088,1,0.13944444444444445,Document
TypeScript,58,78,854.3619212962963,MERGED,416,77,4,2,2,209,True,1,1,1,2397,493,16.06972222222222,Feature
TypeScript,202,107,1174.7676157407407,MERGED,1,1,1,2,1,241,True,0,2,2,1024,2,0.10916666666666666,Bug
TypeScript,202,107,1174.736087962963,MERGED,2,2,1,3,1,240,True,0,3,3,1038,4,0.6813888888888889,Bug
Rust,264,5383,437.8272222222222,MERGED,135,100,25,0,4,256,True,0,0,0,1732,235,1.3913888888888888,Feature
TypeScript,15,34,523.3870833333334,MERGED,3,67,1,0,2,489,True,0,0,0,157,70,8.945,Bug
TypeScript,261,3765,710.9428009259259,MERGED,16,25,5,0,1,220,True,0,0,0,2878,41,0.27166666666666667,Document
TypeScript,15,34,524.6412731481481,CLOSED,2,3,1,0,3,54,False,0,0,0,214,5,2.5922222222222224,Document
TypeScript,261,3765,710.761724537037,MERGED,12,9,3,0,1,941,True,0,0,0,2146,21,0.3036111111111111,Document
Go,54,353,762.8462615740741,MERGED,1,3,1,0,2,45,True,0,0,0,755,4,0.5186111111111111,Feature
TypeScript,261,3765,710.6062384259259,MERGED,8,32,4,0,1,219,True,0,0,0,2552,40,5.633333333333334,Document
Vue,293,495,864.9547453703703,MERGED,1,98,6,11,9,391,False,3,8,4,1227,99,51.068333333333335,Bug
TypeScript,261,3765,710.5067939814816,MERGED,12,35,4,0,2,935,True,0,0,0,2407,47,0.32861111111111113,Document
Go,395,660,1299.0299189814816,MERGED,0,1,1,2,1,15,False,1,1,1,212,1,73.94833333333334,Bug
TypeScript,261,3765,709.8759143518519,MERGED,12,13,3,0,3,264,True,0,0,0,2503,25,14.994444444444444,Document
TypeScript,15,34,524.7034259259259,CLOSED,1,1,1,0,2,55,False,0,0,0,223,2,1.0980555555555556,Document
Vue,293,495,865.1013425925926,MERGED,13,117,4,13,8,392,False,3,10,4,1271,130,24.023611111111112,Bug
Python,547,7160,2271.9500694444446,MERGED,392,45,11,0,13,9,False,0,0,0,1198,437,74.495,Bug
Starlark,440,286,521.4128935185184,MERGED,49,15,1,2,16,9,False,0,2,1,365,64,135.01055555555556,Bug
Go,395,660,1299.1374305555555,MERGED,1,1,1,0,1,67,False,0,0,0,180,2,46.38055555555555,Feature
TypeScript,261,3765,709.7588194444444,MERGED,1,69,4,0,2,220,False,0,0,0,2270,70,0.4577777777777778,Document
TypeScript,261,3765,709.6365856481481,MERGED,6,67,6,0,1,932,True,0,0,0,2961,73,0.2877777777777778,Document
Go,395,660,1299.016261574074,CLOSED,26,20,2,0,3,341,False,0,0,0,387,46,24.829722222222223,Feature
Go,395,660,1298.8959027777778,MERGED,39,34,1,0,7,124,False,0,0,0,281,73,2.269722222222222,Feature
Go,395,660,1299.1049537037036,MERGED,6,10,1,0,3,16,False,0,0,0,241,16,22.39361111111111,Feature
TypeScript,15,34,523.6642824074074,MERGED,1,1,1,0,2,994,False,0,0,0,231,2,2.2711111111111113,Bug
TypeScript,15,34,523.6231828703704,MERGED,12,12,1,0,2,993,False,0,0,0,205,24,3.2558333333333334,Feature
TypeScript,12,11,1019.2661689814814,MERGED,6,11,5,0,1,111,False,0,0,0,2807,17,76.08694444444444,Feature
Go,395,660,1299.2120486111112,MERGED,1,1,1,0,1,125,False,0,0,0,230,2,0.06666666666666667,Bug
Python,2407,12183,272.3097569444445,MERGED,7,2,1,1,1,3,False,0,1,1,2032,9,15.89861111111111,Document
TypeScript,7,6,678.8849421296296,MERGED,0,341,4,0,67,25,True,0,0,0,2035,341,147.3697222222222,Feature
Python,547,7160,2267.621527777778,MERGED,26,84,2,0,35,30,False,0,0,0,621,110,357.61,Bug
TypeScript,202,107,1177.9898148148147,MERGED,175,139,1,11,16,3,False,4,7,4,623,314,371.94444444444446,Bug
Python,137,75,716.0575578703703,MERGED,0,47,4,0,11,1,False,0,0,0,1319,47,1146.9405555555556,Bug
TypeScript,261,3765,706.7469675925926,MERGED,148,333,14,0,3,930,True,0,0,0,2958,481,69.4811111111111,Document
TypeScript,202,107,1178.9359490740742,MERGED,111,93,4,3,4,261,True,0,3,3,2153,204,238.3997222222222,Document
C++,2234,23696,2387.9718749999997,MERGED,0,66,3,2,4,41,False,1,1,1,1377,66,66.59222222222222,Document
Vue,10806,21162,1055.2735185185186,MERGED,2,5,2,1,1,3,False,0,1,1,2025,7,75.75722222222223,Document
JavaScript,9664,43889,3691.002511574074,MERGED,1,4,2,0,2,255,True,0,0,0,287,5,23.65361111111111,Feature
Rust,433,2229,266.4860648148148,MERGED,1,1,1,0,1,931,False,0,0,0,238,2,3.214722222222222,Bug
Go,421,1654,1543.4856828703705,MERGED,72,105,1,0,1,456,True,0,0,0,2533,177,33.825833333333335,Bug
Vue,293,495,861.637199074074,MERGED,61,85,8,7,5,389,False,1,6,5,1274,146,55.5975,Bug
Rust,264,5383,433.79469907407406,MERGED,4,6,1,0,1,121,True,0,0,0,1540,10,5.649166666666667,Bug
Go,421,1654,1543.961886574074,MERGED,6,47,6,0,1,102,False,0,0,0,3110,53,2.1727777777777777,Document
Go,421,1654,1543.9608217592593,MERGED,6,62,5,0,2,101,False,0,0,0,2848,68,2.1911111111111112,Document
Go,421,1654,1543.960173611111,MERGED,9,67,6,0,2,100,False,0,0,0,3025,76,2.2094444444444443,Document
TypeScript,202,107,1179.0453819444444,MERGED,118,110,1,3,3,256,True,0,3,3,2252,228,179.57805555555555,Document
TypeScript,202,107,1179.0265277777778,MERGED,79,17,2,4,3,254,True,0,4,3,2229,96,180.0675,Document
TypeScript,202,107,1178.9371064814816,MERGED,15,14,1,3,1,249,True,0,3,3,2090,29,182.58277777777778,Document
TypeScript,202,107,1178.9287268518517,MERGED,46,17,1,3,1,247,True,0,3,3,2283,63,182.8,Document
TypeScript,15,34,524.6700347222222,MERGED,6,46,5,0,3,999,False,0,0,0,275,52,1.9052777777777778,Feature
TypeScript,15,34,524.6692824074074,MERGED,11,7,8,0,2,998,False,0,0,0,450,18,0.8941666666666667,Feature
Go,421,1654,1543.1848032407406,MERGED,6,22,2,0,1,12,False,0,0,0,2805,28,22.91,Bug
TypeScript,15,34,524.581712962963,CLOSED,1,1,1,0,2,53,False,0,0,0,313,2,2.9175,Document
TypeScript,307,2556,571.8905208333333,MERGED,0,6,1,0,1,20,True,0,0,0,1042,6,13.36888888888889,Bug
TypeScript,261,3765,706.6347800925927,MERGED,3,10,3,0,3,218,False,0,0,0,2458,13,0.7325,Document
Go,421,1654,1543.154537037037,MERGED,33,47,8,0,1,455,True,0,0,0,2551,80,18.538888888888888,Bug
TypeScript,261,3765,706.5178587962963,MERGED,24,68,2,0,1,928,True,0,0,0,2481,92,0.13416666666666666,Document
TypeScript,261,3765,706.4864004629629,MERGED,9,14,2,0,1,217,False,0,0,0,2262,23,0.8827777777777778,Document
Go,395,660,1300.119525462963,MERGED,12,4,1,0,1,128,False,0,0,0,286,16,0.08972222222222222,Feature
TypeScript,202,107,1174.9055902777777,MERGED,54,58,2,5,7,3,False,1,4,3,1710,112,90.84555555555555,Bug
Python,137,75,720.0748958333334,MERGED,0,170,7,0,8,24,False,0,0,0,1071,170,883.1244444444444,Bug
Rust,264,5383,438.07285879629626,MERGED,37,32,3,1,1,74,False,0,1,1,2461,69,0.7544444444444445,Feature
Python,547,7160,2268.3996064814814,MERGED,30,70,11,0,5,620,True,0,0,0,997,100,72.46861111111112,Bug
Vue,10806,21162,1054.2557291666667,CLOSED,1,21,1,2,1,0,False,1,1,1,1523,22,36.344722222222224,Bug
TypeScript,15,34,523.6756481481482,MERGED,5,0,1,0,1,995,False,0,0,0,281,5,2.000277777777778,Bug
V,2097,34362,1583.6164930555553,MERGED,1,27,3,0,3,217,True,0,0,0,1462,28,23.308055555555555,Document
TypeScript,15,34,523.6314236111111,MERGED,10,21,3,0,3,338,False,0,0,0,326,31,0.1511111111111111,Document
JavaScript,9664,43889,3691.9377430555555,MERGED,3,3,1,0,4,58,True,0,0,0,378,6,23.60388888888889,Feature
TypeScript,2070,16640,1277.196087962963,MERGED,1,1,1,0,1,3,False,0,0,0,2180,2,358.23083333333335,Bug
TypeScript,2070,16640,1277.1215277777778,MERGED,1,2,1,0,1,2,False,0,0,0,2134,3,360.0677777777778,Bug
TypeScript,202,107,1174.0216203703703,MERGED,50,30,2,3,4,237,True,0,3,3,1455,80,90.30277777777778,Document
TypeScript,202,107,1174.010462962963,MERGED,4,4,1,3,3,236,True,0,3,3,1752,8,90.58111111111111,Document
V,2097,34362,1583.4404398148147,MERGED,6,60,3,0,3,224,True,0,0,0,1163,66,11.46888888888889,Bug
JavaScript,9664,43889,3691.8236458333336,MERGED,20,557,11,0,2,319,True,0,0,0,495,577,3.465,Feature
TypeScript,15,34,519.5486342592593,MERGED,1,34,2,0,1,488,True,0,0,0,209,35,2.805277777777778,Feature
JavaScript,9664,43889,3691.139652777778,MERGED,220,282,35,0,1,829,True,0,0,0,898,502,19.219444444444445,Bug
JavaScript,9664,43889,3691.6227199074074,MERGED,7,7,1,1,1,1,False,0,1,1,448,14,4.424166666666666,Feature
Rust,264,5383,436.89797453703704,MERGED,6,6,2,0,1,255,True,0,0,0,1913,12,0.5847222222222223,Bug
TypeScript,12,11,1019.198738425926,CLOSED,45,288,3,0,4,164,False,0,0,0,4642,333,313.61083333333335,Bug
TypeScript,15,34,523.5164583333334,MERGED,50,1003,22,0,22,337,False,0,0,0,465,1053,91.55194444444444,Feature
Go,395,660,1298.2869097222222,MERGED,2,2,2,0,2,121,False,0,0,0,280,4,2.3125,Feature
TypeScript,202,107,1174.742951388889,CLOSED,8,6,2,3,3,7,True,1,2,2,1229,14,6.740555555555556,Document
V,2097,34362,1582.4873032407406,MERGED,1,11,2,0,1,220,True,0,0,0,1227,12,8.835555555555555,Bug
TypeScript,15,34,524.5118865740741,MERGED,36,282,6,0,6,339,False,0,0,0,416,318,3.082222222222222,Feature
TypeScript,15,34,521.7236111111112,MERGED,97,102,8,0,1,990,False,0,0,0,377,199,21.798333333333332,Feature
TypeScript,15,34,520.6540625,MERGED,12,28,4,0,4,336,False,0,0,0,375,40,67.84861111111111,Feature
Rust,264,5383,435.8543402777778,MERGED,1,58,7,3,4,1,False,1,2,1,2836,59,359.1713888888889,Feature
TypeScript,202,107,1174.8028356481482,CLOSED,38,37,2,3,3,2,False,0,3,3,393,75,2.493333333333333,Bug
Rust,264,5383,435.7365972222222,MERGED,9,20,3,0,2,3,False,0,0,0,1923,29,11.100277777777778,Feature
TypeScript,15,34,524.6150115740741,MERGED,0,2,1,0,2,997,False,0,0,0,499,2,0.1413888888888889,Document
Go,54,353,762.8388310185186,MERGED,5,15,2,0,1,44,True,0,0,0,1188,20,0.3219444444444444,Feature
JavaScript,9664,43889,3687.824826388889,MERGED,1,4,1,0,2,631,False,0,0,0,395,5,0.5797222222222222,Feature
TypeScript,149,2900,411.7421527777778,MERGED,1427,3223,181,2,74,118,False,0,2,1,442,4650,0.6733333333333333,Document
Erlang,2054,12122,3829.0795833333336,CLOSED,6,75,4,3,1,483,False,3,0,0,1425,81,864.1783333333333,Document
C#,655,7879,1862.3721990740742,MERGED,20,229,14,6,1,79,False,0,6,3,1738,249,346.1336111111111,Document
TypeScript,15,34,521.5207060185186,MERGED,0,1,1,0,1,989,False,0,0,0,253,1,0.45666666666666667,Feature
TypeScript,15,34,520.7883680555556,MERGED,28,70,17,0,4,988,False,0,0,0,481,98,17.81222222222222,Feature
Go,395,660,1299.1585532407407,MERGED,18,36,3,0,5,105,False,0,0,0,416,54,20.855555555555554,Feature
F#,153,337,2949.7651620370366,MERGED,44,51,6,1,31,25,False,0,1,1,3310,95,13.219444444444445,Bug
TypeScript,202,107,1178.5836689814814,CLOSED,16,28,1,2,1,259,True,0,2,2,2115,44,0.014722222222222222,Document
TypeScript,202,107,1179.0075810185185,MERGED,107,74,1,5,6,252,True,0,5,3,3189,181,349.02416666666664,Document
C++,2234,23696,2388.473553240741,MERGED,247,344,30,1,14,4,False,0,1,1,708,591,120.9975,Feature
PHP,883,2338,1862.8062499999999,CLOSED,2,13,2,4,2,0,False,1,3,3,2629,15,486.2816666666667,Document
Starlark,440,286,524.0064351851852,CLOSED,0,0,1,2,1,71,False,0,2,2,1190,0,0.009722222222222222,Feature
Vue,10806,21162,1053.4638657407406,CLOSED,1,0,1,2,4,0,False,0,2,2,4430,1,522.7633333333333,Bug
PHP,883,2338,1864.3253819444444,CLOSED,3,48,3,2,1,85,False,0,2,2,1847,51,38.19277777777778,Document
TypeScript,307,2556,571.7774189814814,MERGED,54,112,11,3,4,577,True,2,1,1,1471,166,67.84194444444445,Bug
TypeScript,307,2556,572.6492013888889,MERGED,26,11,3,2,2,579,True,1,1,1,1868,37,21.596666666666668,Bug
TypeScript,15,34,519.933599537037,MERGED,11,14,1,0,1,984,False,0,0,0,342,25,0.12694444444444444,Feature
Rust,264,5383,433.9336111111111,CLOSED,0,27,5,0,1,0,False,0,0,0,2133,27,0.7763888888888889,Bug
TypeScript,2147,14723,1507.1379398148147,MERGED,55,118,7,0,5,42,False,0,0,0,3315,173,1.1530555555555555,Bug
TypeScript,2147,14723,1507.0665393518518,CLOSED,55,114,7,0,4,41,False,0,0,0,3568,169,1.7025,Feature
TypeScript,15,34,522.0610069444444,MERGED,17,20,1,0,1,991,False,0,0,0,497,37,13.6975,Feature
JavaScript,9664,43889,3692.0464930555554,MERGED,4,5,36,0,1,257,True,0,0,0,468,9,21.913333333333334,Feature
TypeScript,41369,87413,2971.611875,MERGED,1,1,1,2,2,23,False,0,2,2,1893,2,20.613333333333333,Document
TypeScript,261,3765,710.8523958333334,MERGED,1361,762,34,1,9,107,True,0,1,1,4650,2123,16.815555555555555,Document
JavaScript,9664,43889,3692.124502314815,MERGED,15,68,2,0,1,260,True,0,0,0,551,83,0.6472222222222223,Feature
TypeScript,12,11,1019.1855324074073,CLOSED,896,327,32,0,10,110,False,0,0,0,3944,1223,143.95361111111112,Bug
JavaScript,9664,43889,3692.0588657407407,MERGED,51,34,1,0,1,258,True,0,0,0,499,85,0.21611111111111111,Feature
TypeScript,307,2556,571.7539236111111,MERGED,11,30,1,2,1,306,True,1,1,1,1389,41,16.68111111111111,Feature
JavaScript,9664,43889,3691.8830902777777,MERGED,5,13,1,0,2,633,False,0,0,0,642,18,2.296666666666667,Bug
TypeScript,41369,87413,2971.510081018518,MERGED,2,2,2,0,4,0,False,0,0,0,2093,4,7.511666666666667,Document
TypeScript,261,3765,710.7575462962964,MERGED,68,100,10,0,4,113,False,0,0,0,3635,168,0.5444444444444444,Document
TypeScript,261,3765,710.6847569444444,MERGED,102,102,10,0,7,939,True,0,0,0,3644,204,1.4341666666666666,Document
TypeScript,58,78,851.299988425926,CLOSED,15951,565,133,1,6,208,True,0,1,1,4041,16516,72.76527777777778,Feature
TypeScript,58,78,851.2921990740741,CLOSED,65,407,10,1,4,207,True,0,1,1,4073,472,72.95388888888888,Bug
Python,19248,70258,2491.689826388889,CLOSED,2,3,1,0,1,1611,False,0,0,0,479,5,4.895277777777777,Feature
TypeScript,1297,21107,447.32601851851854,MERGED,2,2,1,1,5,1,False,0,1,1,1660,4,6.275,Document
TypeScript,41369,87413,2970.770046296296,CLOSED,0,1,1,1,1,2,False,1,0,0,2155,1,16.404444444444444,Document
TypeScript,15,34,524.4839467592593,MERGED,13,75,6,0,3,491,True,0,0,0,565,88,36.39361111111111,Feature
TypeScript,261,3765,709.6480208333334,MERGED,68,94,13,0,8,624,True,0,0,0,3196,162,24.480833333333333,Document
V,2097,34362,1583.4088310185186,MERGED,4,23,4,0,3,223,True,0,0,0,1858,27,27.3825,Bug
TypeScript,41369,87413,2970.7355439814814,CLOSED,0,1,1,0,1,0,False,0,0,0,2087,1,0.07666666666666666,Document
TypeScript,15,34,520.6420370370371,MERGED,13,9,3,0,2,987,False,0,0,0,440,22,1.8822222222222222,Feature
TypeScript,261,3765,709.6966203703704,MERGED,51,134,12,0,1,933,True,0,0,0,4414,185,0.5155555555555555,Document
TypeScript,261,3765,709.5193402777778,MERGED,26,34,3,0,3,263,True,0,0,0,4259,60,7.689166666666667,Document
TypeScript,2070,16640,1277.4088310185186,MERGED,1,1,1,0,1,0,False,0,0,0,2276,2,67.15416666666667,Bug
TypeScript,261,3765,709.5219675925927,MERGED,45,158,17,0,3,931,True,0,0,0,4800,203,0.6547222222222222,Document
TypeScript,85,723,346.201099537037,MERGED,216,344,12,0,9,20,False,0,0,0,4742,560,72.65944444444445,Document
TypeScript,15,34,519.9654513888889,MERGED,35,19,3,0,1,985,False,0,0,0,459,54,3.6147222222222224,Document
Rust,264,5383,437.4756365740741,MERGED,16,49,4,3,8,0,False,1,2,1,3148,65,83.61222222222223,Feature
TypeScript,7,6,678.995462962963,MERGED,38,68,5,0,6,247,False,0,0,0,3233,106,44.73388888888889,Feature
TypeScript,202,107,1174.9774421296295,MERGED,26,28,7,3,4,8,True,1,2,2,2100,54,9.195,Document
TypeScript,41369,87413,2969.763148148148,MERGED,1,2,1,0,1,0,False,0,0,0,2115,3,1.646388888888889,Document
TypeScript,202,107,1178.9983333333332,MERGED,91,32,1,3,1,251,True,0,3,3,3481,123,181.08805555555554,Document
TypeScript,15,34,519.5120949074075,MERGED,11,16,3,0,5,332,False,0,0,0,417,27,3.9005555555555556,Feature
TypeScript,15,34,523.5714351851851,MERGED,1,6,1,0,1,992,False,0,0,0,643,7,0.34305555555555556,Document
JavaScript,22,26,952.8141435185184,MERGED,0,2,1,0,1,12,True,0,0,0,997,2,2.071111111111111,Feature
V,2097,34362,1581.731701388889,MERGED,4,108,3,0,8,218,True,0,0,0,2060,112,393.60805555555555,Bug
JavaScript,9664,43889,3691.350590277778,CLOSED,26,166,22,6,1,0,False,4,2,1,834,192,210.44305555555556,Bug
TypeScript,15,34,519.9007291666667,MERGED,429,1797,49,0,28,334,False,0,0,0,553,2226,156.83444444444444,Feature
C#,655,7879,1859.3397685185184,MERGED,439,813,33,4,29,592,True,2,2,2,2406,1252,1148.9077777777777,Document
TypeScript,261,3765,706.7375115740741,MERGED,40,47,5,0,2,622,True,0,0,0,3839,87,68.89,Document
TypeScript,261,3765,706.695324074074,MERGED,52,57,3,0,5,621,True,0,0,0,3575,109,70.06916666666666,Document
Erlang,2054,12122,3826.1017592592593,MERGED,8,17,2,2,1,79,True,0,2,1,847,25,20.745277777777776,Document
TypeScript,2070,16640,1277.2327893518518,MERGED,1,1,1,0,1,0,False,0,0,0,2349,2,3.203888888888889,Document
Rust,264,5383,437.89589120370374,MERGED,10,94,3,0,2,257,True,0,0,0,2868,104,1.103611111111111,Bug
TypeScript,17,33,748.8654629629629,MERGED,58,102,6,1,1,48,False,0,1,1,440,160,21.164722222222224,Feature
JavaScript,5139,7050,1237.0350810185184,MERGED,33,484,13,4,20,88,False,2,2,2,4139,517,180.03555555555556,Feature
Kotlin,164,4296,438.6636689814815,MERGED,25,164,9,0,6,22,False,0,0,0,991,189,30.988333333333333,Feature
Go,421,1654,1543.9420138888888,CLOSED,11,99,7,0,3,98,False,0,0,0,4466,110,0.002777777777777778,Document
Erlang,2054,12122,3825.450173611111,MERGED,160,611,23,0,9,136,False,0,0,0,1114,771,759.6088888888889,Document
Rust,264,5383,437.0384143518518,MERGED,167,166,16,0,1,173,False,0,0,0,3227,333,0.5958333333333333,Feature
Python,2407,12183,270.44395833333334,MERGED,2,8,1,2,1,2,False,1,1,1,2387,10,6.008611111111111,Document
Erlang,2054,12122,3830.1840046296297,MERGED,7,18,3,0,1,138,False,0,0,0,979,25,501.9888888888889,Document
TypeScript,261,3765,706.5344328703704,MERGED,64,101,12,0,1,185,False,0,0,0,3942,165,0.3075,Document
Python,137,75,717.9109374999999,MERGED,0,82,5,0,7,5,False,0,0,0,1646,82,540.1208333333333,Bug
JavaScript,5139,7050,1233.8460648148148,MERGED,60,791,12,5,10,97,False,2,3,2,3819,851,258.2322222222222,Feature
Go,421,1654,1540.0516898148146,MERGED,9,99,7,1,2,96,False,0,1,1,4382,108,91.61833333333334,Document
JavaScript,5139,7050,1237.2761689814815,MERGED,42,106,10,3,15,59,False,1,2,2,4218,148,61.729166666666664,Feature
TypeScript,3393,2334,1002.2324884259259,MERGED,1,836,3,2,5,475,False,0,2,1,932,837,15.095833333333333,Feature
Erlang,2054,12122,3828.9846875000003,MERGED,1,1,1,0,1,137,False,0,0,0,808,2,0.07083333333333333,Document
TypeScript,15,34,520.3794328703704,MERGED,75,24,3,0,2,335,False,0,0,0,597,99,0.7952777777777778,Feature
TypeScript,3393,2334,1001.6517708333334,MERGED,5,5,1,2,1,0,False,0,2,1,1121,10,4.7625,Bug
JavaScript,9664,43889,3692.116631944444,CLOSED,43,8,6,1,1,259,True,1,0,0,813,51,25.656666666666666,Feature
TypeScript,15,34,520.0861689814815,MERGED,1,4,1,0,1,986,False,0,0,0,675,5,0.5055555555555555,Document
TypeScript,3393,2334,1000.6538541666667,MERGED,1,9,2,2,1,0,False,0,2,1,1013,10,3.053611111111111,Bug
C#,80,125,854.4189699074074,MERGED,39,1188,10,0,5,220,False,0,0,0,729,1227,30.215,Document
TypeScript,1297,21107,449.0457523148148,MERGED,0,85,9,5,7,43,False,3,2,2,2406,85,35.424166666666665,Document
TypeScript,4,33,797.2794675925926,MERGED,0,6,1,3,1,633,True,2,1,1,1004,6,0.08222222222222222,Feature
TypeScript,15,34,519.5341435185186,MERGED,0,3,2,0,1,981,False,0,0,0,765,3,1.9719444444444445,Bug
PHP,883,2338,1864.96375,CLOSED,6,6,2,2,4,68,False,0,2,2,2319,12,19.430555555555557,Document
Java,450,746,4103.304282407407,MERGED,60,522,29,2,28,7,False,0,2,1,966,582,162.46083333333334,Feature
TypeScript,4,33,796.2997222222222,MERGED,67,74,8,2,8,631,True,1,1,1,776,141,20.502222222222223,Feature
V,2097,34362,1585.5055208333333,MERGED,7,70,5,0,5,226,True,0,0,0,3104,77,14.777777777777779,Bug
TypeScript,3393,2334,1001.1747222222222,MERGED,1,1,1,1,1,133,False,0,1,1,1020,2,0.03027777777777778,Feature
TypeScript,0,0,184.9299074074074,MERGED,0,19,1,0,2,11,False,0,0,0,1016,19,0.04388888888888889,Document
Rust,264,5383,433.9813657407407,MERGED,5,48,8,2,2,253,True,1,1,1,3255,53,0.6233333333333333,Feature
Rust,264,5383,433.9464699074074,MERGED,6,85,10,0,2,172,False,0,0,0,2433,91,2.147777777777778,Bug
Vue,10806,21162,1056.1544444444444,CLOSED,12,30,1,2,5,1,False,1,1,1,2896,42,5.852222222222222,Bug
JavaScript,9664,43889,3691.066539351852,MERGED,9,14,2,0,1,256,True,0,0,0,808,23,0.31916666666666665,Feature
JavaScript,5139,7050,1234.6606712962964,MERGED,52,76,48,1,4,87,False,0,1,1,3558,128,94.22694444444444,Bug
Go,395,660,1298.4307291666667,MERGED,0,16,2,0,3,122,False,0,0,0,1047,16,9.869166666666667,Feature
V,2097,34362,1584.3636921296295,MERGED,23,42,2,1,3,1,False,1,0,0,2644,65,22.884722222222223,Document
TypeScript,41369,87413,2971.6372569444447,MERGED,3,3,3,2,2,8,False,1,1,1,3087,6,0.8419444444444445,Document
C#,655,7879,1859.3390277777778,CLOSED,59,126,7,1,2,591,True,1,0,0,2430,185,925.3663888888889,Document
TypeScript,41369,87413,2971.4562847222223,CLOSED,0,4,2,0,1,3,False,0,0,0,2603,4,4.829722222222222,Document
TypeScript,41369,87413,2971.5253703703706,MERGED,0,3,1,0,2,1924,True,0,0,0,2207,3,0.6869444444444445,Document
TypeScript,41369,87413,2971.457071759259,MERGED,11,22,2,0,2,451,True,0,0,0,2475,33,1.2075,Document
Vue,293,495,860.1033333333334,MERGED,48,110,5,7,5,314,True,2,5,3,1969,158,63.80638888888889,Bug
TypeScript,1297,21107,447.7583912037037,MERGED,1,19,2,1,1,1044,True,0,1,1,3075,20,0.010555555555555556,Document
TypeScript,1297,21107,447.75336805555554,MERGED,6,46,4,1,2,1043,True,0,1,1,3101,52,0.034166666666666665,Document
TypeScript,307,2556,568.713275462963,MERGED,28,29,4,0,2,576,True,0,0,0,2654,57,141.33166666666668,Bug
TypeScript,1297,21107,447.60901620370373,MERGED,83,95,23,1,3,1042,True,0,1,1,3051,178,3.359722222222222,Document
TypeScript,1297,21107,447.5917476851852,MERGED,18,15,3,1,2,1041,True,0,1,1,2858,33,0.08833333333333333,Document
TypeScript,15,34,523.6962731481482,MERGED,11,3,3,0,2,996,False,0,0,0,755,14,1.5075,Bug
C#,80,125,854.4535648148149,MERGED,3219,33057,225,1,178,184,False,1,0,0,1270,36276,414.91833333333335,Document
TypeScript,149,2900,411.0616898148148,MERGED,1,1,1,1,1,117,False,0,1,1,743,2,0.05388888888888889,Feature
TypeScript,202,107,1174.0562962962963,MERGED,178,187,2,3,4,240,True,0,3,3,3576,365,89.41527777777777,Document
TypeScript,41369,87413,2970.756238425926,CLOSED,0,1,1,3,1,1,False,2,1,1,2198,1,0.37222222222222223,Document
TypeScript,41369,87413,2970.756736111111,MERGED,1,1,1,0,1,7,False,0,0,0,2173,2,0.20777777777777778,Document
TypeScript,1297,21107,447.09916666666663,MERGED,23,46,6,1,2,1039,True,0,1,1,2609,69,0.13527777777777777,Document
Erlang,2054,12122,3826.3407291666667,CLOSED,0,2,1,0,1,380,False,0,0,0,1587,2,838.5597222222223,Document
TypeScript,41369,87413,2969.875520833333,MERGED,0,2,1,0,1,113,True,0,0,0,2501,2,13.416944444444445,Document
TypeScript,41369,87413,2969.4421759259258,MERGED,0,13,2,4,3,110,True,2,2,2,2236,13,24.14,Document
TypeScript,12,11,1023.2271412037038,MERGED,95,1759,7,2,13,50,False,2,0,0,5435,1854,191.73,Feature
C#,80,125,850.812164351852,MERGED,1,1,1,0,2,201,True,0,0,0,758,2,2.6341666666666668,Document
TypeScript,261,3765,706.5002199074074,MERGED,94,90,2,0,3,40,False,0,0,0,6734,184,436.75916666666666,Document
Go,1835,11245,1759.3356712962961,MERGED,171,199,6,0,2,7,False,0,0,0,1861,370,42.06,Document
TypeScript,3706,54076,1387.0899884259259,MERGED,67,48,3,0,3,40,True,0,0,0,2644,115,1319.9841666666666,Bug
Go,1835,11245,1761.921111111111,MERGED,57,30,10,0,1,26,True,0,0,0,1820,87,14.754444444444445,Document
TypeScript,41369,87413,2967.7883333333334,CLOSED,2,0,2,2,1,78,True,1,1,1,2300,2,0.14055555555555554,Document
Erlang,2054,12122,3829.139571759259,MERGED,1,2,2,2,1,382,False,0,2,1,1165,3,2.5325,Document
TypeScript,184,377,1945.098449074074,MERGED,44,39,2,1,5,38,False,1,0,0,1372,83,96.69194444444445,Bug
TypeScript,41369,87413,2967.644791666667,MERGED,3,6,1,0,2,109,True,0,0,0,2432,9,1.3994444444444445,Document
Erlang,2054,12122,3829.917650462963,MERGED,1,2,2,2,2,377,True,0,2,1,1113,3,17.963333333333335,Document
Erlang,2054,12122,3829.2861805555553,MERGED,22,100,7,2,3,168,False,0,2,1,1328,122,45.94583333333333,Document
Erlang,2054,12122,3830.2822685185183,MERGED,3,7,2,2,1,386,False,0,2,1,1313,10,7.62,Document
Erlang,2054,12122,3828.8837500000004,MERGED,0,4,2,2,2,375,True,0,2,1,1119,4,2.8275,Document
Erlang,2054,12122,3830.169409722222,MERGED,13,100,4,2,1,385,False,0,2,1,1450,113,10.345833333333333,Document
Erlang,2054,12122,3829.6189699074075,MERGED,14,170,5,3,1,18,False,1,2,1,1435,184,40.713055555555556,Document
TypeScript,178,1359,356.2556597222222,MERGED,13,74,7,1,2,25,True,0,1,1,5451,87,15.763333333333334,Feature
Erlang,2054,12122,3826.1868055555556,MERGED,21,64,4,2,1,1032,True,0,2,1,1437,85,52.824444444444445,Document
TypeScript,202,107,1178.9033912037037,MERGED,84,61,1,4,3,246,True,0,4,3,3761,145,183.41805555555555,Document
TypeScript,178,1359,356.05368055555556,MERGED,98,120,4,1,2,24,True,0,1,1,7440,218,0.4452777777777778,Bug
Erlang,2054,12122,3826.360300925926,MERGED,61,133,9,2,2,20,False,0,2,1,1348,194,1.3280555555555555,Document
Go,395,660,1300.148449074074,MERGED,180,600,29,0,35,106,False,0,0,0,1032,780,236.5313888888889,Bug
TypeScript,85,723,350.04791666666665,MERGED,1829,8924,220,0,31,99,False,0,0,0,7567,10753,24.96527777777778,Document
Erlang,2054,12122,3826.141203703704,MERGED,7,19,4,2,1,80,True,0,2,1,1029,26,19.8225,Document
TypeScript,12,11,1023.1155208333333,MERGED,19,102,8,0,45,43,False,0,0,0,7497,121,2.523888888888889,Feature
Erlang,2054,12122,3829.2219791666666,MERGED,3,36,5,0,2,52,False,0,0,0,1025,39,109.8875,Document
Erlang,2054,12122,3825.736226851852,MERGED,2,7,3,2,2,374,True,0,2,1,1156,9,1.9719444444444445,Document
TypeScript,12,11,1022.4336689814814,MERGED,125,192,5,0,4,113,False,0,0,0,5813,317,26.593055555555555,Bug
TypeScript,4,33,796.1719097222222,MERGED,1,13,1,2,1,630,True,1,1,1,1256,14,169.00055555555556,Feature
TypeScript,85,723,350.0757523148148,MERGED,5,2031,21,0,3,23,False,0,0,0,7441,2036,1.4847222222222223,Document
TypeScript,41369,87413,2969.872546296296,CLOSED,1,20,2,0,1,112,True,0,0,0,3675,21,0.20833333333333334,Document
TypeScript,2147,14723,1506.9790624999998,MERGED,7,106,16,0,1,40,False,0,0,0,6689,113,0.7683333333333333,Bug
Erlang,2054,12122,3829.3425578703705,MERGED,28,104,6,2,2,384,False,0,2,1,1363,132,2.631666666666667,Document
Erlang,2054,12122,3830.1604050925926,MERGED,56,204,5,0,3,81,True,0,0,0,1204,260,21.368055555555557,Document
C#,80,125,853.3815046296296,CLOSED,1837,8347,71,1,43,219,False,1,0,0,1273,10184,174.67777777777778,Document
Erlang,2054,12122,3829.9957986111112,MERGED,82,92,4,0,3,404,True,0,0,0,1175,174,16.775555555555556,Document
TypeScript,4,33,797.3213310185184,MERGED,162,552,40,1,33,383,False,0,1,1,1482,714,67.83222222222223,Document
Rust,264,5383,437.6782638888889,CLOSED,4721,62223,1735,2,12,5,False,1,1,1,4473,66944,1.8511111111111112,Document
Erlang,2054,12122,3829.7377546296298,MERGED,4,18,5,0,1,402,True,0,0,0,1366,22,4.836666666666667,Document
Erlang,2054,12122,3826.4399305555557,MERGED,0,79,3,0,1,17,False,0,0,0,1228,79,160.27583333333334,Document
TypeScript,261,3765,710.7907523148148,MERGED,220,174,17,0,5,942,True,0,0,0,7781,394,4.294444444444444,Document
Starlark,440,286,524.0435069444444,MERGED,1,1,1,1,1,129,True,0,1,1,1437,2,0.11972222222222222,Bug
Starlark,440,286,523.9997916666667,MERGED,2,2,2,2,1,2,False,0,2,1,1179,4,0.8352777777777778,Bug
C++,2234,23696,2390.8631828703706,MERGED,0,2,1,0,2,331,False,0,0,0,1146,2,2.3222222222222224,Bug
TypeScript,3393,2334,1000.9975578703703,MERGED,32,13,3,2,3,471,False,0,2,1,2289,45,1007.685,Feature
TypeScript,261,3765,710.7401504629629,MERGED,52,34,9,0,3,940,True,0,0,0,7069,86,0.7247222222222223,Document
Starlark,440,286,523.2964930555555,MERGED,14,31,1,2,1,68,False,0,2,1,1545,45,16.045,Bug
C#,655,7879,1863.092326388889,CLOSED,27,133,4,2,1,16,False,2,0,0,1803,160,7.445277777777778,Document
Erlang,2054,12122,3826.211365740741,MERGED,3,4,2,2,1,16,False,0,2,1,1284,7,3.2983333333333333,Document
Erlang,2054,12122,3829.2498148148147,MERGED,2,2,1,0,1,401,True,0,0,0,1099,4,0.28444444444444444,Document
Erlang,2054,12122,3826.1682638888888,MERGED,7,57,2,2,3,51,False,0,2,1,977,64,4.973333333333334,Document
TypeScript,261,3765,709.9254861111111,MERGED,23,23,4,0,1,265,True,0,0,0,6881,46,14.982777777777779,Document
TypeScript,1297,21107,451.1654398148148,MERGED,23,60,12,1,4,4,False,0,1,1,4223,83,10.952222222222222,Document
Starlark,440,286,522.6073611111111,CLOSED,2,5,1,2,1,67,False,0,2,1,1376,7,16.468611111111112,Bug
Erlang,2054,12122,3828.982349537037,MERGED,1,1,1,0,1,23,True,0,0,0,1076,2,0.14166666666666666,Document
Erlang,2054,12122,3828.935034722222,MERGED,4,5,5,0,2,376,True,0,0,0,1194,9,0.97,Document
Erlang,2054,12122,3828.872997685185,MERGED,11,10,1,0,1,167,False,0,0,0,1157,21,2.779166666666667,Document
Erlang,2054,12122,3825.2714699074077,MERGED,57,103,9,2,5,1030,True,0,2,1,1284,160,10.294444444444444,Document
TypeScript,4,33,797.1022916666667,MERGED,1,5,1,4,1,236,True,3,1,1,1065,6,0.41638888888888886,Bug
TypeScript,261,3765,709.73875,MERGED,50,57,13,0,9,625,True,0,0,0,6847,107,3.5033333333333334,Document
TypeScript,3393,2334,1001.6580208333334,MERGED,7,7,1,2,1,0,False,0,2,1,1380,14,3.3941666666666666,Feature
TypeScript,4,33,796.4660185185185,MERGED,7,21,1,3,1,632,True,2,1,1,1374,28,27.428333333333335,Document
TypeScript,1297,21107,450.80245370370375,MERGED,15,37,9,1,5,44,False,0,1,1,4359,52,2.8241666666666667,Document
Erlang,2054,12122,3828.2036111111115,MERGED,2,2,2,0,1,400,True,0,0,0,1437,4,16.93027777777778,Document
Python,547,7160,2267.7984953703703,MERGED,1,40,2,2,14,2,False,1,1,1,1138,41,191.9922222222222,Feature
TypeScript,4,33,796.1449421296296,MERGED,0,8,1,2,1,628,True,1,1,1,1200,8,22.708055555555557,Feature
TypeScript,3393,2334,1001.9162037037037,MERGED,2,2,2,2,1,474,False,0,2,1,1397,4,0.0725,Document
Erlang,2054,12122,3828.0019907407404,MERGED,11,26,4,0,1,502,True,0,0,0,1255,37,4.313611111111111,Document
Erlang,2054,12122,3828.006701388889,MERGED,4,16,2,0,1,399,True,0,0,0,1371,20,4.108333333333333,Document
JavaScript,34,25,232.30142361111112,MERGED,2,2,2,0,1,35,False,0,0,0,1530,4,0.09694444444444444,Bug
TypeScript,4,33,796.2873032407407,MERGED,3,4,3,1,2,382,False,0,1,1,1523,7,0.47555555555555556,Document
Erlang,2054,12122,3827.871539351852,MERGED,1,1,1,0,1,22,True,0,0,0,1076,2,0.13583333333333333,Document
C#,655,7879,1859.0126388888891,MERGED,42,450,27,6,15,68,True,0,6,1,1459,492,126.16,Document
Go,421,1654,1541.131574074074,MERGED,54,1227,7,1,2,15,False,0,1,1,5296,1281,139.53,Document
Erlang,2054,12122,3826.0686111111113,MERGED,20,15,1,0,1,19,False,0,0,0,1451,35,74.66527777777777,Document
Erlang,2054,12122,3827.0617129629627,MERGED,3,3,1,0,1,397,True,0,0,0,1125,6,21.83972222222222,Document
Starlark,440,286,521.4813310185185,MERGED,1,1,1,2,1,28,False,0,2,1,1014,2,9.083055555555555,Document
TypeScript,261,3765,706.49125,MERGED,42,42,4,0,14,218,True,0,0,0,7671,84,98.56444444444445,Document
Starlark,440,286,521.4191203703704,MERGED,30,8,1,3,1,1,False,0,3,2,1746,38,10.791666666666666,Bug
TypeScript,4,33,793.2721412037037,MERGED,9,72,6,2,9,232,True,1,1,1,1653,81,118.89166666666667,Feature
TypeScript,3393,2334,1001.1392939814815,MERGED,25,34,3,2,3,473,False,0,2,1,1211,59,0.6308333333333334,Feature
TypeScript,3393,2334,1001.1216087962963,MERGED,1,1,1,2,1,472,False,0,2,1,1119,2,0.2613888888888889,Bug
TypeScript,4,33,797.2390856481483,MERGED,199,484,12,3,17,3,True,1,2,2,1791,683,315.75166666666667,Document
Erlang,2054,12122,3825.2424768518517,MERGED,68,563,23,0,12,395,True,0,0,0,1461,631,89.41,Document
C#,655,7879,1859.0550231481482,MERGED,0,113,4,1,4,246,True,0,1,1,1491,113,89.67861111111111,Document
TypeScript,41369,87413,2970.796423611111,MERGED,12,550,6,24,23,1,False,11,13,2,3231,562,91.33277777777778,Document
TypeScript,307,2556,572.6107523148148,MERGED,242,281,65,0,4,578,True,0,0,0,4303,523,0.17777777777777778,Bug
Starlark,440,286,520.8548148148149,MERGED,1,1,1,2,1,13,False,0,2,1,1020,2,0.09472222222222222,Bug
Go,1835,11245,1762.7327199074073,MERGED,1,1,7,0,1,18,False,0,0,0,1918,2,1.2236111111111112,Document
TypeScript,41369,87413,2971.6404861111114,MERGED,13,102,4,0,12,115,True,0,0,0,3384,115,31.621944444444445,Document
TypeScript,4,33,793.2024074074075,MERGED,40,124,12,2,8,625,True,1,1,1,1413,164,78.34833333333333,Feature
TypeScript,1297,21107,448.7597685185185,MERGED,61,94,3,1,2,1050,True,0,1,1,3185,155,0.0325,Document
Erlang,2054,12122,3826.294108796296,MERGED,1,1,1,0,1,379,False,0,0,0,1093,2,1.1263888888888889,Document
Erlang,2054,12122,3826.2715625,MERGED,2,4,2,0,1,378,False,0,0,0,1227,6,1.2222222222222223,Document
C#,655,7879,1858.396064814815,MERGED,1,72,6,1,1,87,False,0,1,1,1596,73,86.37194444444444,Document
Erlang,2054,12122,3826.103333333333,MERGED,28,16,9,0,3,377,False,0,0,0,1557,44,2.605277777777778,Document
TypeScript,1297,21107,448.17949074074073,MERGED,31,1,7,5,6,2,False,3,2,2,4289,32,15.878333333333334,Document
Erlang,2054,12122,3825.8820023148146,MERGED,0,6,1,0,1,1031,True,0,0,0,1026,6,5.833888888888889,Document
Python,2407,12183,270.6949305555556,MERGED,1,1,1,0,1,312,True,0,0,0,1234,2,0.010277777777777778,Document
Erlang,2054,12122,3825.4959490740744,MERGED,754,659,57,0,7,75,False,0,0,0,1473,1413,17.005555555555556,Document
Erlang,2054,12122,3825.8365625,MERGED,1,2,1,0,1,396,True,0,0,0,1137,3,0.3575,Document
TypeScript,41369,87413,2971.491863425926,MERGED,12,12,2,1,2,602,True,0,1,1,4082,24,1.7561111111111112,Document
TypeScript,4,33,796.1174884259259,MERGED,2,83,3,1,3,0,False,0,1,1,1753,85,294.6122222222222,Bug
C#,80,125,850.5978472222222,MERGED,69760,5967,615,0,15,218,False,0,0,0,1289,75727,73.79083333333334,Document
TypeScript,3393,2334,999.4098148148149,CLOSED,31876,31804,330,2,35,0,False,0,2,1,1427,63680,0.04027777777777778,Document
TypeScript,202,107,1173.9960185185184,MERGED,135,68,6,4,12,235,True,0,4,3,3706,203,112.64222222222222,Document
TypeScript,1297,21107,447.77464120370365,MERGED,28,33,9,1,2,1045,True,0,1,1,3817,61,0.01361111111111111,Document
C#,655,7879,1859.1105902777779,CLOSED,53,149,11,1,89,0,False,0,1,1,1567,202,4.346666666666667,Document
Python,2407,12183,269.90550925925925,MERGED,1,0,1,2,1,0,False,1,1,1,1134,1,2.886388888888889,Bug
Erlang,2054,12122,3829.838414351852,MERGED,11,40,4,2,2,504,True,0,2,1,1591,51,5.054166666666666,Document
Erlang,2054,12122,3829.9067824074077,MERGED,279,305,7,2,2,403,True,0,2,1,1601,584,18.11916666666667,Document
Python,2407,12183,269.87868055555555,MERGED,6,8,2,0,2,311,True,0,0,0,1855,14,3.0841666666666665,Bug
TypeScript,3393,2334,998.9362152777777,CLOSED,1,1,1,3,1,275,False,0,3,2,1834,2,1.0358333333333334,Feature
C#,655,7879,1863.256585648148,CLOSED,31,145,11,3,3,17,False,1,2,1,2180,176,186.91916666666665,Document
TypeScript,4,33,793.5309722222222,MERGED,3,10,2,3,1,627,True,2,1,1,1712,13,0.1913888888888889,Bug
TypeScript,4,33,793.3947685185185,MERGED,4,36,4,1,3,381,False,0,1,1,1413,40,0.115,Bug
Go,1835,11245,1762.7049189814816,MERGED,15,7,2,1,5,95,False,1,0,0,1660,22,8.306944444444444,Feature
Go,1835,11245,1762.7092939814813,MERGED,1,41,1,0,1,96,False,0,0,0,1326,42,0.5494444444444444,Feature
Java,450,746,4102.226226851852,MERGED,34,159,12,2,15,34,False,0,2,2,4879,193,90.79944444444445,Feature
TypeScript,307,2556,568.4407407407408,MERGED,66,99,3,4,2,575,True,0,4,2,4620,165,99.9336111111111,Bug
JavaScript,9664,43889,3687.821388888889,MERGED,30,31,3,0,1,318,True,0,0,0,988,61,0.8030555555555555,Feature
TypeScript,41369,87413,2969.8541550925925,MERGED,0,26,2,0,3,111,True,0,0,0,3937,26,13.934722222222222,Document
TypeScript,3393,2334,998.0536689814816,MERGED,2,0,1,1,1,343,False,0,1,1,1228,2,0.3988888888888889,Feature
TypeScript,41369,87413,2969.763599537037,MERGED,13,30,2,0,1,0,False,0,0,0,3563,43,16.338333333333335,Document
Erlang,2054,12122,3828.875150462963,CLOSED,149,318,6,2,4,503,True,0,2,1,1712,467,43.67805555555555,Document
TypeScript,3393,2334,997.8928935185186,MERGED,13,5,6,1,3,721,False,0,1,1,1678,18,1.1641666666666666,Bug
TypeScript,4,33,792.3287731481481,MERGED,200,466,12,4,2,624,True,3,1,1,1349,666,1.7152777777777777,Bug
PHP,1334,2960,4238.235925925926,CLOSED,988765,91053,9319,1,1221,3,False,0,1,1,6362,1079818,0.025833333333333333,Document
TypeScript,41369,87413,2968.6968055555553,CLOSED,9,70,3,1,12,0,False,1,0,0,3707,79,50.174166666666665,Document
TypeScript,4,33,792.2551504629629,MERGED,1,1,1,1,2,379,False,0,1,1,1254,2,0.3963888888888889,Bug
TypeScript,4,33,792.249375,MERGED,50,47,3,2,5,231,True,1,1,1,1360,97,0.22333333333333333,Feature
Erlang,2054,12122,3826.790960648148,MERGED,3,4,2,2,2,501,True,0,2,1,1747,7,5.029444444444445,Document
C#,655,7879,1860.2662152777777,MERGED,24,21,7,2,4,622,True,0,2,1,2140,45,258.75694444444446,Document
JavaScript,34,25,227.4884375,MERGED,0,73,3,0,2,34,False,0,0,0,1475,73,0.09666666666666666,Document
TypeScript,2147,14723,1506.1353819444446,MERGED,1908,2774,81,0,2,178,False,0,0,0,9774,4682,95.175,Bug
C#,655,7879,1859.3383333333334,MERGED,32,59,7,1,7,590,True,0,1,1,2315,91,257.9775,Document
Starlark,440,286,523.4581597222221,MERGED,71,71,1,2,3,29,False,0,2,1,1933,142,80.56861111111111,Bug
Erlang,2054,12122,3829.1244675925923,MERGED,2,14,2,2,1,381,False,0,2,1,1763,16,2.8991666666666664,Document
C#,655,7879,1859.343263888889,MERGED,2126,2347,114,5,44,593,True,1,4,3,2336,4473,239.25055555555556,Document
Go,1835,11245,1762.7739814814815,MERGED,7,7,6,0,1,97,False,0,0,0,1934,14,0.02638888888888889,Bug
Starlark,440,286,521.2886574074074,MERGED,0,420,5,3,2,0,False,1,2,1,1843,420,138.02083333333334,Document
Starlark,440,286,522.2409490740741,MERGED,0,181,2,4,1,0,False,1,3,2,1738,181,115.2611111111111,Feature
JavaScript,34,25,231.14744212962964,MERGED,30,100,7,3,3,11,False,3,0,0,1967,130,137.33638888888888,Feature
Starlark,440,286,523.5942013888889,MERGED,225,546,2,2,2,69,False,0,2,1,1452,771,8.866111111111111,Document
TypeScript,4,33,797.1022337962963,MERGED,122,166,3,3,1,235,True,2,1,1,1811,288,0.26416666666666666,Bug
TypeScript,3393,2334,1001.6223148148148,MERGED,6,16,3,2,1,0,False,0,2,1,2342,22,7.079166666666667,Feature
TypeScript,4,33,797.0252546296297,MERGED,6,6,1,2,1,234,True,1,1,1,1928,12,0.14833333333333334,Bug
TypeScript,1073,11366,1128.951087962963,MERGED,6,8,4,4,5,1,False,1,3,3,1801,14,12.695277777777777,Bug
Python,2407,12183,272.9206134259259,MERGED,0,17,1,0,10,314,True,0,0,0,1851,17,3.026388888888889,Document
Python,2407,12183,272.9649074074074,MERGED,0,2,1,1,1,315,True,1,0,0,1677,2,0.14916666666666667,Document
Go,1835,11245,1762.6181712962962,MERGED,0,225,38,4,7,0,False,0,4,3,1641,225,169.90777777777777,Document
TypeScript,85,723,349.0673032407407,MERGED,41,880,25,0,8,170,False,0,0,0,8430,921,2.0244444444444443,Document
Starlark,440,286,522.1740277777777,MERGED,44,33,4,2,6,2,False,0,2,1,2494,77,116.74944444444445,Feature
TypeScript,261,3765,710.6360185185185,MERGED,419,847,50,0,14,187,False,0,0,0,8088,1266,25.221666666666668,Document
TypeScript,4,33,793.2940393518519,MERGED,76,196,13,3,4,626,True,2,1,1,2056,272,93.09611111111111,Bug
Starlark,440,286,521.027962962963,MERGED,5,10,1,2,1,27,False,0,2,1,1776,15,1.0022222222222221,Bug
C#,655,7879,1859.249722222222,MERGED,357,711,65,2,16,620,True,1,1,1,2450,1068,54.069722222222225,Document
Starlark,440,286,520.759861111111,CLOSED,2,17,2,3,14,1,False,1,2,1,2136,19,0.0425,Bug
C#,655,7879,1859.2548379629632,MERGED,52,2,2,0,5,621,True,0,0,0,2235,54,46.89861111111111,Document
Starlark,440,286,520.1458101851852,MERGED,33,32,1,2,5,1,False,0,2,1,2450,65,17.903055555555557,Feature
Starlark,440,286,519.8368981481482,MERGED,0,207,4,2,2,8,False,0,2,1,1874,207,24.647222222222222,Document
C#,655,7879,1859.3816203703702,CLOSED,3,46,6,0,9,1496,True,0,0,0,2264,49,0.7197222222222223,Document
TypeScript,261,3765,709.5436574074074,MERGED,433,180,79,0,4,186,False,0,0,0,9176,613,2.7116666666666664,Document
Go,1835,11245,1761.9285069444443,CLOSED,0,67,9,2,4,0,False,0,2,2,1909,67,68.90944444444445,Document
Go,1835,11245,1763.1523148148146,MERGED,7,17,5,1,2,173,False,0,1,1,1886,24,0.35583333333333333,Document
C#,655,7879,1858.3411689814814,MERGED,54,63,4,0,5,1493,True,0,0,0,2337,117,15.605277777777777,Document
C#,655,7879,1858.3895486111112,CLOSED,9,49,9,0,9,1494,True,0,0,0,2350,58,5.751111111111111,Document
Python,2407,12183,274.99944444444446,CLOSED,1,14,2,4,6,0,False,3,1,1,3139,15,949.3911111111111,Document
Go,1835,11245,1761.821886574074,MERGED,2,2,2,0,1,25,True,0,0,0,1886,4,0.18888888888888888,Document
JavaScript,34,25,227.4145601851852,MERGED,31,31,1,0,1,82,False,0,0,0,1994,62,0.08694444444444445,Document
JavaScript,0,0,20.927430555555556,CLOSED,13,21,6,0,1,7,False,0,0,0,1788,34,0.4988888888888889,Document
TypeScript,261,3765,706.626087962963,MERGED,53,96,24,0,4,929,True,0,0,0,7685,149,4.183055555555556,Document
TypeScript,3706,54076,1392.1072569444443,MERGED,27,105,8,0,3,41,True,0,0,0,3074,132,218.20888888888888,Bug
TypeScript,7,6,677.8834606481481,MERGED,0,139,3,0,38,24,True,0,0,0,5787,139,102.7575,Feature
TypeScript,202,107,1178.5541087962963,MERGED,262,150,5,4,10,241,True,0,4,3,7094,412,192.08194444444445,Document
JavaScript,22,26,950.1923263888889,CLOSED,89,98,4,1,2,12,True,1,0,0,2779,187,62.37638888888889,Feature
TypeScript,58,78,850.3143518518518,MERGED,255,250,6,1,8,124,False,0,1,1,5979,505,163.3711111111111,Feature
Rust,264,5384,438.03239583333334,MERGED,58,68,3,1,2,258,True,0,1,1,6264,126,1.0030555555555556,Bug
Kotlin,164,4296,438.601875,MERGED,38,145,9,0,5,53,False,0,0,0,2244,183,26.322222222222223,Feature
Starlark,440,286,523.3585185185185,MERGED,0,178,4,2,7,4,False,0,2,1,3069,178,88.46222222222222,Document
C++,2234,23696,2387.9759375,MERGED,14,88,4,1,3,295,False,0,1,1,6742,102,137.58777777777777,Feature
TypeScript,4,33,792.8975347222222,MERGED,59,238,8,1,7,74,False,0,1,1,2616,297,272.7216666666667,Document
Python,14531,41186,1121.3124421296295,CLOSED,4,87,1,1,3,2,False,0,1,1,3332,91,25.906944444444445,Document
Go,54,353,766.631875,MERGED,40,23,9,0,2,228,True,0,0,0,5170,63,1.311388888888889,Bug
Rust,264,5384,433.9815740740741,MERGED,104,361,18,3,2,73,False,1,2,1,6503,465,67.21166666666667,Feature
Python,2407,12183,273.43863425925923,MERGED,1,1,1,1,2,80,True,0,1,1,2116,2,5.404166666666667,Document
V,2097,34362,1585.764398148148,MERGED,95,103,6,0,1,40,True,0,0,0,6952,198,8.53111111111111,Document
Starlark,440,286,522.2851273148148,MERGED,61,100,1,2,1,66,False,0,2,1,2453,161,40.32361111111111,Document
TypeScript,4,33,796.1911574074074,MERGED,19,32,5,2,8,233,True,1,1,1,2696,51,21.308611111111112,Bug
TypeScript,1073,11366,1128.9061689814814,MERGED,3,6,1,2,2,0,False,0,2,2,2006,9,13.95861111111111,Bug
TypeScript,1073,11366,1128.8718055555555,MERGED,5,7,3,0,2,7,True,0,0,0,2824,12,0.5211111111111111,Document
TypeScript,1073,11366,1128.7682291666667,MERGED,3,3,2,0,1,5,True,0,0,0,2246,6,0.03027777777777778,Document
TypeScript,1073,11366,1128.7491666666667,MERGED,6,10,3,0,1,184,False,0,0,0,2926,16,0.06972222222222223,Bug
TypeScript,1073,11366,1128.6031597222222,MERGED,1,2,2,1,1,183,False,0,1,1,2580,3,0.24388888888888888,Bug
Python,72,25,1667.1563657407407,MERGED,29,63,3,0,5,28,False,0,0,0,3340,92,1.9980555555555555,Feature
TypeScript,1073,11366,1127.6624189814816,CLOSED,37,135,6,2,3,180,False,1,1,1,2652,172,3.9205555555555556,Bug
Starlark,440,286,521.2288657407407,MERGED,27,51,1,2,2,65,False,0,2,1,3024,78,15.368333333333334,Bug
TypeScript,140,827,780.0775231481481,MERGED,175,262,7,3,5,51,False,1,2,2,2775,437,49.83583333333333,Feature
TypeScript,41369,87413,2970.608854166667,MERGED,94,60,9,0,14,114,True,0,0,0,5747,154,24.40277777777778,Document
TypeScript,1073,11366,1127.5959837962962,MERGED,24,16,4,1,3,179,False,0,1,1,2535,40,2.776111111111111,Feature
TypeScript,1073,11366,1127.5744791666666,MERGED,0,11,3,1,1,178,False,0,1,1,2406,11,0.4897222222222222,Bug
TypeScript,58,78,850.3531944444444,CLOSED,252,961,25,1,14,97,False,0,1,1,11048,1213,184.99583333333334,Bug
TypeScript,1297,21107,446.85835648148145,MERGED,143,145,12,1,18,1037,True,0,1,1,6016,288,4.578333333333333,Document
TypeScript,149,2900,410.8858333333333,MERGED,12,14,3,1,1,114,False,0,1,1,2893,26,0.30722222222222223,Feature
TypeScript,1297,21107,446.0070949074074,MERGED,11,246,13,1,9,1035,True,0,1,1,5085,257,0.026111111111111113,Document
TypeScript,4,33,792.6732291666667,MERGED,83,204,12,1,4,220,False,0,1,1,2879,287,0.16527777777777777,Bug
Go,1835,11245,1760.1088194444444,MERGED,153,221,10,0,1,8,False,0,0,0,2801,374,115.20694444444445,Document
TypeScript,7,6,678.2233912037037,MERGED,11,1245,23,0,61,278,False,0,0,0,8569,1256,232.87222222222223,Feature
TypeScript,261,3765,710.8496990740741,MERGED,47,88,12,0,2,627,True,0,0,0,12039,135,14.705555555555556,Document
Python,137,75,715.1359027777777,MERGED,0,356,9,0,14,23,False,0,0,0,3892,356,584.0275,Bug
TypeScript,261,3765,709.7899074074074,MERGED,259,238,23,0,1,934,True,0,0,0,12835,497,1.4605555555555556,Document
Python,4516,54989,957.6979166666666,MERGED,1,12,3,1,2,105,True,0,1,1,3873,13,1.6880555555555556,Document
TypeScript,7,6,674.9186805555556,MERGED,8,114,7,0,50,23,True,0,0,0,8647,122,150.08944444444444,Feature
Rust,264,5384,436.8728125,MERGED,0,127,22,0,1,254,True,0,0,0,8272,127,0.8002777777777778,Feature
TypeScript,184,377,1945.1470601851852,MERGED,9,10,2,1,5,39,False,1,0,0,3522,19,91.935,Bug
Java,450,746,4105.937847222222,MERGED,69,370,24,2,10,154,False,0,2,1,10414,439,76.37416666666667,Bug
Python,14531,41186,1121.2221412037036,CLOSED,1,21,2,0,6,0,False,0,0,0,3882,22,169.81,Feature
V,2097,34362,1581.7555555555555,MERGED,10,223,19,9,5,96,True,2,7,3,7715,233,206.06222222222223,Feature
TypeScript,4803,40785,3794.6462847222224,MERGED,25,181,7,1,23,143,True,0,1,1,4087,206,20.002222222222223,Bug
Starlark,440,286,522.1987962962963,MERGED,0,165,3,4,3,0,False,1,3,2,3456,165,116.22027777777778,Feature
TypeScript,41369,87413,2970.8036458333336,MERGED,460,1088,35,1,13,450,True,1,0,0,7917,1548,0.44,Document
Python,2407,12183,274.0322453703704,MERGED,12,22,8,0,7,316,True,0,0,0,3166,34,0.8097222222222222,Document
Starlark,440,286,523.6123611111111,MERGED,73,297,1,2,3,70,False,0,2,1,4515,370,8.418611111111112,Bug
Erlang,2054,12122,3827.629513888889,MERGED,8,84,14,0,2,398,True,0,0,0,3111,92,30.443055555555556,Document
TypeScript,149,2900,412.51122685185186,MERGED,1403,561,13,1,3,188,True,0,1,1,4274,1964,48.01416666666667,Bug
TypeScript,140,827,782.062025462963,MERGED,405,451,3,2,1,52,False,0,2,2,3654,856,5.814444444444445,Feature
Python,4516,54989,958.9095486111111,MERGED,1,81,3,6,13,0,False,4,2,1,3694,82,25.176944444444445,Document
Python,2407,12183,271.76070601851853,MERGED,44,66,12,0,20,313,True,0,0,0,3308,110,31.739444444444445,Document
Python,4516,54989,959.0836226851852,MERGED,1,1,1,6,1,0,False,2,4,2,3456,2,1.6583333333333334,Document
Starlark,440,286,520.1167708333334,MERGED,32,161,1,6,1,1,False,1,5,3,3441,193,92.70166666666667,Feature
Python,4516,54989,957.7208564814815,MERGED,7,19,1,0,3,106,True,0,0,0,4099,26,19.56888888888889,Document
TypeScript,202,107,1174.082037037037,MERGED,12,115,6,11,22,1,False,4,7,4,4528,127,110.62805555555556,Document
Python,137,75,715.2046875,MERGED,2,124,8,0,6,238,False,0,0,0,4679,126,0.5,Document
TypeScript,4,33,793.176875,MERGED,78,117,3,1,2,380,False,0,1,1,3867,195,0.5341666666666667,Feature
TypeScript,4,33,792.328738425926,MERGED,26,30,5,4,1,623,True,3,1,1,3336,56,1.5597222222222222,Document
Go,1835,11245,1758.0749652777777,MERGED,4,12,4,0,1,69,False,0,0,0,3215,16,11.82638888888889,Document
TypeScript,7,6,678.0810300925926,MERGED,121,591,20,0,26,246,False,0,0,0,11217,712,67.27555555555556,Bug
Rust,264,5384,437.1750578703704,MERGED,137,385,16,0,29,351,False,0,0,0,13567,522,38.602777777777774,Document
Python,4516,54989,958.785775462963,CLOSED,12,136,6,16,9,0,False,10,6,2,5393,148,624.7608333333334,Document
TypeScript,41369,87413,2967.5814814814817,MERGED,3603,4414,462,2,18,449,True,1,1,1,13040,8017,3.3852777777777776,Document
Erlang,2054,12122,3826.9920023148147,MERGED,5,12,3,2,1,1033,True,0,2,1,5091,17,23.94527777777778,Document
TypeScript,58,78,851.3631944444445,MERGED,519,3846,30,2,19,176,False,0,2,2,5953,4365,91.61111111111111,Document
C++,2234,23696,2390.863113425926,MERGED,37,52,9,0,2,330,False,0,0,0,5774,89,2.3230555555555554,Feature
TypeScript,184,377,1941.0475925925928,MERGED,9,62,1,1,2,37,False,1,0,0,6600,71,95.43138888888889,Document
TypeScript,4803,40785,3793.65318287037,MERGED,137,98,12,1,15,141,True,0,1,1,8384,235,1.716388888888889,Bug
TypeScript,4803,40785,3793.502048611111,MERGED,174,789,43,1,7,140,True,0,1,1,7918,963,4.378611111111111,Bug
TypeScript,4,33,796.6587731481482,MERGED,593,1367,30,1,1,222,False,0,1,1,5257,1960,0.31055555555555553,Document
TypeScript,1073,11366,1127.7946296296298,MERGED,1,25,1,1,1,182,False,0,1,1,7388,26,1.4530555555555555,Document
C#,655,7879,1859.2583796296296,MERGED,102,95,36,1,25,1495,True,0,1,1,5673,197,45.88361111111111,Document
TypeScript,140,827,778.4352199074074,MERGED,16,179,7,4,14,50,False,1,3,3,5336,195,87.8475,Feature
TypeScript,1073,11366,1124.636886574074,MERGED,7,2466,20,1,5,5,False,1,0,0,7400,2473,76.72,Document
TypeScript,4,33,792.3287152777779,MERGED,32,40,4,2,1,622,True,1,1,1,5553,72,1.1522222222222223,Feature
Python,547,7160,2271.512222222222,MERGED,31,624,11,0,38,28,False,0,0,0,8374,655,98.98972222222223,Document
Rust,591,3260,577.511087962963,MERGED,44,226,12,3,21,62,False,0,3,1,9237,270,286.67527777777775,Document
TypeScript,261,3765,710.6492476851853,MERGED,650,627,30,0,1,938,True,0,0,0,27784,1277,0.4444444444444444,Document
TypeScript,4803,40785,3793.726585648148,MERGED,75,84,14,1,20,142,True,0,1,1,11027,159,21.968333333333334,Bug
TypeScript,140,827,782.2647337962962,MERGED,54,52,5,2,3,54,False,0,2,2,7468,106,18.252777777777776,Feature
TypeScript,4803,40785,3793.449247685185,MERGED,144,461,14,1,5,139,True,0,1,1,8077,605,0.8897222222222222,Document
TypeScript,4,33,796.171875,MERGED,24,25,18,2,2,629,True,1,1,1,7904,49,28.54361111111111,Document
Java,450,746,4102.993356481481,MERGED,69,1170,24,2,57,51,False,0,2,1,9656,1239,168.73111111111112,Document
TypeScript,3393,2334,997.9155092592592,CLOSED,73,221,5,3,1,722,False,0,3,2,10397,294,0.6175,Bug
TypeScript,4,33,793.6401851851851,MERGED,253,538,18,1,12,221,False,0,1,1,9939,791,68.35083333333333,Document
Go,1835,11245,1763.0502546296295,MERGED,46,171,4,0,1,172,False,0,0,0,11409,217,0.7094444444444444,Document
Rust,413,5118,497.3211342592592,MERGED,26,1816,15,0,11,17,False,0,0,0,11574,1842,284.1647222222222,Document
Go,1835,11245,1758.8180324074074,MERGED,341,453,16,0,4,36,False,0,0,0,8476,794,8.09388888888889,Document
Go,1835,11245,1758.6139120370372,MERGED,0,9123,92,1,1,6,False,0,1,1,7861,9123,11.228333333333333,Document
TypeScript,140,827,782.0627314814815,MERGED,145,66,12,2,1,53,False,0,2,2,12531,211,22.3225,Bug
TypeScript,1073,11366,1128.7725,MERGED,1199,5929,196,1,117,6,True,0,1,1,12258,7128,0.2777777777777778,Bug
Go,789,5551,1070.8821990740742,MERGED,6949,136,86,0,2,388,False,0,0,0,11734,7085,71.28916666666667,Document
Go,1835,11245,1762.2450347222223,MERGED,750,786,34,1,1,9,False,0,1,1,12299,1536,7.708611111111111,Document
V,2097,34362,1586.9747800925925,MERGED,5,15,3,0,2,33,True,0,0,0,802,20,9.750833333333333,Bug
V,2097,34362,1586.9997685185183,MERGED,5,83,3,2,2,34,True,1,1,1,1012,88,20.1775,Bug
Java,450,746,4107.2098842592595,CLOSED,7,214,3,1,10,4,False,0,1,1,1701,221,1709.3591666666666,Bug
V,2097,34362,1587.6778587962963,MERGED,0,42,5,1,5,35,True,0,1,1,1662,42,3.8919444444444444,Feature
Vue,10806,21162,1058.3145023148147,MERGED,5,5,1,0,1,98,True,0,0,0,1950,10,1655.2316666666666,Bug
TypeScript,85,723,351.27472222222224,MERGED,1,1,1,1,2,5,False,0,1,1,1230,2,784.15,Document
TypeScript,261,3765,713.6372569444444,MERGED,133,2090,66,0,13,266,True,0,0,0,1318,2223,602.41,Document
TypeScript,2147,14723,1508.8715740740743,MERGED,8,12,2,1,1,106,False,0,1,1,825,20,3.5547222222222223,Bug
TypeScript,41369,87413,2974.9909953703705,MERGED,1,82,2,5,6,1,False,1,4,3,2882,83,1799.9980555555555,Document
TypeScript,2147,14723,1508.2244328703703,MERGED,16,8,4,0,8,735,False,0,0,0,973,24,40.22277777777778,Bug
Python,547,7160,2275.6184027777776,CLOSED,0,0,0,0,3,302,True,0,0,0,677,0,600.9972222222223,Bug
Rust,264,5384,439.9660069444444,CLOSED,66,48,24,2,5,355,False,2,0,0,910,114,673.1294444444444,Bug
Python,19248,70258,2497.4569560185187,CLOSED,2,0,1,2,1,1616,False,2,0,0,480,2,4.322777777777778,Bug
,0,1,55.95548611111111,CLOSED,1,8,2,0,1,3,False,0,0,0,1923,9,261.7891666666667,Document
V,2097,34362,1589.690150462963,MERGED,0,24,3,5,5,37,True,3,2,1,1989,24,47.8575,Bug
V,2097,34362,1587.816712962963,MERGED,1,10,4,0,2,36,True,0,0,0,3215,11,32.21138888888889,Bug
TypeScript,2147,14723,1510.1034375,MERGED,1,0,1,0,1,182,False,0,0,0,697,1,0.07222222222222222,Feature
TypeScript,2147,14723,1508.389988425926,CLOSED,8,92,1,1,1,0,False,0,1,1,1328,100,512.9736111111112,Feature
Go,1835,11245,1765.7674768518518,MERGED,10,15,4,1,1,120,False,0,1,1,223,25,71.3225,Feature
TypeScript,2147,14723,1510.0359837962963,MERGED,3,11,3,0,1,741,False,0,0,0,1719,14,308.58194444444445,Document
TypeScript,2147,14723,1510.017025462963,MERGED,5,74,2,0,1,740,False,0,0,0,1579,79,311.65527777777777,Bug
TypeScript,12,11,1024.3903009259259,CLOSED,7,36,2,0,1,379,False,0,0,0,1850,43,651.2341666666666,Feature
JavaScript,5139,7050,1239.5756712962964,CLOSED,0,26,1,3,1,0,False,0,3,3,893,26,387.09555555555556,Bug
TypeScript,2147,14724,1508.1874421296297,MERGED,7,10,1,0,7,734,False,0,0,0,1318,17,41.118611111111115,Bug
TypeScript,2147,14724,1507.9594097222223,MERGED,0,32,2,0,7,732,False,0,0,0,1247,32,46.67388888888889,Document
TypeScript,2147,14724,1510.0353819444445,MERGED,0,1,1,0,1,50,False,0,0,0,655,1,1.8394444444444444,Feature
TypeScript,85,723,351.21557870370367,MERGED,21,141,12,4,23,4,False,3,1,1,2004,162,627.1169444444445,Document
TypeScript,2147,14724,1508.9892939814815,MERGED,1,1,1,6,2,0,False,3,3,1,695,2,22.331666666666667,Bug
TypeScript,2147,14724,1508.8400694444445,CLOSED,0,9,1,0,1,105,False,0,0,0,729,9,0.5308333333333334,Bug
TypeScript,2147,14724,1507.942662037037,MERGED,8,4,1,0,1,181,False,0,0,0,1089,12,0.3761111111111111,Bug
V,2097,34362,1589.6029513888889,CLOSED,0,17,3,4,2,218,True,1,3,2,1758,17,1118.9183333333333,Document
TypeScript,178,1359,359.61855324074077,MERGED,1,0,1,2,1,1,False,0,2,2,932,1,0.1238888888888889,Feature
TypeScript,15,34,525.3974884259259,MERGED,310,532,26,0,16,492,True,0,0,0,226,842,1034.62,Bug
TypeScript,2147,14724,1510.1961805555557,MERGED,1,2,1,0,1,35,False,0,0,0,1096,3,21.8925,Feature
Go,1835,11245,1764.5996990740741,MERGED,16,9,4,1,1,119,False,0,1,1,369,25,0.355,Bug
TypeScript,2147,14724,1509.1786226851852,MERGED,14,17,4,0,8,739,False,0,0,0,2023,31,17.523055555555555,Bug
Python,547,7160,2275.4088425925925,MERGED,0,4,1,0,5,229,False,0,0,0,703,4,143.59583333333333,Document
Go,1835,11245,1763.588298611111,MERGED,259,1043,4,1,2,118,False,0,1,1,350,1302,2.6794444444444445,Feature
TypeScript,2147,14724,1508.732638888889,MERGED,6,28,2,0,8,736,False,0,0,0,2239,34,28.00777777777778,Bug
TypeScript,85,723,352.09238425925923,MERGED,8,0,1,0,1,6,False,0,0,0,1093,8,0.008888888888888889,Document
TypeScript,178,1359,357.4041666666667,MERGED,5,5,4,1,3,15,True,0,1,1,1048,10,5.733333333333333,Feature
TypeScript,2147,14724,1509.0446527777776,MERGED,2,15,1,0,1,107,False,0,0,0,869,17,0.7952777777777778,Feature
JavaScript,8844,63474,4114.2785300925925,MERGED,50,242,26,1,5,117,True,1,0,0,722,292,132.2313888888889,Bug
TypeScript,85,723,350.95282407407404,MERGED,1,1,1,0,1,107,False,0,0,0,1050,2,0.006944444444444444,Document
PHP,1334,2960,4245.3875,CLOSED,3,13,1,4,3,0,False,1,3,3,1040,16,71.76416666666667,Feature
JavaScript,5139,7050,1241.8929513888888,MERGED,0,2,1,1,2,7,False,0,1,1,597,2,1.853888888888889,Feature
PHP,1334,2960,4243.919027777778,MERGED,1,1,1,1,1,874,False,0,1,1,762,2,1.3708333333333333,Document
TypeScript,12,11,1026.3877777777777,CLOSED,8,29,1,0,1,223,False,0,0,0,1349,37,78.11916666666667,Feature
TypeScript,261,3765,713.848125,MERGED,1,61,2,0,1,115,False,0,0,0,1140,62,90.95333333333333,Document
TypeScript,12,11,1024.601388888889,MERGED,19,1035,4,0,6,166,False,0,0,0,1657,1054,139.6536111111111,Feature
C++,2234,23696,2392.961539351852,CLOSED,29,1,1,1,1,296,False,0,1,1,511,30,25.436944444444446,Bug
Vue,293,495,869.6758333333333,MERGED,1,1,1,3,1,179,True,0,3,2,667,2,2.216388888888889,Bug
TypeScript,178,1359,359.79107638888894,MERGED,2,2,2,2,1,44,True,0,2,2,1527,4,6.445277777777778,Feature
TypeScript,7,6,681.8152662037037,MERGED,0,3,1,0,3,223,False,0,0,0,765,3,2.0036111111111112,Feature
TypeScript,7,6,681.7960648148148,MERGED,1,2,1,0,2,222,False,0,0,0,715,3,2.4563888888888887,Feature
TypeScript,85,723,352.1799189814815,MERGED,0,16,2,0,3,174,False,0,0,0,1618,16,98.49888888888889,Document
TypeScript,58,78,856.7858680555555,MERGED,4,23,1,2,2,127,False,1,1,1,1538,27,33.2375,Feature
Python,547,7160,2275.420601851852,MERGED,26,19,4,0,6,230,False,0,0,0,1045,45,143.58638888888888,Document
TypeScript,2147,14724,1510.0975925925925,MERGED,1,30,7,0,1,677,False,0,0,0,1776,31,3.721388888888889,Feature
C#,80,125,856.7715740740741,CLOSED,10,14,1,0,1,94,False,0,0,0,1397,24,1508.3355555555556,Document
TypeScript,12,11,1024.7181365740742,MERGED,13,628,5,0,6,115,False,0,0,0,1339,641,37.79888888888889,Feature
TypeScript,261,3765,712.8719097222223,MERGED,11,10,2,0,2,266,True,0,0,0,1376,21,0.32055555555555554,Document
PHP,1334,2960,4243.287557870371,MERGED,9,11,1,2,2,22,False,0,2,2,1099,20,17.780277777777776,Bug
TypeScript,261,3765,712.8022337962963,MERGED,4,20,3,0,2,226,False,0,0,0,1596,24,0.6555555555555556,Document
Python,547,7160,2275.7957523148148,MERGED,3,3,2,0,4,30,False,0,0,0,2062,6,118.81972222222223,Document
Rust,264,5384,438.81430555555556,MERGED,0,3,1,0,1,353,False,0,0,0,702,3,0.5041666666666667,Bug
TypeScript,2147,14724,1508.8886689814815,MERGED,4,47,1,0,1,309,False,0,0,0,1900,51,24.775,Feature
TypeScript,2147,14724,1508.837650462963,MERGED,0,22,2,0,1,305,False,0,0,0,1118,22,25.689444444444444,Feature
TypeScript,2147,14724,1508.8230208333334,MERGED,30,32,1,0,1,304,False,0,0,0,1866,62,26.31277777777778,Feature
TypeScript,2147,14724,1512.0003587962963,MERGED,14,71,3,0,11,51,False,0,0,0,1984,85,67.32694444444445,Bug
PHP,1334,2960,4242.922719907408,MERGED,1,1,1,1,2,162,False,0,1,1,1015,2,0.49027777777777776,Bug
TypeScript,42,46,805.0602314814814,CLOSED,0,384,3,2,1,26,False,0,2,2,554,384,162.8061111111111,Feature
TypeScript,2147,14724,1508.8414699074074,CLOSED,8,14,1,0,1,306,False,0,0,0,1645,22,0.6441666666666667,Feature
TypeScript,261,3765,711.794525462963,MERGED,0,14,2,0,1,114,False,0,0,0,1522,14,0.7580555555555556,Document
TypeScript,261,3765,711.7483796296297,MERGED,4,19,3,0,2,190,False,0,0,0,1690,23,1.631388888888889,Document
C++,2234,23696,2397.241701388889,MERGED,1,47,2,1,7,110,False,0,1,1,1159,48,312.6163888888889,Feature
Vue,293,495,869.061886574074,MERGED,8,4,2,2,1,397,False,0,2,2,908,12,92.55166666666666,Bug
TypeScript,12,11,1026.4042708333334,MERGED,10,31,3,0,1,168,False,0,0,0,1813,41,71.50611111111111,Feature
Vue,10806,21162,1058.7854050925926,CLOSED,24,21,8,1,1,4,False,0,1,1,4445,45,1664.181388888889,Feature
TypeScript,12,11,1026.507986111111,MERGED,2,6,1,0,1,52,False,0,0,0,1888,8,63.43083333333333,Feature
TypeScript,261,3765,711.468275462963,MERGED,0,8,2,0,1,223,False,0,0,0,1492,8,0.22722222222222221,Document
C++,2234,23696,2395.023472222222,MERGED,1,23,2,1,1,298,False,0,1,1,978,24,67.70833333333333,Bug
TypeScript,2147,14724,1508.0731944444444,MERGED,19,95,5,0,7,733,False,0,0,0,3222,114,43.93083333333333,Document
TypeScript,2147,14724,1507.9745486111112,MERGED,7,8,3,0,2,43,False,0,0,0,1534,15,0.6475,Feature
Vue,293,495,866.7261689814815,MERGED,378,321,24,15,21,176,True,5,10,5,1302,699,483.07666666666665,Bug
Python,2407,12183,279.97905092592595,CLOSED,9,17,1,0,4,338,True,0,0,0,2146,26,1724.2008333333333,Document
V,2097,34362,1591.5868402777778,MERGED,6,30,3,0,3,233,True,0,0,0,770,36,39.84722222222222,Bug
PHP,883,2338,1867.5607175925925,CLOSED,6,43,4,3,1,200,False,1,2,2,3206,49,1061.8983333333333,Document
Rust,264,5384,440.85590277777777,MERGED,0,0,6,0,1,149,False,0,0,0,1049,0,1.7633333333333334,Feature
TypeScript,12,11,1028.667210648148,MERGED,58,1270,9,0,17,117,False,0,0,0,3361,1328,188.0986111111111,Feature
TypeScript,202,107,1182.1053587962963,MERGED,4,4,2,3,2,249,True,0,3,3,1012,8,105.95111111111112,Bug
TypeScript,149,2900,415.27569444444447,MERGED,13,0,2,1,1,189,True,0,1,1,75,13,160.19222222222223,Feature
TypeScript,261,3765,711.5011458333333,CLOSED,46,75,7,0,3,108,True,0,0,0,5635,121,1535.878611111111,Document
C++,2234,23696,2394.7322916666667,MERGED,0,33,3,1,1,337,False,0,1,1,1119,33,1.5416666666666667,Bug
Go,421,1654,1546.9144791666668,MERGED,2,5,1,0,1,460,True,0,0,0,1319,7,6.0152777777777775,Bug
Vue,293,495,867.6438657407407,MERGED,29,32,1,5,1,65,False,0,5,5,1181,61,52.6675,Bug
TypeScript,202,107,1180.5608680555556,MERGED,0,1,1,3,2,153,True,0,3,3,1175,1,142.975,Document
F#,271,818,2765.49,MERGED,2,7,2,2,2,71,False,1,1,1,1327,9,16.046388888888888,Document
Python,547,7160,2272.654965277778,MERGED,1,12,1,0,1,300,True,0,0,0,733,13,0.018333333333333333,Bug
Python,547,7160,2272.649363425926,MERGED,2,4,2,0,1,299,True,0,0,0,712,6,0.03305555555555555,Bug
TypeScript,58,78,855.4047337962962,MERGED,203,479,14,1,7,177,False,0,1,1,955,682,19.982777777777777,Feature
Go,421,1654,1546.1007407407408,MERGED,0,6,1,0,1,458,True,0,0,0,1561,6,19.368333333333332,Bug
TypeScript,202,107,1180.6193171296297,MERGED,3,2,1,3,2,243,True,0,3,3,1282,5,117.41027777777778,Document
TypeScript,261,3765,712.9359490740741,MERGED,3,11,2,0,1,267,True,0,0,0,1726,14,13.43138888888889,Document
TypeScript,2147,14724,1510.076064814815,CLOSED,116,249,3,0,1,34,False,0,0,0,1961,365,0.31027777777777776,Feature
JavaScript,8844,63474,4115.106296296296,MERGED,7,17,4,3,5,8,False,0,3,3,1818,24,122.97111111111111,Bug
TypeScript,42,46,806.0772800925926,MERGED,5,66,2,1,1,28,False,0,1,1,890,71,161.88861111111112,Feature
TypeScript,42,46,805.0689930555556,MERGED,9,10,1,1,3,27,False,0,1,1,529,19,18.9475,Bug
Vue,293,495,867.8164236111111,MERGED,14,20,1,3,1,178,True,0,3,2,826,34,1.5988888888888888,Bug
Python,2407,12183,277.8395023148148,MERGED,1,15,2,0,3,320,True,0,0,0,139,16,0.3661111111111111,Feature
TypeScript,261,3765,712.5466435185185,MERGED,20,8,4,0,1,950,True,0,0,0,1833,28,2.1955555555555555,Document
TypeScript,2147,14724,1508.8857407407406,MERGED,15,16,3,0,1,308,False,0,0,0,2562,31,24.6375,Feature
TypeScript,2147,14724,1508.8787499999999,MERGED,30,60,6,0,1,307,False,0,0,0,2199,90,24.92972222222222,Feature
Vue,293,495,867.0641898148148,MERGED,12,10,1,5,1,395,False,0,5,4,794,22,0.6927777777777778,Bug
TypeScript,202,107,1181.746412037037,MERGED,2,5,1,3,1,246,True,0,3,3,1298,7,3.5380555555555557,Bug
PHP,1334,2960,4243.198819444445,MERGED,0,1,1,2,1,49,False,0,2,2,1592,1,16.92388888888889,Document
Go,421,1654,1545.165185185185,MERGED,11,12,2,0,1,457,True,0,0,0,1415,23,1.4358333333333333,Bug
PHP,1334,2960,4244.946111111111,MERGED,3,16,4,1,5,88,False,0,1,1,1960,19,122.65,Document
Vue,293,495,866.5983912037037,MERGED,17,55,3,12,5,394,False,3,9,5,959,72,11.80861111111111,Bug
Vue,293,495,866.4538194444444,MERGED,2,44,2,6,1,393,False,1,5,4,1067,46,15.322222222222223,Bug
Kotlin,164,4296,441.6517824074074,MERGED,25,41,1,0,1,55,False,0,0,0,230,66,70.60888888888888,Feature
TypeScript,261,3765,711.6956944444445,MERGED,10,10,4,0,3,221,True,0,0,0,1914,20,1.9305555555555556,Document
JavaScript,5139,7050,1240.7847916666667,MERGED,3,6,3,2,1,61,False,0,2,2,1656,9,21.41722222222222,Feature
JavaScript,8844,63474,4116.407256944444,MERGED,2,45,8,1,2,119,True,1,0,0,5250,47,91.67777777777778,Bug
TypeScript,261,3765,711.4905324074074,MERGED,2,2,2,0,2,224,False,0,0,0,1867,4,3.321111111111111,Document
JavaScript,5139,7050,1243.4993171296296,MERGED,16,113,18,6,6,22,False,0,6,3,1143,129,25.25861111111111,Document
JavaScript,8844,63474,4115.772905092593,MERGED,8,8,2,7,2,0,False,3,4,3,2327,16,106.94277777777778,Feature
Go,395,660,1302.9821875,MERGED,1,1,1,0,2,113,False,0,0,0,203,2,139.14027777777778,Bug
TypeScript,85,723,355.0632060185185,MERGED,15229,4379,10,0,22,105,False,0,0,0,3069,19608,71.16055555555556,Document
TypeScript,7,6,682.7668171296297,MERGED,247,0,6,0,6,29,False,0,0,0,1665,247,92.41388888888889,Feature
V,2097,34362,1588.3637152777776,MERGED,1,124,7,0,4,232,True,0,0,0,866,125,19.095,Bug
Vue,10806,21162,1059.1515277777778,MERGED,1,4,1,0,1,184,False,0,0,0,1278,5,21.125,Bug
Vue,10806,21162,1059.0306828703704,MERGED,3,2,1,1,1,7,False,0,1,1,1096,5,23.63388888888889,Bug
Go,395,660,1304.9165972222222,MERGED,41,0,1,0,1,87,False,0,0,0,174,41,23.563055555555554,Feature
V,2097,34362,1587.4308912037038,MERGED,2,43,2,2,4,229,True,1,1,1,831,45,41.52,Bug
Vue,293,495,868.0889930555555,MERGED,7,57,4,16,14,396,False,7,9,5,1448,64,161.27027777777778,Bug
Starlark,440,286,526.9588310185185,MERGED,10598,10514,1,1,2,3,False,0,1,1,198,21112,2.0838888888888887,Bug
Starlark,440,286,526.9532175925925,CLOSED,10864,10779,1,1,1,2,False,0,1,1,246,21643,0.11611111111111111,Bug
Vue,293,495,867.7974421296295,MERGED,292,104,19,10,6,177,True,1,9,6,1428,396,165.3025,Bug
Go,421,1654,1546.9477314814815,MERGED,134,173,5,0,2,461,True,0,0,0,1775,307,5.220555555555555,Bug
Vue,293,495,867.8311458333333,MERGED,258,1200,24,32,54,66,False,11,21,5,2006,1458,385.25111111111113,Bug
TypeScript,261,3765,713.7992824074073,MERGED,42,44,4,0,1,957,True,0,0,0,2793,86,64.62305555555555,Document
Go,395,660,1304.4788541666667,MERGED,1,1,1,0,1,86,False,0,0,0,211,2,34.67166666666667,Feature
Kotlin,164,4296,441.6387268518518,MERGED,2,17,3,2,3,54,False,0,2,2,361,19,71.37722222222222,Document
TypeScript,202,107,1181.6405208333333,MERGED,1693,409,3,3,1,265,True,0,3,3,1593,2102,164.0822222222222,Document
TypeScript,202,107,1181.4699074074074,MERGED,4,20,2,3,1,264,True,0,3,3,1359,24,168.195,Document
TypeScript,7,6,681.8221990740741,MERGED,0,24,3,0,2,224,False,0,0,0,1180,24,1.8775,Feature
TypeScript,261,3765,713.5322106481482,MERGED,10,20,7,0,1,954,True,0,0,0,2663,30,1.0341666666666667,Document
JavaScript,9664,43889,3692.729513888889,CLOSED,7,10,4,0,139,0,False,0,0,0,775,17,161.21694444444444,Bug
TypeScript,15,34,525.7071064814814,CLOSED,2,3,1,0,4,56,False,0,0,0,199,5,140.38305555555556,Document
Java,450,746,4109.132291666667,MERGED,1,98,3,1,3,981,False,0,1,1,560,99,318.2916666666667,Document
Go,395,660,1302.1742245370372,MERGED,234,161,4,1,6,112,False,1,0,0,208,395,88.20666666666666,Feature
TypeScript,202,107,1179.704537037037,MERGED,156,116,1,3,2,262,True,0,3,3,2017,272,210.58916666666667,Document
TypeScript,41369,87413,2974.73212962963,MERGED,4,22,3,1,8,79,True,0,1,1,3088,26,1319.6133333333332,Document
Rust,264,5384,439.90428240740744,MERGED,34,8,5,0,1,354,False,0,0,0,1178,42,5.971111111111111,Bug
Rust,264,5384,438.9370138888889,MERGED,8,22,2,0,1,274,True,0,0,0,1626,30,50.34027777777778,Feature
TypeScript,261,3765,713.5323032407408,MERGED,2,138,6,0,2,192,False,0,0,0,2775,140,3.678888888888889,Document
TypeScript,261,3765,713.4956018518519,MERGED,224,229,4,0,2,953,True,0,0,0,2248,453,0.6916666666666667,Document
TypeScript,202,107,1182.0976157407406,MERGED,4,10,1,3,1,248,True,0,3,3,2046,14,81.90277777777777,Document
TypeScript,7,6,680.945324074074,MERGED,1,1,1,0,1,290,False,0,0,0,282,2,0.0375,Bug
TypeScript,2147,14724,1508.7776273148147,MERGED,60,142,2,0,8,737,False,0,0,0,3354,202,26.91638888888889,Document
Java,450,746,4110.026828703704,MERGED,4,47,2,1,1,584,False,0,1,1,296,51,97.72638888888889,Bug
Go,11875,71340,2733.051539351852,MERGED,7,24,5,0,1,291,True,0,0,0,2102,31,0.03166666666666667,Feature
TypeScript,15,34,527.3294791666666,MERGED,2,2,1,0,2,496,True,0,0,0,218,4,0.9738888888888889,Bug
TypeScript,178,1359,357.2432870370371,MERGED,0,80,4,2,1,26,True,0,2,2,2959,80,7.606388888888889,Feature
TypeScript,15,34,527.1440972222223,MERGED,1,1,1,0,1,495,True,0,0,0,238,2,0.39666666666666667,Feature
TypeScript,202,107,1179.4747916666668,MERGED,16,9,1,3,2,259,True,0,3,3,1307,25,169.16166666666666,Document
TypeScript,202,107,1179.4467939814815,MERGED,156,120,4,3,7,258,True,0,3,3,1985,276,169.85583333333332,Document
Rust,264,5384,438.7982175925926,MERGED,0,1,1,1,3,352,False,0,1,1,1130,1,0.9397222222222222,Bug
TypeScript,15,34,527.4255902777778,CLOSED,1,1,1,0,1,342,False,0,0,0,377,2,127.37777777777778,Feature
TypeScript,15,34,526.4255671296296,MERGED,6,6,1,0,1,493,True,0,0,0,357,12,170.6625,Bug
TypeScript,261,3765,711.6789814814815,MERGED,103,145,10,0,3,265,True,0,0,0,2748,248,20.615277777777777,Document
Go,395,660,1301.9543171296298,MERGED,17,52,1,0,2,111,False,0,0,0,245,69,1.6236111111111111,Bug
Go,395,660,1301.8830324074074,MERGED,1,7,1,0,1,110,False,0,0,0,214,8,0.07805555555555556,Feature
TypeScript,261,3765,711.546087962963,MERGED,27,89,5,0,4,225,False,0,0,0,2281,116,8.167222222222222,Document
TypeScript,261,3765,711.6255092592593,MERGED,10,10,8,0,2,945,True,0,0,0,2670,20,1.9366666666666668,Document
TypeScript,202,107,1181.8941550925927,MERGED,2,2,2,3,1,247,True,0,3,3,1397,4,0.10527777777777778,Document
Go,395,660,1301.0026273148148,MERGED,0,0,1,0,1,107,False,0,0,0,206,0,0.06861111111111111,Feature
TypeScript,15,34,528.6087962962963,MERGED,16,17,4,0,2,1007,False,0,0,0,378,33,23.30388888888889,Document
Java,450,746,4110.090486111111,MERGED,3,5,2,1,1,8,False,0,1,1,484,8,0.8047222222222222,Feature
Go,395,660,1303.042326388889,MERGED,3,45,1,0,2,1,False,0,0,0,343,48,69.23222222222222,Feature
Java,450,746,4109.1209375,MERGED,3,33,3,2,1,155,False,0,2,1,1330,36,21.650277777777777,Bug
V,2097,34362,1588.7997337962963,MERGED,1,1,1,0,1,13,False,0,0,0,1333,2,8.636666666666667,Document
TypeScript,12,11,1026.3150231481482,MERGED,131,900,8,0,14,167,False,0,0,0,4542,1031,241.92694444444444,Feature
Java,450,746,4110.205289351852,MERGED,2,10,4,1,2,9,False,0,1,1,540,12,96.27027777777778,Feature
TypeScript,15,34,524.7303587962963,MERGED,1,1,1,0,2,1000,False,0,0,0,223,2,0.4486111111111111,Document
V,2097,34362,1587.6993055555556,MERGED,24,54,8,0,2,231,True,0,0,0,1524,78,35.08833333333333,Bug
TypeScript,7046,76149,2665.5247569444446,MERGED,867,828,3,3,1,106,False,0,3,2,1806,1695,0.1175,Bug
TypeScript,15,34,527.6214004629629,MERGED,29,8,3,0,2,345,False,0,0,0,469,37,0.2725,Bug
JavaScript,9664,43889,3695.075486111111,MERGED,26,26,1,1,4,1,False,0,1,1,476,52,65.36666666666666,Bug
Go,182,37,1743.4428819444445,MERGED,0,159,5,2,6,458,False,2,0,0,2548,159,186.2888888888889,Document
TypeScript,15,34,527.42625,MERGED,4,5,1,0,1,497,True,0,0,0,350,9,1.3566666666666667,Bug
JavaScript,9664,43889,3693.243715277778,MERGED,7,7,1,0,2,0,False,0,0,0,340,14,14.3775,Feature
Go,421,1654,1545.9895833333333,MERGED,11,44,2,0,2,103,False,0,0,0,3456,55,21.150555555555556,Document
TypeScript,15,34,527.2948842592592,MERGED,1,1,1,0,1,176,False,0,0,0,285,2,0.005833333333333334,Feature
TypeScript,15,34,526.7386805555556,MERGED,5,38,4,0,1,1006,False,0,0,0,363,43,20.113055555555555,Document
Java,450,746,4109.393159722223,MERGED,34,157,4,1,12,13,False,0,1,1,534,191,277.5136111111111,Feature
TypeScript,202,107,1179.7023032407408,MERGED,14,12,1,2,1,10,True,0,2,2,1521,26,0.1486111111111111,Document
TypeScript,202,107,1179.5281481481481,MERGED,6,7,1,3,1,260,True,0,3,3,1380,13,2.075,Document
Go,395,660,1302.426701388889,MERGED,2,54,1,0,2,85,False,0,0,0,292,56,0.37,Feature
TypeScript,202,107,1182.8278587962964,MERGED,188,118,2,4,3,265,True,0,4,3,2747,306,88.67777777777778,Document
TypeScript,15,34,527.4671527777778,MERGED,5,19,3,0,2,498,True,0,0,0,475,24,95.83361111111111,Feature
TypeScript,15,34,526.5504166666666,MERGED,3,3,2,0,1,1005,False,0,0,0,427,6,4.144444444444445,Document
TypeScript,202,107,1179.7215856481482,MERGED,102,65,1,3,1,263,True,0,3,3,2557,167,210.16666666666666,Document
TypeScript,15,34,526.099236111111,MERGED,0,7,3,0,1,1004,False,0,0,0,279,7,0.10666666666666667,Feature
Rust,264,5384,439.95886574074075,MERGED,20,13,4,0,1,259,True,0,0,0,2102,33,0.7111111111111111,Document
Go,395,660,1301.0770486111112,MERGED,5,17,1,0,1,108,False,0,0,0,258,22,23.77138888888889,Bug
TypeScript,15,34,525.333125,MERGED,4,9,1,0,2,174,False,0,0,0,334,13,22.869444444444444,Feature
Go,395,660,1301.1204282407407,MERGED,17,23,2,0,1,109,False,0,0,0,300,40,18.37638888888889,Feature
Java,450,746,4110.233622685185,MERGED,9,10,4,2,1,156,False,0,2,1,2367,19,90.28777777777778,Bug
TypeScript,178,1359,358.7850810185185,MERGED,30,154,8,4,11,16,True,1,3,3,4504,184,127.825,Bug
TypeScript,2070,16640,1280.5499768518519,MERGED,1,1,1,0,1,0,False,0,0,0,2263,2,277.6744444444444,Document
Go,395,660,1301.906886574074,MERGED,15,125,2,0,4,129,False,0,0,0,464,140,95.84277777777778,Feature
Go,2083,11769,1554.9673032407409,MERGED,1,1,1,2,1,0,False,0,2,2,1253,2,4.035833333333334,Document
TypeScript,15,34,527.5622453703703,MERGED,7,29,2,0,2,344,False,0,0,0,407,36,1.6972222222222222,Bug
TypeScript,2070,16640,1279.842037037037,MERGED,1,1,1,0,1,0,False,0,0,0,2381,2,294.7391666666667,Bug
TypeScript,1297,21107,452.68128472222224,MERGED,1,55,3,5,10,45,False,2,3,2,2186,56,46.60027777777778,Document
TypeScript,41369,87413,2975.5550694444446,MERGED,2,57,6,0,1,52,False,0,0,0,2917,59,452.6675,Document
C#,80,125,855.882673611111,MERGED,14,1,1,0,1,0,True,0,0,0,474,15,18.773055555555555,Document
TypeScript,15,34,526.4187962962964,MERGED,718,997,35,0,13,340,False,0,0,0,542,1715,24.002777777777776,Feature
TypeScript,2070,16640,1278.703622685185,MERGED,17,14,1,0,2,2,False,0,0,0,2637,31,322.0252777777778,Bug
C++,2234,23696,2392.8652314814813,MERGED,2,17,2,1,1,559,False,0,1,1,2022,19,1.9869444444444444,Bug
TypeScript,85,723,353.1098958333334,MERGED,213,335,6,0,5,175,False,0,0,0,3579,548,75.14027777777778,Document
TypeScript,307,2556,575.6107060185185,MERGED,21,24,1,0,1,307,True,0,0,0,1497,45,77.75805555555556,Bug
TypeScript,1297,21107,452.8754861111111,MERGED,1,40,3,1,1,1060,True,0,1,1,1903,41,0.03333333333333333,Document
TypeScript,15,34,526.4285532407407,MERGED,4,31,3,0,1,494,True,0,0,0,418,35,2.283888888888889,Feature
V,2097,34362,1588.728472222222,MERGED,1,4,3,0,1,14,True,0,0,0,1661,5,10.305277777777778,Document
PHP,883,2338,1869.8125,CLOSED,10,575,6,5,3,69,False,2,3,3,3980,585,815.1463888888889,Document
V,2097,34362,1591.218263888889,MERGED,63,63,28,0,1,38,True,0,0,0,6394,126,11.415,Document
TypeScript,1297,21107,451.7022337962963,MERGED,58,158,10,1,8,1056,True,0,1,1,2216,216,1.803611111111111,Document
Go,2083,11769,1557.351539351852,MERGED,0,132,3,2,3,0,False,0,2,2,2436,132,40.70916666666667,Document
C#,80,125,856.8746064814815,CLOSED,610,1595,37,0,89,1,True,0,0,0,627,2205,90.93833333333333,Document
JavaScript,8844,63474,4117.260451388889,MERGED,134,274,26,0,11,9,True,0,0,0,2539,408,71.15194444444444,Feature
JavaScript,9664,43889,3694.9860069444444,MERGED,14,31,8,0,2,635,False,0,0,0,597,45,2.0172222222222222,Bug
JavaScript,9664,43889,3694.9959259259263,MERGED,2,9,2,0,3,62,True,0,0,0,519,11,0.345,Feature
Vue,10806,21163,1062.3052314814815,MERGED,21,140,5,2,6,100,True,1,1,1,8413,161,594.5075,Bug
TypeScript,178,1359,357.7903819444444,MERGED,109,126,6,2,1,43,True,0,2,2,3851,235,0.10722222222222222,Document
JavaScript,5139,7050,1239.8644675925925,MERGED,20,1294,14,5,10,98,False,1,4,2,3517,1314,332.39972222222224,Feature
TypeScript,7,6,682.2355439814816,MERGED,79,187,5,0,59,249,False,0,0,0,2774,266,113.14111111111112,Feature
TypeScript,307,2556,574.6754861111111,MERGED,24,21,1,0,1,10,False,0,0,0,1510,45,0.8947222222222222,Bug
TypeScript,41369,87413,2973.832488425926,MERGED,2,2,1,0,1,1928,True,0,0,0,2171,4,14.495833333333334,Document
TypeScript,15,34,525.4498958333334,MERGED,50,160,15,0,17,175,False,0,0,0,524,210,136.4163888888889,Feature
JavaScript,9664,43889,3693.0602662037036,MERGED,5,8,130,0,2,262,True,0,0,0,583,13,47.033055555555556,Feature
TypeScript,41369,87413,2973.755173611111,MERGED,1,1,1,0,1,1926,True,0,0,0,2105,2,0.4141666666666667,Document
TypeScript,41369,87413,2973.6725,MERGED,1,1,1,0,1,604,True,0,0,0,2134,2,2.3738888888888887,Document
TypeScript,261,3765,712.7780092592593,MERGED,245,337,17,0,7,191,False,0,0,0,4310,582,2.1213888888888888,Document
C++,2234,23696,2393.5031944444445,MERGED,9,41,3,2,9,179,False,1,1,1,1975,50,1064.5291666666667,Feature
Python,547,7160,2272.704849537037,MERGED,4,20,4,3,16,81,False,1,2,2,726,24,70.1075,Document
TypeScript,15,34,527.5617361111111,MERGED,76,94,4,1,5,343,False,1,0,0,574,170,1.7577777777777779,Bug
TypeScript,261,3765,712.6046296296296,MERGED,46,14,27,0,2,951,True,0,0,0,4675,60,0.6841666666666667,Document
JavaScript,9664,43889,3693.0770601851855,MERGED,1,3,1,0,1,59,True,0,0,0,588,4,0.22722222222222221,Bug
JavaScript,9664,43889,3692.9629282407404,MERGED,2,2,24,0,1,261,True,0,0,0,534,4,0.21805555555555556,Feature
Starlark,440,286,528.2804745370371,MERGED,9,31,2,1,10,5,False,0,1,1,813,40,84.23277777777778,Feature
Go,421,1654,1546.8913657407409,MERGED,80,312,8,1,3,459,True,0,1,1,4926,392,72.095,Bug
JavaScript,9664,43889,3692.643541666667,MERGED,3,3,2,0,1,2,False,0,0,0,647,6,3.313888888888889,Feature
Python,137,75,722.0286111111112,MERGED,2,102,6,0,17,3,False,0,0,0,2163,104,987.5141666666667,Bug
TypeScript,261,3765,711.703263888889,MERGED,27,32,8,0,1,947,True,0,0,0,4364,59,0.5447222222222222,Document
TypeScript,261,3765,711.655625,MERGED,26,54,7,0,1,946,True,0,0,0,4001,80,0.5194444444444445,Document
TypeScript,307,2556,575.6978472222222,MERGED,6,38,4,0,1,580,True,0,0,0,2421,44,234.7161111111111,Bug
TypeScript,261,3765,711.5443055555555,MERGED,30,48,2,0,3,944,True,0,0,0,3597,78,0.1111111111111111,Document
TypeScript,261,3765,711.5239467592593,MERGED,20,152,10,0,1,943,True,0,0,0,4707,172,0.1322222222222222,Document
C++,2234,23696,2393.709178240741,MERGED,17,163,10,1,14,297,False,0,1,1,3138,180,118.08833333333334,Bug
Python,137,75,722.020486111111,MERGED,3,691,23,0,46,0,False,0,0,0,1561,694,955.5544444444445,Bug
TypeScript,202,107,1182.8471064814814,MERGED,111,57,1,3,2,266,True,0,3,3,3166,168,88.12638888888888,Document
TypeScript,15,34,525.6368865740741,MERGED,156,162,99,0,2,1001,False,0,0,0,684,318,2.1058333333333334,Feature
TypeScript,7,6,681.1632870370371,MERGED,16,53,2,0,2,230,False,0,0,0,2848,69,19.40222222222222,Document
C#,80,125,857.9665740740742,MERGED,1,1,1,0,1,184,False,0,0,0,738,2,139.06916666666666,Document
TypeScript,1297,21107,455.00471064814815,MERGED,47,37,9,1,3,1074,True,0,1,1,3032,84,0.8841666666666667,Document
TypeScript,202,107,1180.8507291666667,MERGED,37,56,2,3,1,244,True,0,3,3,3014,93,111.84861111111111,Document
Python,547,7160,2272.9963541666666,MERGED,1,6,1,0,4,29,False,0,0,0,2854,7,63.7275,Document
Starlark,440,286,527.0300462962963,MERGED,0,3,1,2,1,72,False,1,1,1,955,3,0.024166666666666666,Feature
Python,19248,70258,2497.4368055555556,CLOSED,15,23,2,1,2,1615,False,1,0,0,905,38,1.1391666666666667,Document
Go,182,37,1743.4429050925926,MERGED,410,271,29,1,9,459,False,1,0,0,4891,681,301.9875,Document
C#,80,125,855.8744907407407,MERGED,27,79,6,0,9,93,False,0,0,0,940,106,136.44694444444445,Document
TypeScript,2147,14724,1508.96875,MERGED,54,79,5,0,8,738,False,0,0,0,6148,133,26.863333333333333,Bug
JavaScript,9664,43889,3694.8006134259263,MERGED,6,113,6,0,3,61,True,0,0,0,720,119,1.4516666666666667,Feature
Python,137,75,725.0115509259259,MERGED,5,9,3,0,3,76,False,0,0,0,2259,14,3.433611111111111,Bug
Erlang,2054,12122,3832.253483796296,MERGED,11,24,4,2,1,22,False,1,1,1,1567,35,833.1369444444445,Document
Erlang,2054,12122,3830.9870254629627,MERGED,1,4,1,0,1,76,False,0,0,0,854,5,0.6658333333333334,Document
TypeScript,3393,2334,1004.0739699074074,CLOSED,1,1,1,2,1,479,False,0,2,1,1040,2,0.8847222222222222,Bug
JavaScript,9664,43889,3695.194861111111,MERGED,260,262,160,0,6,830,True,0,0,0,940,522,113.11944444444444,Feature
TypeScript,3393,2334,1003.916875,MERGED,0,6,1,1,1,134,False,0,1,1,918,6,0.1686111111111111,Bug
TypeScript,41369,87413,2974.7316666666666,MERGED,5,10,1,0,1,454,True,0,0,0,2838,15,1.3902777777777777,Document
JavaScript,9664,43889,3693.1452546296296,MERGED,15,1,4,0,1,60,True,0,0,0,709,16,0.21416666666666667,Feature
C#,80,125,856.1631481481481,MERGED,75,71,7,0,2,163,True,0,0,0,747,146,20.453611111111112,Document
TypeScript,41369,87413,2974.493159722222,MERGED,2,2,1,0,1,0,False,0,0,0,2500,4,0.7344444444444445,Document
TypeScript,41369,87413,2974.4759722222225,MERGED,12,0,2,0,2,1929,True,0,0,0,2259,12,0.21416666666666667,Document
TypeScript,41369,87413,2973.985243055555,CLOSED,4,31,1,0,1,0,False,0,0,0,2265,35,24.205833333333334,Document
TypeScript,41369,87413,2972.381539351852,MERGED,8,26,3,7,2,49,False,3,4,2,3092,34,100.58055555555555,Document
TypeScript,41369,87413,2973.9419560185183,MERGED,32,76,2,0,4,118,True,0,0,0,2902,108,2.9008333333333334,Document
TypeScript,41369,87413,2973.8349189814817,MERGED,4,18,2,0,3,1609,True,0,0,0,2897,22,5.1375,Document
TypeScript,41369,87413,2973.831875,MERGED,28,34,1,0,3,117,True,0,0,0,2403,62,3.7055555555555557,Document
TypeScript,41369,87413,2973.7590625,MERGED,2,3,1,0,1,1927,True,0,0,0,2149,5,0.4525,Document
Python,2407,12184,277.3128125,MERGED,24,21,2,7,4,319,True,3,4,1,1230,45,0.3463888888888889,Document
TypeScript,41369,87413,2975.5430671296294,MERGED,3,39,6,0,1,51,False,0,0,0,4451,42,437.35583333333335,Document
TypeScript,15,34,525.6531944444445,MERGED,112,44,2,0,1,1002,False,0,0,0,811,156,0.8763888888888889,Document
TypeScript,41369,87413,2972.7410416666667,MERGED,2,8,1,0,1,0,False,0,0,0,2386,10,0.495,Document
Erlang,2054,12122,3832.998101851852,MERGED,2,39,4,0,1,53,False,0,0,0,1128,41,269.4577777777778,Document
TypeScript,58,78,858.3495254629629,MERGED,169,322,20,1,7,178,False,0,1,1,7973,491,67.27944444444445,Bug
TypeScript,7,6,682.7542013888889,MERGED,11,60,16,0,9,28,False,0,0,0,4723,71,97.19083333333333,Feature
Erlang,2054,12122,3833.437372685185,MERGED,13,495,5,0,1,20,False,0,0,0,1233,508,138.45,Document
Starlark,440,286,528.2848263888889,MERGED,17,5,1,1,1,73,False,0,1,1,1441,22,84.12138888888889,Document
Starlark,440,286,527.7874768518519,MERGED,22,5,1,2,21,3,False,1,1,1,1487,27,96.0911111111111,Feature
C#,80,125,857.6261921296297,MERGED,5,15,3,3,16,221,False,1,2,1,1269,20,233.95777777777778,Document
TypeScript,12,11,1025.1830671296295,MERGED,32,40,2,0,6,116,False,0,0,0,5403,72,84.10388888888889,Feature
Erlang,2054,12122,3832.7868287037036,MERGED,3,5,3,2,1,249,True,0,2,1,1254,8,1.9352777777777779,Document
TypeScript,4,33,800.2823958333333,MERGED,269,988,30,2,20,637,True,1,1,1,1513,1257,153.19305555555556,Feature
TypeScript,41369,87413,2975.9883796296294,MERGED,3,29,6,0,1,38,False,0,0,0,4278,32,211.78805555555556,Document
C++,2234,23696,2393.9445949074075,MERGED,1,7,2,0,5,336,False,0,0,0,1408,8,88.74777777777778,Bug
C++,2234,23696,2393.944525462963,MERGED,1,3,2,0,5,335,False,0,0,0,1730,4,88.74972222222222,Feature
C++,2234,23696,2393.9444560185184,MERGED,46,68,1,0,3,334,False,0,0,0,1353,114,88.75083333333333,Bug
TypeScript,58,78,856.0338888888888,CLOSED,0,322,14,1,2,126,False,0,1,1,6119,322,51.291111111111114,Feature
Python,2407,12184,279.09622685185184,MERGED,1,1,1,0,6,330,True,0,0,0,1230,2,6.897222222222222,Document
Erlang,2054,12122,3831.2431944444447,MERGED,1,10,3,2,1,21,False,0,2,1,1152,11,17.02027777777778,Document
TypeScript,41369,87413,2976.9998842592595,MERGED,1,39,6,0,15,459,True,0,0,0,4486,40,159.15,Document
Erlang,2054,12122,3831.990717592593,MERGED,12,13,7,2,2,411,True,0,2,1,1134,25,2.9583333333333335,Document
Erlang,2054,12122,3833.0093287037034,MERGED,0,23,3,0,2,250,True,0,0,0,1200,23,64.29944444444445,Document
TypeScript,41369,87413,2976.865601851852,MERGED,5,36,8,0,7,458,True,0,0,0,4202,41,159.3111111111111,Document
TypeScript,3393,2334,1007.1714583333334,MERGED,16,24,3,2,1,0,False,0,2,1,1857,40,36.12722222222222,Bug
Python,2407,12184,279.0415046296296,MERGED,1,1,1,0,1,328,True,0,0,0,1520,2,0.2363888888888889,Document
Erlang,2054,12122,3833.0238194444446,MERGED,2,2,1,0,1,24,True,0,0,0,1076,4,62.663333333333334,Document
TypeScript,41369,87413,2975.496331018519,MERGED,1,29,6,0,1,37,False,0,0,0,4442,30,221.63888888888889,Document
Erlang,2054,12122,3831.6564467592593,MERGED,9,63,5,2,3,410,True,0,2,1,1236,72,9.476111111111111,Document
Kotlin,0,0,9.997326388888888,CLOSED,18,0,1,0,1,1,True,0,0,0,1323,18,168.80805555555557,Document
Erlang,2054,12122,3832.191446759259,MERGED,0,6,1,0,2,508,True,0,0,0,1358,6,1.5647222222222221,Document
TypeScript,7,6,682.0319444444444,MERGED,29,179,36,0,3,248,False,0,0,0,4723,208,2.263333333333333,Feature
Python,547,7160,2274.539652777778,MERGED,16,118,4,0,23,5,False,0,0,0,1522,134,526.6283333333333,Bug
TypeScript,7,6,681.9713773148148,MERGED,17,68,7,1,3,26,True,0,1,1,4706,85,0.9611111111111111,Feature
TypeScript,140,827,787.2650462962962,MERGED,0,41,4,2,1,105,False,0,2,2,1462,41,23.82888888888889,Document
TypeScript,202,107,1182.5106828703704,MERGED,7,15,4,3,1,250,True,0,3,3,4006,22,96.23555555555555,Document
Starlark,440,286,527.8120138888888,MERGED,2,2,1,2,2,74,False,1,1,1,1131,4,0.056666666666666664,Bug
Starlark,440,286,527.8089930555556,MERGED,3,3,1,2,1,73,False,1,1,1,1366,6,0.013055555555555556,Bug
Erlang,2054,12122,3833.0770601851855,MERGED,1,1,1,0,1,509,True,0,0,0,1200,2,17.686944444444446,Document
Erlang,2054,12122,3832.8809490740737,MERGED,3,34,1,0,1,485,False,0,0,0,1073,37,26.53361111111111,Document
Rust,264,5384,441.0255902777778,MERGED,32,70,9,0,2,261,True,0,0,0,4200,102,0.9511111111111111,Bug
Erlang,2054,12122,3830.8822685185187,MERGED,72,70,14,3,7,406,True,0,3,2,1477,142,5.237777777777778,Document
TypeScript,3393,2334,1005.2574537037036,MERGED,4,4,1,2,2,276,False,0,2,1,1711,8,82.05833333333334,Bug
TypeScript,3393,2334,1004.767962962963,MERGED,1,1,1,2,1,0,False,0,2,1,1114,2,95.73638888888888,Bug
TypeScript,4,33,801.3048148148149,MERGED,723,24,10,1,4,389,True,0,1,1,1549,747,3.9788888888888887,Document
TypeScript,3393,2334,1004.4148958333334,MERGED,9,2,1,2,1,0,False,0,2,1,1475,11,10.88111111111111,Bug
Starlark,440,286,527.1120370370371,MERGED,1,1,1,1,1,1,False,0,1,1,1288,2,0.04722222222222222,Feature
Erlang,2054,12122,3832.7035300925927,MERGED,1,10,3,0,1,413,True,0,0,0,1269,11,3.6766666666666667,Document
TypeScript,1073,11366,1133.7564583333333,MERGED,3,3,2,1,1,141,True,0,1,1,1172,6,0.36444444444444446,Document
Starlark,440,286,527.023900462963,MERGED,2,2,1,1,1,7,False,0,1,1,1465,4,0.5269444444444444,Bug
TypeScript,1297,21107,454.9202662037037,MERGED,11,56,6,1,2,46,False,0,1,1,3604,67,2.015833333333333,Document
TypeScript,1073,11366,1133.6638425925926,MERGED,1,3,1,1,1,140,True,0,1,1,1652,4,0.5316666666666666,Bug
TypeScript,261,3765,713.7302893518519,MERGED,2,157,15,0,3,956,True,0,0,0,6049,159,0.39111111111111113,Document
TypeScript,261,3765,713.6853472222223,MERGED,59,161,21,0,5,955,True,0,0,0,5866,220,0.7661111111111111,Document
Erlang,2054,12122,3832.460416666667,MERGED,2,2,2,0,1,19,False,0,0,0,1148,4,2.0955555555555554,Document
TypeScript,1297,21107,454.7617708333333,MERGED,61,42,2,1,1,1073,True,0,1,1,3299,103,0.12527777777777777,Document
Erlang,2054,12122,3831.4086342592595,MERGED,42,63,10,0,3,77,False,0,0,0,1146,105,50.970555555555556,Document
TypeScript,202,107,1179.70125,MERGED,14,5,3,3,2,242,True,0,3,3,4014,19,163.5986111111111,Feature
Starlark,440,286,526.1486342592592,MERGED,0,706,2,1,1,72,False,0,1,1,1255,706,21.511388888888888,Document
Erlang,2054,12122,3832.0404166666667,MERGED,3,3,2,0,1,412,True,0,0,0,1047,6,0.27805555555555556,Document
TypeScript,3393,2334,1003.0305671296296,MERGED,4,8,1,2,2,478,False,0,2,1,1461,12,135.72861111111112,Bug
Erlang,2054,12122,3831.860405092593,MERGED,53,18,2,0,2,248,True,0,0,0,1325,71,2.221388888888889,Document
Erlang,2054,12122,3831.875555555556,MERGED,75,284,14,0,4,484,False,0,0,0,1385,359,1.851388888888889,Document
Starlark,440,286,525.3450578703704,MERGED,0,299,2,2,3,4,False,0,2,2,1759,299,35.2625,Feature
TypeScript,41369,87413,2976.6398842592594,MERGED,50,83,6,2,8,455,True,1,1,1,4442,133,47.60444444444445,Document
Erlang,2054,12122,3831.6516203703704,MERGED,2,5,2,0,2,409,True,0,0,0,1247,7,8.086388888888889,Document
TypeScript,4,33,800.1734027777778,MERGED,20,42,4,2,7,240,True,1,1,1,1345,62,0.8977777777777778,Bug
Erlang,2054,12122,3831.409016203704,MERGED,1,1,1,0,1,387,False,0,0,0,1368,2,18.56972222222222,Document
JavaScript,9664,43889,3694.9615856481482,MERGED,2,261,4,0,1,320,True,0,0,0,1140,263,0.2386111111111111,Feature
Erlang,2054,12122,3831.686898148148,MERGED,1,2,2,0,2,378,True,0,0,0,1137,3,0.2941666666666667,Document
TypeScript,1297,21107,453.722349537037,MERGED,6,16,5,1,1,1064,True,0,1,1,3601,22,0.07805555555555556,Document
TypeScript,1297,21107,453.7185185185185,MERGED,41,87,8,1,1,1063,True,0,1,1,3660,128,0.12333333333333334,Document
Erlang,2054,12122,3831.2041087962966,MERGED,735,1927,87,0,83,408,True,0,0,0,1400,2662,10.731111111111112,Document
TypeScript,261,3765,712.5060300925926,MERGED,44,160,15,0,1,949,True,0,0,0,5076,204,0.5094444444444445,Document
Starlark,440,286,527.5673495370371,MERGED,89,174,1,4,4,3,False,1,3,3,2209,263,294.6347222222222,Feature
Erlang,2054,12122,3831.013703703704,MERGED,25,33,6,0,2,407,True,0,0,0,1493,58,4.519722222222223,Document
Python,72,25,1671.6330787037039,MERGED,27,155,4,0,4,33,False,0,0,0,4143,182,3.3880555555555554,Feature
C#,655,7879,1864.5641319444446,MERGED,36,36,1,2,1,10,False,0,2,2,1881,72,17.573888888888888,Document
TypeScript,1297,21107,451.9248032407407,CLOSED,251,332,11,1,12,1057,True,0,1,1,3775,583,66.38222222222223,Document
C#,655,7879,1864.6314583333333,MERGED,1,1,1,0,3,1,False,0,0,0,1881,2,10.628055555555555,Document
Erlang,2054,12122,3830.7794675925925,MERGED,1,1,1,0,1,506,True,0,0,0,1079,2,0.02722222222222222,Document
TypeScript,4,33,799.0945023148148,MERGED,8,4,1,2,1,237,True,1,1,1,1115,12,0.10027777777777777,Bug
TypeScript,202,107,1180.9247222222223,MERGED,139,33,5,2,2,245,True,0,2,2,4503,172,9.752777777777778,Bug
TypeScript,3393,2334,1004.1038310185186,MERGED,35,1,1,1,1,136,False,0,1,1,1502,36,0.12194444444444444,Feature
Starlark,440,286,526.4013773148148,MERGED,0,269,2,1,3,5,False,0,1,1,1953,269,301.12444444444446,Feature
TypeScript,3393,2334,1003.9571875,MERGED,5,7,2,1,2,135,False,0,1,1,1387,12,0.4791666666666667,Bug
TypeScript,1073,11366,1129.791226851852,MERGED,4393,1644,27,2,5,185,False,0,2,2,4565,6037,1648.6044444444444,Bug
TypeScript,1073,11366,1130.8012962962964,MERGED,11,12,1,0,1,138,True,0,0,0,1194,23,0.24888888888888888,Bug
TypeScript,3393,2334,1003.0107060185186,MERGED,2,2,2,2,1,477,False,0,2,1,1599,4,24.537777777777777,Bug
TypeScript,3393,2334,1003.3710532407407,CLOSED,0,0,1,2,1,0,False,0,2,1,1597,0,0.1361111111111111,Bug
TypeScript,41369,87413,2974.6335532407406,MERGED,121,139,6,0,5,1930,True,0,0,0,3180,260,4.076944444444444,Document
TypeScript,202,107,1179.6115277777778,MERGED,141,94,4,2,2,9,True,0,2,2,4906,235,1.081388888888889,Document
TypeScript,1073,11366,1133.4867824074074,MERGED,2,2,1,0,2,1,False,0,0,0,1683,4,218.47277777777776,Bug
TypeScript,12,11,1024.2831018518518,MERGED,226,1859,26,0,24,51,False,0,0,0,10202,2085,319.52805555555557,Feature
JavaScript,5139,7050,1239.5724305555557,MERGED,220,186,47,3,7,101,False,1,2,2,7255,406,103.95027777777777,Bug
TypeScript,184,377,1946.8515162037038,MERGED,2,347,4,1,16,41,False,1,0,0,1564,349,136.65194444444444,Document
TypeScript,41369,87413,2972.8693055555555,MERGED,36,267,8,0,13,116,True,0,0,0,3600,303,43.12111111111111,Document
F#,153,337,2958.892349537037,MERGED,16,315,6,4,3,26,False,1,3,2,8420,331,312.315,Document
Go,1835,11245,1765.843738425926,MERGED,1,1,1,0,1,3,False,0,0,0,1406,2,0.195,Document
TypeScript,41369,87413,2973.4305671296297,MERGED,6,12,4,0,1,1608,True,0,0,0,3358,18,0.4922222222222222,Document
Go,1835,11245,1765.657013888889,MERGED,5,5,1,0,1,114,True,0,0,0,1553,10,0.49833333333333335,Document
Python,2407,12184,279.61850694444445,MERGED,7,6,2,2,4,0,False,1,1,1,1652,13,36.60666666666667,Document
TypeScript,41369,87413,2972.8917592592593,MERGED,171,67,6,0,3,453,True,0,0,0,4746,238,16.637777777777778,Document
TypeScript,41369,87413,2972.7706597222223,MERGED,3,7,4,4,1,25,False,1,3,2,4463,10,15.648888888888889,Document
TypeScript,4803,40785,3797.6144097222223,MERGED,59,43,3,1,2,147,True,0,1,1,2461,102,116.37916666666666,Bug
Go,789,5551,1077.2997685185185,MERGED,8,10,1,0,1,32,False,0,0,0,2086,18,60.92944444444444,Document
TypeScript,41369,87413,2972.4558564814815,MERGED,6,6,2,0,1,28,False,0,0,0,4469,12,2.8305555555555557,Document
Erlang,2054,12122,3833.416435185185,MERGED,4,52,2,0,1,388,False,0,0,0,1744,56,65.42222222222222,Document
Python,2407,12184,279.36207175925927,MERGED,1,1,1,0,1,336,True,0,0,0,1722,2,0.23777777777777778,Document
Python,2407,12184,279.3103009259259,MERGED,5,3,2,0,1,333,True,0,0,0,2241,8,0.4083333333333333,Document
Python,2407,12184,279.0519791666667,MERGED,5,4,1,0,3,329,True,0,0,0,1824,9,0.27,Document
Python,2407,12184,279.0382407407407,MERGED,1,1,1,0,1,327,True,0,0,0,1897,2,0.008333333333333333,Document
JavaScript,5139,7050,1239.2458333333334,MERGED,45,76,33,2,13,60,False,0,2,2,5147,121,10.678055555555556,Bug
Python,2407,12184,278.77125,MERGED,16,285,6,0,2,324,True,0,0,0,2278,301,0.35694444444444445,Document
TypeScript,3393,2334,1007.4975115740741,MERGED,1,39,5,1,3,346,False,0,1,1,2013,40,15.106944444444444,Feature
JavaScript,5139,7050,1239.6500115740741,MERGED,21,708,18,4,8,0,False,2,2,2,4438,729,23.34027777777778,Document
C#,655,7879,1866.153113425926,MERGED,1,29,5,2,4,18,False,0,2,1,2044,30,77.3236111111111,Document
C++,2234,23696,2393.406712962963,MERGED,76,132,5,6,2,0,False,2,4,3,2037,208,76.38,Feature
Python,14532,41187,1126.4271875,MERGED,1,4,1,0,3,1426,True,0,0,0,1796,5,0.15611111111111112,Document
Python,14532,41187,1126.4127083333333,MERGED,0,1,1,1,1,1425,True,1,0,0,1850,1,0.09111111111111111,Document
Python,2407,12184,277.90129629629627,MERGED,1,4,2,0,3,321,True,0,0,0,1745,5,1.8227777777777778,Document
TypeScript,1073,11366,1133.6289814814816,MERGED,4,9,1,1,1,139,True,0,1,1,1677,13,0.14027777777777778,Document
C#,655,7879,1863.484085648148,MERGED,0,45,2,5,2,10,False,3,2,2,2233,45,134.98611111111111,Document
TypeScript,1073,11366,1133.4669907407408,CLOSED,2,2,1,0,2,0,False,0,0,0,1710,4,0.22527777777777777,Bug
Python,2407,12184,277.3030671296296,MERGED,1,1,1,0,1,318,True,0,0,0,1670,2,0.13916666666666666,Document
TypeScript,4,33,798.4778009259259,MERGED,6,9,2,1,5,227,False,0,1,1,2079,15,143.31333333333333,Bug
Vue,293,495,867.1409027777778,MERGED,7366,10432,279,4,410,352,True,0,4,3,1754,17798,0.11777777777777777,Feature
TypeScript,1073,11366,1132.4680439814815,MERGED,1,1,1,0,1,0,False,0,0,0,2043,2,0.25833333333333336,Bug
TypeScript,3393,2334,1005.1234606481481,MERGED,54,7,2,1,1,138,False,0,1,1,2159,61,0.40194444444444444,Bug
TypeScript,3393,2334,1004.5928240740741,MERGED,22,22,2,2,4,480,False,0,2,1,1926,44,6.634722222222222,Document
Starlark,440,286,525.5866666666667,MERGED,16,19,1,1,1,71,False,0,1,1,2425,35,10.15638888888889,Feature
TypeScript,3393,2334,1004.4874768518517,MERGED,4,16,2,2,1,0,False,0,2,1,2250,20,5.8838888888888885,Bug
JavaScript,34,25,235.07703703703703,MERGED,6,11,4,0,1,83,False,0,0,0,2229,17,0.042777777777777776,Bug
TypeScript,3393,2334,1004.1691666666667,MERGED,2,11,2,1,1,137,False,0,1,1,1989,13,0.2038888888888889,Feature
Erlang,2054,12122,3830.6966203703705,MERGED,149,318,6,0,4,505,True,0,0,0,1862,467,1.9247222222222222,Document
TypeScript,149,2900,415.496875,MERGED,68,67,2,1,1,190,True,0,1,1,1886,135,16.504722222222224,Feature
TypeScript,3393,2334,1003.4891435185185,MERGED,4,9,2,2,1,0,False,0,2,1,2171,13,10.2475,Bug
TypeScript,1073,11366,1129.9134490740742,CLOSED,1,1,1,0,1,8,False,0,0,0,1928,2,40.97972222222222,Bug
TypeScript,1073,11366,1129.9091550925925,CLOSED,1,1,1,0,1,7,False,0,0,0,2139,2,41.050555555555555,Bug
TypeScript,1073,11366,1129.9551388888888,CLOSED,2,2,1,0,1,11,False,0,0,0,1909,4,14.769444444444444,Document
TypeScript,1073,11366,1129.8859143518519,CLOSED,1,1,1,2,1,4,False,1,1,1,1888,2,0.17083333333333334,Document
TypeScript,1073,11366,1129.8755439814815,CLOSED,1,1,1,0,1,3,False,0,0,0,1934,2,0.3875,Bug
TypeScript,4,33,797.9696412037038,MERGED,22,56,12,1,2,226,False,0,1,1,1612,78,0.24166666666666667,Feature
TypeScript,1073,11366,1129.8665277777777,CLOSED,2,2,1,0,2,2,False,0,0,0,1770,4,0.6102777777777778,Document
TypeScript,7,6,682.1772222222222,CLOSED,88,266,9,0,6,231,False,0,0,0,8219,354,233.3347222222222,Feature
Go,1835,11245,1765.9578472222222,CLOSED,2,2,1,0,1,115,True,0,0,0,1655,4,0.043055555555555555,Document
TypeScript,58,78,858.3382638888888,MERGED,434,1533,34,1,35,99,False,0,1,1,11561,1967,90.91222222222223,Bug
TypeScript,261,3765,712.7417939814815,MERGED,88,274,13,0,1,952,True,0,0,0,8759,362,0.34194444444444444,Document
TypeScript,202,107,1182.5425925925927,MERGED,288,178,4,2,7,266,True,0,2,2,5940,466,316.52194444444444,Document
TypeScript,41369,87413,2975.4529398148147,MERGED,1,56,6,0,1,50,False,0,0,0,5082,57,396.2191666666667,Document
TypeScript,1297,21107,452.0060416666667,CLOSED,6,660,10,1,12,1058,True,0,1,1,5194,666,386.5413888888889,Document
Go,1835,11245,1763.7977430555557,MERGED,4,2,1,0,2,112,True,0,0,0,1948,6,51.99472222222222,Document
JavaScript,8844,63474,4115.788912037037,CLOSED,49,642,40,4,6,0,False,2,2,2,4908,691,111.80972222222222,Feature
Go,1835,11245,1764.6281712962964,MERGED,1,1,1,0,1,564,False,0,0,0,1810,2,1.281111111111111,Document
TypeScript,1073,11366,1133.946712962963,MERGED,68,6,1,2,3,0,False,1,1,1,2079,74,211.35583333333332,Document
Go,1835,11245,1764.1592939814816,MERGED,3,0,2,0,1,563,False,0,0,0,2144,3,0.03361111111111111,Document
Go,1835,11245,1764.1337962962962,MERGED,3,1,1,0,1,113,True,0,0,0,1661,4,0.35444444444444445,Document
Go,1835,11245,1763.8315509259257,MERGED,1,4,1,0,1,561,False,0,0,0,2135,5,0.07277777777777777,Document
Go,1835,11245,1763.6813541666668,MERGED,4,4,2,0,1,174,False,0,0,0,2094,8,0.11722222222222223,Document
Rust,264,5384,440.96456018518523,MERGED,137,306,13,0,13,356,False,0,0,0,6048,443,76.48916666666666,Feature
Go,789,5551,1079.8928587962962,CLOSED,3,228,2,0,1,10,False,0,0,0,2662,231,2.0330555555555554,Document
TypeScript,7,6,680.1592939814815,MERGED,49,853,53,0,46,228,False,0,0,0,8419,902,115.13027777777778,Bug
Go,54,353,772.7761574074075,MERGED,489,353,10,1,4,237,True,0,1,1,6087,842,0.6955555555555556,Document
TypeScript,7,6,682.0061574074074,MERGED,58,20,7,1,5,27,True,0,1,1,6195,78,1.4383333333333332,Feature
Python,2407,12184,279.8872222222222,MERGED,4,7,1,0,3,337,True,0,0,0,2501,11,0.20694444444444443,Document
Python,1912,12141,103.82255787037037,CLOSED,1,1,1,3,1,0,False,2,1,1,1255,2,2.6394444444444445,Document
TypeScript,4,33,800.2823611111112,MERGED,893,1038,58,2,7,636,True,1,1,1,2542,1931,103.74944444444445,Document
Python,2407,12184,279.3391550925926,MERGED,1,1,1,0,1,335,True,0,0,0,2193,2,0.3269444444444444,Document
Rust,264,5384,440.98600694444445,MERGED,17,17,17,0,1,260,True,0,0,0,5924,34,0.7430555555555556,Bug
Python,2407,12184,279.3248032407408,MERGED,2,6,2,0,2,334,True,0,0,0,2577,8,0.11777777777777777,Document
TypeScript,1297,21107,455.62806712962964,MERGED,7,235,9,1,2,1076,True,0,1,1,5365,242,0.1361111111111111,Document
C++,2234,23696,2393.883900462963,MERGED,9,56,3,1,8,333,False,1,0,0,2778,65,90.205,Feature
Starlark,440,286,528.9018518518518,CLOSED,0,139,3,3,2,0,False,2,1,1,2480,139,1.8519444444444444,Feature
TypeScript,7,6,680.9761111111111,MERGED,1,214,12,0,5,229,False,0,0,0,8387,215,1.1730555555555555,Feature
Go,54,353,769.6929861111112,MERGED,1618,623,34,2,2,233,True,1,1,1,7115,2241,4.351666666666667,Bug
Go,11875,71340,2733.0292824074077,MERGED,147,209,10,0,1,290,True,0,0,0,7635,356,0.11972222222222222,Feature
Python,2407,12184,278.1594675925926,MERGED,4,4,3,0,2,323,True,0,0,0,2540,8,2.633888888888889,Document
PHP,883,2338,1867.5542708333332,CLOSED,2587,2950,55,3,1,199,False,1,2,1,6141,5537,129.90194444444444,Document
Python,2407,12184,278.00721064814815,MERGED,5,9,2,0,1,322,True,0,0,0,2707,14,1.1608333333333334,Document
TypeScript,41369,87413,2976.7040625000004,MERGED,3,32,6,0,8,456,True,0,0,0,3059,35,51.05833333333333,Document
TypeScript,3393,2334,1003.8155324074074,MERGED,16,8,2,2,1,0,False,0,2,1,2926,24,25.75583333333333,Bug
TypeScript,307,2556,574.6556597222223,MERGED,17,130,8,0,2,189,True,0,0,0,4818,147,120.99555555555555,Bug
Java,450,746,4107.219189814815,MERGED,162,581,25,2,3,81,True,0,2,1,6162,743,160.985,Bug
TypeScript,202,107,1181.804201388889,MERGED,250,26,10,2,1,263,True,0,2,2,6010,276,1.2294444444444443,Document
C++,2234,23696,2392.764849537037,MERGED,47,49,8,1,1,558,False,0,1,1,6288,96,1.6708333333333334,Feature
Python,2407,12184,276.9100810185185,MERGED,1,1,1,2,1,0,False,1,1,1,2240,2,9.583333333333334,Document
C#,655,7879,1865.9587847222222,MERGED,1232,4166,110,2,85,594,True,1,1,1,2514,5398,4.924166666666666,Document
TypeScript,1073,11366,1131.8114814814815,MERGED,1,1,1,2,1,0,False,0,2,2,2701,2,16.024166666666666,Bug
TypeScript,1073,11366,1131.8033101851852,MERGED,2,2,1,2,1,0,False,1,1,1,2281,4,16.23,Document
TypeScript,41369,87413,2974.059259259259,MERGED,97,158,8,0,18,36,False,0,0,0,5688,255,90.45916666666666,Document
Python,14532,41187,1122.427974537037,MERGED,5,53,1,2,6,3,False,0,2,1,2320,58,76.81166666666667,Document
Go,54,353,768.7695601851851,CLOSED,74,548,11,0,2,231,True,0,0,0,7184,622,0.3597222222222222,Bug
TypeScript,41369,87413,2973.0564236111113,CLOSED,294,794,34,4,19,18,False,1,3,2,5411,1088,110.48638888888888,Document
Python,14532,41187,1123.337662037037,MERGED,4,1,1,0,1,1423,True,0,0,0,2266,5,0.014444444444444444,Document
TypeScript,41369,87413,2972.6091319444445,MERGED,6,244,9,2,12,11,False,1,1,1,5436,250,100.68416666666667,Document
TypeScript,1073,11366,1129.9006712962962,CLOSED,1,1,1,0,1,6,False,0,0,0,2143,2,41.24722222222222,Bug
Python,4516,54989,961.1725231481481,MERGED,12,14,2,1,9,1,False,0,1,1,3188,26,7.348888888888889,Document
TypeScript,1073,11366,1129.8557407407409,MERGED,5,135,3,1,3,186,False,0,1,1,2148,140,23.455,Bug
TypeScript,1073,11366,1129.9375347222222,CLOSED,2,2,2,0,2,9,False,0,0,0,2204,4,15.709166666666667,Bug
TypeScript,1073,11366,1129.9424305555556,CLOSED,2,2,2,0,1,10,False,0,0,0,2654,4,15.065555555555555,Bug
TypeScript,4,33,797.9057523148149,MERGED,0,64,6,1,1,225,False,0,1,1,2528,64,0.34944444444444445,Document
TypeScript,85,723,352.17822916666665,MERGED,292,834,20,0,7,173,False,0,0,0,13640,1126,98.45222222222222,Document
TypeScript,140,827,783.2046412037038,MERGED,1,23,5,2,2,55,False,0,2,2,2456,24,6.456944444444445,Document
TypeScript,4,33,797.7305671296295,MERGED,92,168,10,1,5,224,False,0,1,1,2710,260,0.1075,Document
TypeScript,1073,11366,1129.8904166666666,CLOSED,2,2,1,0,1,5,False,0,0,0,2124,4,0.06,Bug
TypeScript,85,723,350.9705671296296,MERGED,1,7,1,0,7,172,False,0,0,0,13143,8,127.48916666666666,Document
TypeScript,41369,87413,2972.8526851851852,MERGED,29,27,2,0,1,1925,True,0,0,0,4676,56,0.21,Document
TypeScript,41369,87413,2972.6183449074074,MERGED,99,103,8,0,2,452,True,0,0,0,5247,202,2.013611111111111,Document
TypeScript,184,377,1949.1618171296295,MERGED,2,2,2,1,1,42,False,0,1,1,4446,4,61.933055555555555,Document
Go,1835,11245,1765.7696412037037,MERGED,0,134,18,0,1,2,False,0,0,0,2187,134,0.6525,Document
Go,1835,11245,1764.7996296296296,CLOSED,0,134,18,5,4,1,False,1,4,2,2432,134,24.725277777777777,Document
Go,1835,11245,1764.1481944444442,MERGED,552,587,3,1,1,175,False,0,1,1,2539,1139,0.23333333333333334,Document
Rust,264,5384,439.1501157407408,MERGED,314,541,46,0,3,175,False,0,0,0,10277,855,43.66361111111111,Feature
TypeScript,261,3765,711.789375,MERGED,19,705,32,0,3,948,True,0,0,0,10707,724,26.636666666666667,Document
TypeScript,261,3765,711.6351041666667,MERGED,73,140,23,0,5,628,True,0,0,0,11887,213,1.5577777777777777,Document
Python,4516,54989,961.5718634259259,MERGED,0,95,2,0,39,107,True,0,0,0,4716,95,179.30777777777777,Document
TypeScript,7,6,681.9409143518518,MERGED,202,800,23,1,12,291,False,0,1,1,8975,1002,22.725,Feature
Python,1912,12141,103.68274305555555,MERGED,5,49,3,1,5,12,False,1,0,0,2652,54,188.89805555555554,Bug
JavaScript,8844,63474,4115.295312499999,MERGED,474,1214,142,0,7,118,True,0,0,0,11947,1688,120.61805555555556,Document
Go,54,353,770.5519675925925,MERGED,537,750,31,2,2,234,True,2,0,0,10051,1287,9.465,Document
V,2097,34362,1588.427164351852,MERGED,65,601,3,8,8,2,False,3,5,2,7639,666,97.79333333333334,Document
JavaScript,22,26,955.1394328703703,MERGED,179,198,5,0,2,13,True,0,0,0,4472,377,83.3275,Bug
Go,1835,11245,1764.8559490740743,MERGED,13,19,4,0,2,27,True,0,0,0,3495,32,1.3641666666666667,Document
Python,2407,12184,279.1253819444444,MERGED,123,118,5,1,7,331,True,1,0,0,3991,241,3.7447222222222223,Document
Python,4516,54989,965.5167592592593,MERGED,2,33,2,0,12,0,False,0,0,0,3811,35,27.9425,Document
Python,2407,12184,278.90533564814814,MERGED,32,451,37,0,4,326,True,0,0,0,4987,483,0.35444444444444445,Document
Python,2407,12184,278.8881712962963,MERGED,1102,1104,93,0,6,325,True,0,0,0,4941,2206,0.30694444444444446,Document
TypeScript,1073,11366,1133.4824884259258,MERGED,1,12,2,3,1,1,False,1,2,2,3603,13,71.15,Bug
Python,4516,54989,963.9202777777778,MERGED,1,78,3,2,5,3,False,1,1,1,4528,79,58.955555555555556,Document
Python,2407,12184,277.12645833333335,MERGED,75,99,76,0,1,317,True,0,0,0,4702,174,0.042777777777777776,Document
Python,2407,12184,276.58783564814814,MERGED,4,5,1,1,3,3,False,0,1,1,3458,9,17.3375,Document
TypeScript,4803,40785,3796.6837384259256,MERGED,37,38,4,1,1,146,True,0,1,1,3784,75,22.308611111111112,Bug
TypeScript,41369,87413,2972.747974537037,CLOSED,299,287,34,1,9,24,False,0,1,1,9995,586,0.5502777777777778,Document
Python,4516,54989,960.9659722222223,MERGED,2,1,1,4,3,0,False,1,3,3,3220,3,31.37527777777778,Document
Erlang,2054,12122,3830.8816666666667,MERGED,1,1,1,0,1,507,True,0,0,0,2663,2,0.82,Document
TypeScript,1073,11366,1130.7350810185185,MERGED,0,57,3,3,1,8,True,1,2,2,3602,57,41.91166666666667,Bug
TypeScript,4,33,798.4913773148147,MERGED,62,84,7,4,1,635,True,3,1,1,4902,146,1.3608333333333333,Bug
TypeScript,1073,11366,1129.864074074074,MERGED,58,146,10,1,4,137,True,0,1,1,4344,204,19.420833333333334,Bug
TypeScript,1297,21107,455.4346296296296,CLOSED,50,17566,27,2,9,0,False,0,2,2,11164,17616,364.1386111111111,Document
TypeScript,85,723,351.0904513888889,MERGED,22300,11045,22,1,51,100,False,0,1,1,19234,33345,114.99666666666667,Document
Python,4516,54989,965.1336458333334,MERGED,45,85,2,5,14,0,False,0,5,3,6779,130,494.84472222222223,Document
TypeScript,1297,21107,453.93854166666665,MERGED,76,4424,16,1,1,1070,True,0,1,1,11772,4500,0.15611111111111112,Document
Erlang,2054,12122,3833.0885416666665,MERGED,128,139,35,2,5,414,True,1,1,1,3814,267,117.3625,Document
TypeScript,4803,40785,3795.6098842592596,MERGED,48,255,10,1,1,144,True,0,1,1,6017,303,20.35638888888889,Document
TypeScript,184,377,1949.1435879629628,MERGED,2,2,2,0,1,41,False,0,0,0,4646,4,59.33777777777778,Document
TypeScript,1073,11366,1130.8341203703703,MERGED,27343,26101,23,1,16,187,False,0,1,1,6456,53444,306.495,Document
Starlark,440,286,528.2963310185186,MERGED,69,326,1,1,2,74,False,0,1,1,4824,395,83.8386111111111,Feature
Python,4516,54989,965.5365625,MERGED,17,58,2,2,8,5,False,0,2,2,4648,75,35.117222222222225,Document
TypeScript,3393,2334,1006.1265162037038,MERGED,47,42,25,2,1,0,False,0,2,1,5807,89,61.19277777777778,Bug
Java,450,746,4109.215474537037,MERGED,454,1096,105,2,76,52,False,0,2,1,5780,1550,167.20111111111112,Bug
TypeScript,1073,11366,1131.781064814815,CLOSED,115,6,50,3,1,0,False,1,2,2,6295,121,112.57805555555555,Bug
Python,4516,54989,960.6678125,MERGED,24,30,1,3,9,0,False,2,1,1,4773,54,178.87583333333333,Document
TypeScript,3393,2334,1002.866712962963,MERGED,190,340,17,2,1,724,False,0,2,2,6754,530,0.2708333333333333,Bug
Go,1835,11245,1763.6144791666666,MERGED,3051,3106,8,1,1,37,False,0,1,1,7065,6157,1.5052777777777777,Document
Rust,264,5384,441.0148032407408,MERGED,201,77,13,0,1,275,True,0,0,0,15813,278,0.8972222222222223,Bug
Python,4516,54989,962.3337499999999,MERGED,5,11,1,0,2,0,False,0,0,0,8527,16,163.07333333333332,Document
TypeScript,4,33,798.4913425925926,MERGED,44,70,5,3,2,634,True,2,1,1,7918,114,1.2144444444444444,Document
Go,1835,11245,1764.099502314815,MERGED,2312,1045,36,1,9,562,False,0,1,1,9831,3357,306.5338888888889,Feature
TypeScript,4803,40785,3795.7580208333334,MERGED,175,172,20,1,3,145,True,0,1,1,9790,347,16.954444444444444,Document
TypeScript,4,33,798.3597569444445,MERGED,893,1390,86,1,117,388,True,0,1,1,8421,2283,54.96083333333333,Bug
Go,1835,11245,1765.0748263888888,MERGED,1132,1639,40,2,1,565,False,1,1,1,10324,2771,109.72083333333333,Document
Go,1835,11245,1765.260023148148,MERGED,1235,3028,37,1,3,10,False,0,1,1,8094,4263,84.44777777777777,Document
Java,450,746,4109.162592592593,MERGED,3444,8626,70,3,5,28,False,0,3,2,12573,12070,265.90555555555557,Bug
TypeScript,1073,11366,1133.4771527777777,CLOSED,1014,1551,65,0,108,0,False,0,0,0,14112,2565,0.07972222222222222,Bug
Go,1835,11245,1763.8921296296296,MERGED,68,305,16,0,4,38,False,0,0,0,10159,373,44.21805555555556,Document
TypeScript,1073,11366,1133.7779629629629,MERGED,1103,1583,66,1,119,142,True,0,1,1,17965,2686,0.11333333333333333,Bug
V,2097,34362,1591.9501736111113,MERGED,1,15,2,0,2,40,True,0,0,0,772,16,13.915833333333333,Feature
V,2097,34362,1594.8822222222223,MERGED,10,10,5,0,1,42,True,0,0,0,1445,20,8.059166666666666,Bug
TypeScript,15,34,531.9974652777778,CLOSED,0,25,1,1,2,1019,False,1,0,0,338,25,147.97222222222223,Feature
TypeScript,7,6,688.9401157407407,CLOSED,2,108,2,0,5,235,False,0,0,0,1118,110,942.3372222222222,Feature
V,2097,34362,1591.888263888889,MERGED,17,38,3,0,3,39,True,0,0,0,1179,55,32.645833333333336,Feature
Go,1835,11245,1768.8882291666666,CLOSED,33,42,1,0,1,122,False,0,0,0,287,75,1561.9283333333333,Feature
TypeScript,85,723,358.90064814814815,MERGED,1,1,1,3,3,6,False,1,2,1,1230,2,434.30333333333334,Document
Vue,10806,21163,1064.3607175925927,MERGED,101,224,4,1,3,31,False,0,1,1,2130,325,1485.6277777777777,Document
JavaScript,9664,43889,3701.073553240741,CLOSED,92,92,3,4,2,0,False,2,2,1,802,184,1655.0530555555556,Bug
,0,1,59.61025462962963,CLOSED,0,14,1,0,1,4,False,0,0,0,995,14,174.075,Feature
TypeScript,202,107,1188.6695833333333,MERGED,176,149,26,5,11,257,True,1,4,3,639,325,454.85527777777776,Bug
TypeScript,12,11,1032.231388888889,MERGED,1,4,1,0,1,171,False,0,0,0,761,5,118.38833333333334,Bug
PHP,883,2338,1872.8405902777777,CLOSED,0,99,3,3,6,2,False,1,2,2,2671,99,1588.39,Document
TypeScript,2147,14724,1513.9904282407408,MERGED,0,24,1,0,1,1,False,0,0,0,885,24,197.7722222222222,Feature
TypeScript,2147,14724,1515.0107291666666,MERGED,1,4,2,0,1,11,False,0,0,0,1141,5,116.07388888888889,Feature
TypeScript,2147,14724,1513.9092129629628,MERGED,1,8,1,0,1,36,False,0,0,0,624,9,23.626666666666665,Bug
JavaScript,5139,7050,1247.746840277778,MERGED,18,30,19,1,5,103,False,0,1,1,584,48,138.28277777777777,Feature
TypeScript,2147,14724,1513.2171180555554,MERGED,7,10,1,0,1,3,False,0,0,0,701,17,13.058333333333334,Bug
V,2097,34362,1593.5355671296295,MERGED,0,3,1,0,1,0,False,0,0,0,529,3,17.316111111111113,Bug
PHP,1334,2960,4249.0050810185185,MERGED,1,0,1,2,1,206,False,0,2,2,735,1,166.81277777777777,Document
TypeScript,2147,14724,1514.8193055555555,MERGED,98,139,5,1,8,17,False,0,1,1,1627,237,311.8222222222222,Feature
TypeScript,85,723,358.22098379629625,MERGED,1,3,1,0,1,27,False,0,0,0,1124,4,0.5030555555555556,Document
PHP,883,2338,1872.8234722222223,CLOSED,1,101,4,2,3,10,False,0,2,2,1539,102,863.0319444444444,Document
JavaScript,5139,7050,1246.7010532407407,MERGED,0,7,1,1,5,10,False,0,1,1,709,7,121.20611111111111,Document
TypeScript,202,107,1185.493125,MERGED,1,1,1,2,1,267,True,0,2,2,1442,2,0.5375,Document
TypeScript,12,11,1033.3629398148148,MERGED,45,70,3,0,4,58,False,0,0,0,1397,115,74.29972222222223,Document
TypeScript,12,11,1031.448576388889,MERGED,32,389,4,1,77,56,False,1,0,0,1816,421,160.77055555555555,Feature
PHP,1334,2960,4250.999571759259,CLOSED,17,17,4,3,5,163,False,1,2,2,1383,34,4.8933333333333335,Document
TypeScript,12,11,1029.3699421296296,MERGED,1,1,1,0,1,381,False,0,0,0,929,2,4.286666666666667,Bug
JavaScript,5139,7050,1248.1544328703703,MERGED,1,1,1,3,1,3,False,0,3,3,689,2,9.170277777777779,Feature
TypeScript,12,11,1029.2532291666666,MERGED,0,1,1,0,1,380,False,0,0,0,790,1,0.37805555555555553,Feature
PHP,1334,2960,4250.206423611111,MERGED,1,1,1,0,1,878,False,0,0,0,664,2,0.07777777777777778,Bug
TypeScript,2147,14724,1513.071724537037,MERGED,37,39,1,0,1,108,False,0,0,0,1042,76,16.6075,Feature
TypeScript,2147,14724,1514.0530324074073,MERGED,4,17,1,2,1,2,False,1,1,1,1973,21,212.19472222222223,Feature
JavaScript,5139,7050,1246.0090856481481,MERGED,1,1,1,1,1,9,False,0,1,1,672,2,16.061944444444446,Document
TypeScript,58,78,864.1334143518519,MERGED,25,21,1,1,2,224,True,0,1,1,1525,46,1.4313888888888888,Feature
JavaScript,5139,7050,1246.7821875,MERGED,51,80,10,2,13,11,False,1,1,1,1033,131,119.33472222222223,Feature
JavaScript,5139,7050,1245.8669907407407,MERGED,1,1,1,1,2,1,False,0,1,1,654,2,0.42333333333333334,Feature
TypeScript,58,78,862.4373842592591,CLOSED,0,13,1,2,8,217,True,0,2,1,1344,13,13.994444444444444,Feature
TypeScript,58,78,863.2502893518518,MERGED,2,1,1,1,1,103,False,0,1,1,1230,3,0.09888888888888889,Bug
JavaScript,5139,7050,1245.1576041666667,MERGED,1,1,1,2,1,107,False,0,2,2,653,2,11.939722222222223,Document
TypeScript,58,78,863.2374652777777,MERGED,2,2,1,1,1,180,False,0,1,1,1422,4,0.02,Feature
Python,547,7160,2279.7134953703703,CLOSED,1,1,1,0,9,235,False,0,0,0,479,2,26.198611111111113,Bug
TypeScript,202,107,1186.5068171296296,MERGED,0,1,1,3,1,252,True,0,3,3,634,1,18.088055555555556,Feature
PHP,1334,2960,4249.927581018518,MERGED,1,1,1,1,1,877,False,0,1,1,1046,2,0.1663888888888889,Feature
F#,271,818,2769.2332523148148,MERGED,1,44,1,0,1,12,True,0,0,0,1731,45,307.825,Document
Go,421,1654,1551.1544675925925,MERGED,5,5,1,0,1,465,True,0,0,0,1010,10,16.996388888888887,Document
TypeScript,58,78,862.5437962962964,MERGED,0,13,1,1,8,179,False,0,1,1,1210,13,11.43388888888889,Feature
TypeScript,261,3765,718.7747800925927,MERGED,2,3,2,0,2,634,True,0,0,0,1396,5,0.28444444444444444,Document
TypeScript,261,3765,718.7603356481482,MERGED,1,1,1,0,1,633,True,0,0,0,1099,2,0.06388888888888888,Document
PHP,1334,2960,4249.341192129629,MERGED,2,0,1,2,1,207,False,0,2,2,864,2,0.45944444444444443,Document
TypeScript,12,11,1030.386886574074,MERGED,4,4,3,0,2,53,False,0,0,0,1701,8,20.927777777777777,Feature
TypeScript,12,11,1029.577847222222,MERGED,0,19,2,0,1,383,False,0,0,0,1605,19,42.90777777777778,Feature
TypeScript,2070,16640,1283.8136458333333,MERGED,1,1,1,0,1,0,False,0,0,0,1007,2,199.55944444444444,Bug
TypeScript,12,11,1031.3776157407408,MERGED,66,1337,9,1,59,55,False,1,0,0,2352,1403,151.0036111111111,Feature
PHP,1334,2960,4248.146354166666,MERGED,4,4,1,2,1,23,False,0,2,2,1191,8,44.45,Feature
Python,72,25,1680.6914814814816,MERGED,1,30,2,0,1,35,False,0,0,0,939,31,66.98722222222223,Feature
TypeScript,261,3765,717.9069097222223,MERGED,61,1,2,0,1,967,True,0,0,0,1456,62,0.2797222222222222,Document
TypeScript,2147,14724,1515.0324189814817,MERGED,3,5,3,0,1,185,False,0,0,0,1238,8,1.0002777777777778,Bug
TypeScript,261,3765,717.7591435185185,MERGED,1,1,1,0,1,966,True,0,0,0,1230,2,0.03,Document
TypeScript,12,11,1029.5559953703703,MERGED,1,1,1,0,1,382,False,0,0,0,1232,2,15.671666666666667,Bug
Python,19248,70258,2504.1661342592593,CLOSED,160,159,96,1,3,143,False,0,1,1,741,319,41.14333333333333,Bug
TypeScript,261,3765,717.6577314814814,MERGED,2,1,2,0,1,195,False,0,0,0,1567,3,0.4147222222222222,Document
TypeScript,12,11,1029.124722222222,MERGED,95,312,4,0,10,44,False,0,0,0,1513,407,30.645833333333332,Feature
V,2097,34362,1595.4410532407408,MERGED,2,27,3,0,1,236,True,0,0,0,759,29,6.2675,Bug
JavaScript,5139,7050,1246.1271875,MERGED,1,4,1,1,5,2,False,0,1,1,1048,5,10.234444444444444,Bug
TypeScript,178,1359,366.2976851851852,MERGED,1,2,1,1,1,45,True,0,1,1,2110,3,8.223611111111111,Document
TypeScript,85,723,357.1504861111111,MERGED,1,11,1,0,1,26,False,0,0,0,1832,12,0.16055555555555556,Document
Python,547,7160,2281.7111226851853,MERGED,27,74,8,1,12,31,False,0,1,1,653,101,120.64055555555555,Feature
C++,2234,23696,2400.4177777777777,MERGED,2,5,3,3,2,180,False,0,3,2,1160,7,81.05055555555556,Bug
TypeScript,261,3765,716.656111111111,MERGED,4,2,2,0,1,194,False,0,0,0,1693,6,0.7930555555555555,Document
TypeScript,58,78,863.1798032407409,MERGED,182,241,13,1,4,102,False,0,1,1,987,423,0.5155555555555555,Feature
TypeScript,261,3765,716.47375,MERGED,7,32,4,0,2,109,True,0,0,0,1647,39,4.822222222222222,Document
C++,2234,23696,2397.7049537037037,MERGED,3,3,1,1,1,45,False,0,1,1,770,6,3.591388888888889,Bug
TypeScript,41369,87413,2977.8583333333336,CLOSED,4,2,1,2,1,54,False,1,1,1,2915,6,2.1041666666666665,Document
TypeScript,85,723,357.3034953703704,MERGED,70,88,2,0,1,177,False,0,0,0,2326,158,136.87305555555557,Document
Python,547,7160,2281.602997685185,MERGED,275,607,23,2,39,32,False,1,1,1,693,882,337.215,Bug
TypeScript,2147,14724,1512.818252314815,MERGED,5,6,1,0,1,310,False,0,0,0,1594,11,1.7616666666666667,Feature
PHP,1334,2960,4251.024699074074,CLOSED,16,16,1,1,1,89,False,0,1,1,1550,32,2.9430555555555555,Document
TypeScript,7,6,686.1200462962962,MERGED,7,15,2,0,3,294,False,0,0,0,916,22,44.13333333333333,Feature
TypeScript,7,6,686.9518171296296,MERGED,1,1,1,1,2,30,True,0,1,1,842,2,0.11444444444444445,Feature
TypeScript,58,78,863.292962962963,MERGED,15,15,1,1,1,182,False,0,1,1,1804,30,0.029166666666666667,Feature
C++,2234,23696,2398.8877430555553,MERGED,3,3,1,1,1,340,False,0,1,1,855,6,1.7841666666666667,Bug
TypeScript,4803,40785,3802.604027777778,MERGED,0,15,1,5,2,12,False,1,4,3,671,15,362.1777777777778,Bug
TypeScript,261,3765,717.8321064814814,MERGED,1,7,2,0,3,145,True,0,0,0,1384,8,1.801111111111111,Document
TypeScript,2147,14724,1515.0279050925926,MERGED,6,27,1,0,1,87,False,0,0,0,1918,33,0.13,Feature
TypeScript,261,3765,718.50375,MERGED,15,27,3,0,1,968,True,0,0,0,2143,42,0.02388888888888889,Document
PHP,1334,2960,4249.026238425926,MERGED,4,3,1,2,3,875,False,1,1,1,1149,7,28.27777777777778,Document
Go,395,660,1306.153298611111,MERGED,77,131,3,2,9,69,False,1,1,1,349,208,571.6091666666666,Bug
Vue,10806,21163,1064.945162037037,MERGED,1,1,1,1,1,0,False,0,1,1,1374,2,91.94694444444444,Bug
TypeScript,202,107,1187.8602893518519,MERGED,4,4,1,3,1,256,True,0,3,3,1151,8,10.033611111111112,Feature
TypeScript,261,3765,717.6891666666667,MERGED,3,30,5,1,2,269,True,0,1,1,2149,33,0.7708333333333334,Document
TypeScript,58,78,861.3568171296297,MERGED,382,497,69,1,3,214,True,0,1,1,1830,879,0.8472222222222222,Bug
TypeScript,261,3765,716.5116550925926,MERGED,5,5,1,0,1,110,True,0,0,0,1817,10,71.97583333333333,Document
TypeScript,2147,14724,1514.0063194444444,MERGED,3,69,3,0,1,109,False,0,0,0,2211,72,18.25638888888889,Document
Python,547,7160,2280.630486111111,MERGED,24,114,2,0,10,84,False,0,0,0,989,138,26.294166666666666,Bug
TypeScript,261,3765,717.7658912037036,MERGED,1,9,3,0,2,228,False,0,0,0,2134,10,1.3988888888888888,Document
TypeScript,202,107,1187.5399421296295,MERGED,3,7,1,3,1,254,True,0,3,3,1127,10,4.695,Bug
TypeScript,202,107,1187.5334027777778,MERGED,1,1,1,3,1,275,True,0,3,3,1049,2,4.8597222222222225,Document
TypeScript,202,107,1187.5256712962962,MERGED,1,1,1,4,1,274,True,0,4,3,917,2,5.028888888888889,Document
TypeScript,202,107,1187.4788657407407,MERGED,0,1,1,3,2,272,True,0,3,3,1107,1,6.177777777777778,Document
PHP,1334,2960,4249.03625,MERGED,3,3,3,1,1,876,False,0,1,1,1212,6,0.2675,Document
TypeScript,261,3765,717.6173842592593,MERGED,52,59,3,0,1,965,True,0,0,0,1834,111,0.3283333333333333,Document
V,2097,34362,1593.9345949074075,MERGED,96,59,7,1,3,41,True,0,1,1,3443,155,7.84,Feature
F#,153,337,2960.7037152777775,MERGED,37,43,3,4,3,37,False,1,3,1,1486,80,2.4319444444444445,Bug
Python,547,7160,2280.4621527777776,MERGED,6,42,18,0,15,236,False,0,0,0,948,48,5.524444444444445,Bug
TypeScript,261,3765,716.8441319444445,MERGED,1,8,2,0,1,117,False,0,0,0,1806,9,19.27638888888889,Document
V,2097,34362,1594.240127314815,MERGED,1,33,2,0,2,486,True,0,0,0,1009,34,34.93666666666667,Bug
TypeScript,202,107,1186.8683564814814,MERGED,84,97,2,3,2,253,True,0,3,3,1171,181,9.428611111111111,Bug
Python,547,7160,2280.2312731481484,CLOSED,2,2,1,2,1,0,False,0,2,1,1144,4,5.603055555555556,Bug
TypeScript,2147,14724,1513.0498726851854,MERGED,5,16,1,0,1,183,False,0,0,0,1786,21,17.29361111111111,Feature
TypeScript,261,3765,716.5131828703703,MERGED,2,39,4,0,1,958,True,0,0,0,1965,41,8.316944444444445,Document
TypeScript,261,3765,716.7987268518518,MERGED,3,11,4,0,1,269,True,0,0,0,1900,14,7.266111111111111,Document
Go,421,1654,1550.1224189814814,MERGED,8,11,1,0,1,108,False,0,0,0,1564,19,0.8888888888888888,Document
TypeScript,261,3765,716.7073032407408,MERGED,0,8,2,0,2,268,True,0,0,0,1779,8,0.20694444444444443,Document
TypeScript,261,3765,716.6884837962963,MERGED,0,56,2,0,1,960,True,0,0,0,1693,56,0.13583333333333333,Document
Vue,293,495,871.1258449074074,MERGED,0,7,1,4,1,400,False,0,4,3,816,7,0.6097222222222223,Bug
Vue,10806,21163,1065.0082523148149,MERGED,0,27,1,0,1,186,False,0,0,0,1206,27,4.8805555555555555,Bug
TypeScript,12,11,1031.3717476851853,MERGED,53,727,7,0,15,54,False,0,0,0,3002,780,149.42333333333335,Feature
Go,395,660,1307.9723148148148,MERGED,1,15,1,0,3,343,False,0,0,0,157,16,121.73083333333334,Feature
PHP,1334,2960,4251.2235995370365,MERGED,70,46,4,1,1,164,False,0,1,1,2147,116,0.48333333333333334,Document
Go,2083,11769,1561.9561111111109,MERGED,1,1,1,4,1,0,False,2,2,2,1173,2,7.8,Document
TypeScript,307,2556,578.4606365740741,MERGED,1,1,1,2,1,308,True,0,2,2,972,2,11.274444444444445,Feature
Vue,10806,21163,1063.0411805555557,MERGED,6,10,2,0,2,185,False,0,0,0,1249,16,24.230555555555554,Bug
Vue,10806,21163,1063.2171296296297,MERGED,1,1,1,0,1,98,False,0,0,0,1176,2,0.1025,Document
TypeScript,7,6,688.1617824074074,MERGED,6,6,1,0,4,280,False,0,0,0,1355,12,19.35861111111111,Feature
C#,80,125,860.513125,CLOSED,57,131,5,0,5,199,False,0,0,0,1147,188,1418.5452777777778,Document
TypeScript,202,107,1187.8352777777777,MERGED,1,1,1,3,2,71,True,0,3,3,1384,2,137.1436111111111,Document
Python,547,7160,2280.466273148148,MERGED,2,39,2,1,4,1,False,0,1,1,1229,41,8.335277777777778,Bug
Vue,293,495,872.8227893518518,MERGED,35,420,12,16,35,67,False,6,10,6,1476,455,145.67833333333334,Bug
Go,395,660,1308.1335300925925,MERGED,1,6,1,0,1,345,False,0,0,0,217,7,0.6077777777777778,Feature
Go,395,660,1306.9263657407407,MERGED,1,7,1,0,2,70,False,0,0,0,216,8,146.56166666666667,Bug
TypeScript,202,107,1184.1661342592593,MERGED,91,90,3,7,7,8,False,1,6,4,1479,181,277.7263888888889,Document
TypeScript,12,11,1031.2473726851852,MERGED,1,21,1,0,3,169,False,0,0,0,2914,22,0.2088888888888889,Feature
Go,421,1654,1550.211111111111,MERGED,47,54,3,0,1,464,True,0,0,0,2063,101,3.9594444444444443,Bug
Python,19248,70258,2504.7814814814815,CLOSED,2,7,1,2,1,1626,False,2,0,0,270,9,16.960833333333333,Feature
TypeScript,15,34,533.6605671296296,MERGED,33,36,1,0,1,1026,False,0,0,0,190,69,1.8983333333333334,Bug
TypeScript,15,34,533.5833217592593,MERGED,6,6,1,0,1,1024,False,0,0,0,267,12,0.11,Feature
TypeScript,15,34,533.4247569444444,MERGED,1,1,1,0,1,504,True,0,0,0,274,2,1.6780555555555556,Bug
JavaScript,8844,63474,4118.6274884259265,MERGED,2,95,7,0,4,3,False,0,0,0,1323,97,38.81638888888889,Feature
TypeScript,261,3765,718.7821759259259,MERGED,79,7,10,0,2,972,True,0,0,0,2634,86,1.3505555555555555,Document
Go,395,660,1306.9920486111112,MERGED,1,1,1,0,1,89,False,0,0,0,192,2,0.12527777777777777,Feature
TypeScript,261,3765,718.557800925926,MERGED,17,29,5,0,2,229,False,0,0,0,2499,46,0.5066666666666667,Document
TypeScript,307,2556,580.6542476851852,MERGED,30,30,2,0,2,309,True,0,0,0,1048,60,166.35,Feature
JavaScript,9664,43889,3698.791597222222,MERGED,30,30,1,0,1,2,False,0,0,0,234,60,2.88,Feature
TypeScript,2147,14724,1514.8250694444444,MERGED,9,66,3,0,4,52,False,0,0,0,3208,75,2.7655555555555558,Document
TypeScript,307,2556,578.9256944444445,MERGED,2,2,1,3,3,6,False,0,3,2,966,4,233.2375,Bug
TypeScript,15,34,532.5143287037037,MERGED,11,14,5,0,5,1020,False,0,0,0,241,25,5.0088888888888885,Feature
TypeScript,2147,14724,1514.0288425925926,MERGED,15,68,2,0,1,184,False,0,0,0,3101,83,2.525,Document
TypeScript,178,1359,362.4460763888889,MERGED,89,35,1,1,2,17,True,0,1,1,2970,124,10.881666666666666,Feature
V,2097,34362,1594.8165972222223,MERGED,6,63,3,3,4,235,True,1,2,1,1695,69,55.61388888888889,Bug
Vue,293,495,872.089050925926,MERGED,9,24,4,7,4,402,False,2,5,3,1130,33,65.01833333333333,Bug
TypeScript,7,6,684.996886574074,MERGED,20,86,4,0,6,28,True,0,0,0,1137,106,24.147222222222222,Feature
TypeScript,85,723,357.1921875,MERGED,12,12,5,0,1,104,False,0,0,0,3461,24,0.3488888888888889,Document
TypeScript,261,3765,717.703912037037,MERGED,37,50,8,0,1,270,True,0,0,0,2588,87,4.3869444444444445,Document
TypeScript,202,107,1187.815763888889,MERGED,2,2,2,3,1,277,True,0,3,3,1326,4,11.09388888888889,Document
TypeScript,261,3765,717.713275462963,MERGED,1,14,2,0,2,111,True,0,0,0,2205,15,0.8980555555555556,Document
Go,395,660,1306.038599537037,MERGED,7,3,1,0,3,28,False,0,0,0,205,10,92.85138888888889,Feature
TypeScript,202,107,1187.5358449074074,MERGED,7,6,1,3,1,276,True,0,3,3,1329,13,4.778333333333333,Document
Go,395,660,1308.9794560185185,MERGED,2,51,8,0,1,346,False,0,0,0,362,53,97.5975,Feature
TypeScript,202,107,1187.4976157407407,MERGED,2,2,1,3,1,273,True,0,3,3,1329,4,5.688611111111111,Document
JavaScript,9664,43889,3700.0129398148147,CLOSED,97,448,17,1,11,637,False,1,0,0,466,545,181.0611111111111,Bug
Kotlin,164,4296,445.5399074074074,MERGED,67451,1,154,0,1,58,False,0,0,0,310,67452,4.679722222222222,Document
Go,395,660,1308.0018171296297,MERGED,10,69,2,1,5,344,False,1,0,0,362,79,121.22194444444445,Feature
TypeScript,15,34,531.7893402777778,MERGED,1,3,1,0,2,1018,False,0,0,0,238,4,2.8269444444444445,Feature
TypeScript,15,34,531.6794907407408,MERGED,8,203,5,0,5,1014,False,0,0,0,260,211,7.626666666666667,Feature
Go,395,660,1306.9988194444445,MERGED,17,16,1,1,1,90,False,0,1,1,270,33,0.021388888888888888,Feature
Go,395,660,1306.986076388889,MERGED,4,16,2,0,2,18,False,0,0,0,281,20,22.13888888888889,Feature
C#,655,7879,1872.2778587962964,MERGED,4,4,1,1,1,1511,True,0,1,1,490,8,103.32555555555555,Bug
TypeScript,202,107,1187.0780439814814,MERGED,63,67,2,3,1,270,True,0,3,3,1279,130,3.528888888888889,Document
TypeScript,202,107,1186.8783333333333,MERGED,3,3,3,3,1,269,True,0,3,3,1633,6,9.158888888888889,Document
TypeScript,23,38,1613.8751157407407,MERGED,4,33,6,1,2,46,False,1,0,0,273,37,69.51138888888889,Feature
Vue,293,495,871.4769907407408,MERGED,1,12,1,11,4,25,True,2,9,5,1254,13,32.80583333333333,Bug
Vue,293,495,872.0075694444445,MERGED,12,13,3,7,2,401,False,1,6,4,1132,25,4.280833333333334,Bug
Kotlin,164,4296,444.80699074074073,MERGED,931,3,35,0,3,57,False,0,0,0,314,934,2.3125,Feature
PHP,883,2338,1876.3107291666665,CLOSED,4,458,8,3,1,86,False,2,1,1,2368,462,515.2061111111111,Document
Go,395,660,1307.117337962963,MERGED,1,111,1,0,6,114,False,0,0,0,277,112,139.47416666666666,Feature
Go,395,660,1306.0389236111112,MERGED,0,1,1,0,1,29,False,0,0,0,223,1,26.59611111111111,Feature
TypeScript,3393,2334,1008.4144675925926,CLOSED,4,10,1,1,1,350,False,0,1,1,1839,14,0.32972222222222225,Feature
TypeScript,7,6,688.229675925926,MERGED,128,1003,36,0,4,253,False,0,0,0,5113,1131,959.9927777777777,Feature
Go,421,1654,1549.9691087962963,MERGED,240,315,7,1,1,16,False,0,1,1,2804,555,146.57222222222222,Bug
TypeScript,15,34,530.3685648148148,MERGED,4,1,1,0,1,501,True,0,0,0,269,5,5.921111111111111,Feature
TypeScript,15,34,533.357048611111,MERGED,3,44,3,0,2,503,True,0,0,0,373,47,20.549166666666668,Bug
Go,395,660,1306.2576157407407,MERGED,0,73,1,0,1,88,False,0,0,0,334,73,39.82388888888889,Feature
TypeScript,15,34,533.7133796296297,MERGED,2,25,2,0,1,1027,False,0,0,0,349,27,0.5869444444444445,Document
Python,19248,70258,2503.5624305555557,CLOSED,28,9,4,2,2,1623,False,2,0,0,490,37,5.187777777777778,Feature
JavaScript,9664,43889,3699.92125,MERGED,24,494,6,0,1,831,True,0,0,0,501,518,0.31333333333333335,Bug
V,2097,34362,1592.5464583333332,MERGED,2,9,1,4,2,14,True,1,3,2,1415,11,69.73138888888889,Document
TypeScript,202,107,1185.5487037037037,MERGED,439,448,3,3,5,268,True,0,3,3,1338,887,26.95916666666667,Document
TypeScript,15,34,533.4822106481481,MERGED,4,6,1,0,1,505,True,0,0,0,275,10,2.5394444444444444,Bug
Kotlin,164,4296,446.54431712962963,MERGED,290,0,8,0,1,59,False,0,0,0,461,290,4.418888888888889,Feature
TypeScript,12,11,1032.4419097222224,MERGED,543,1242,5,0,14,119,False,0,0,0,4879,1785,192.75,Bug
JavaScript,9664,43889,3701.804166666667,MERGED,32,32,2,0,1,267,True,0,0,0,449,64,0.25055555555555553,Feature
TypeScript,15,34,532.3742592592592,MERGED,241,630,32,0,18,347,False,0,0,0,321,871,45.239444444444445,Feature
JavaScript,9664,43889,3698.9343981481484,MERGED,1,1,1,0,1,3,False,0,0,0,269,2,2.4944444444444445,Feature
JavaScript,9664,43889,3698.7732175925926,MERGED,7,7,1,0,1,1,False,0,0,0,282,14,3.2416666666666667,Feature
JavaScript,3618,9016,2327.8482638888886,MERGED,17,569,3,15,66,68,False,5,10,5,2563,586,550.455,Bug
JavaScript,5139,7050,1245.9180208333335,MERGED,0,34,17,1,2,8,False,0,1,1,3663,34,139.98583333333335,Document
JavaScript,9664,43889,3700.9463310185183,MERGED,77,77,1,2,1,4,False,1,1,1,404,154,21.25861111111111,Feature
TypeScript,15,34,532.7299421296296,MERGED,245,423,2,0,1,1023,False,0,0,0,277,668,0.37166666666666665,Bug
V,2097,34362,1592.9799189814814,MERGED,2,8,1,0,1,22,True,0,0,0,1411,10,3.598888888888889,Document
TypeScript,15,34,532.6797106481482,MERGED,12,60,6,0,2,348,False,0,0,0,383,72,1.0930555555555554,Feature
TypeScript,12,11,1030.7598611111111,MERGED,422,1559,7,0,29,118,False,0,0,0,4584,1981,233.5336111111111,Feature
TypeScript,42,46,813.8835532407408,MERGED,0,2659,15,2,1,32,False,0,2,2,447,2659,25.09138888888889,Feature
JavaScript,9664,43889,3700.1142939814818,MERGED,22,62,6,7,5,1,False,5,2,2,750,84,117.06583333333333,Feature
TypeScript,4,33,804.3304976851852,CLOSED,0,4,1,1,2,75,False,0,1,1,889,4,562.9311111111111,Document
TypeScript,15,34,531.3976504629629,MERGED,28,111,7,2,5,502,True,1,1,1,374,139,22.488333333333333,Feature
TypeScript,15,34,531.7495601851853,MERGED,1,2,2,0,1,1016,False,0,0,0,265,3,3.381666666666667,Feature
V,2097,34362,1591.6743287037036,MERGED,0,2694,4,1,3,13,True,1,0,0,1601,2694,20.10527777777778,Feature
TypeScript,15,34,531.7381828703703,MERGED,4,2,1,0,2,1015,False,0,0,0,383,6,0.25222222222222224,Feature
JavaScript,5139,7050,1246.559363425926,MERGED,21,605,10,3,6,102,False,1,2,2,2588,626,48.19111111111111,Feature
TypeScript,202,107,1186.8926851851852,MERGED,225,315,17,2,15,12,True,0,2,2,2373,540,131.2552777777778,Document
TypeScript,15,34,531.5570717592592,MERGED,2,2,1,0,1,57,False,0,0,0,366,4,4.581388888888889,Feature
JavaScript,34,25,238.37913194444445,MERGED,0,42,3,0,1,36,False,0,0,0,277,42,0.1213888888888889,Bug
Kotlin,164,4296,444.77082175925926,MERGED,639,0,14,0,1,56,False,0,0,0,438,639,0.8158333333333333,Feature
TypeScript,15,34,534.2364699074075,MERGED,41,56,7,0,2,140,False,0,0,0,525,97,1.2666666666666666,Feature
Go,421,1654,1550.3361574074072,MERGED,9,702,8,0,2,111,False,0,0,0,3160,711,12.556111111111111,Document
Go,395,660,1306.0171412037037,MERGED,1,40,2,0,3,17,False,0,0,0,331,41,45.51416666666667,Feature
TypeScript,15,34,533.7723148148149,MERGED,5,10,1,0,2,1028,False,0,0,0,398,15,0.03027777777777778,Document
TypeScript,7,6,685.0229282407407,MERGED,29,149,6,0,14,232,False,0,0,0,1855,178,45.1875,Document
TypeScript,15,34,530.6149768518518,MERGED,10,15,4,0,3,1008,False,0,0,0,295,25,2.020277777777778,Feature
Vue,293,495,872.6703240740741,MERGED,1,5,1,5,1,26,True,0,5,5,1772,6,51.0725,Bug
JavaScript,5139,7050,1246.0682870370372,MERGED,22,22,17,1,2,299,False,0,1,1,3425,44,2.9869444444444446,Bug
TypeScript,7,6,687.9506018518518,MERGED,25,287,6,0,24,32,True,0,0,0,3234,312,267.59472222222223,Feature
TypeScript,15,34,532.2672222222222,MERGED,4,61,3,1,11,179,False,1,0,0,461,65,47.11638888888889,Feature
TypeScript,15,34,530.2545717592592,MERGED,2,2,1,0,1,499,True,0,0,0,256,4,4.94,Feature
TypeScript,15,34,530.30375,MERGED,21,3,2,0,1,500,True,0,0,0,291,24,0.3375,Feature
TypeScript,2147,14724,1515.102997685185,MERGED,8,29,6,0,2,88,False,0,0,0,4053,37,136.70361111111112,Feature
JavaScript,9664,43889,3698.3971064814814,MERGED,26,26,1,0,1,0,False,0,0,0,482,52,15.382777777777777,Feature
Java,450,746,4116.186319444444,MERGED,108,219,17,1,10,12,False,0,1,1,717,327,91.99583333333334,Feature
TypeScript,15,34,532.8416435185185,MERGED,0,145,2,0,5,59,False,0,0,0,436,145,0.09055555555555556,Feature
V,2097,34362,1595.6165625,MERGED,0,19,3,0,1,219,True,0,0,0,2036,19,1.9108333333333334,Document
C#,655,7879,1869.3611458333335,MERGED,32,1711,9,1,7,1504,True,0,1,1,2025,1743,377.56194444444446,Document
TypeScript,15,34,532.7147800925926,MERGED,71,0,2,1,1,58,False,0,1,1,436,71,0.6288888888888889,Document
TypeScript,15,34,532.6435532407407,MERGED,31,74,5,0,2,1021,False,0,0,0,492,105,2.1772222222222224,Feature
TypeScript,12,11,1032.6958217592594,MERGED,51,297,3,1,3,57,False,1,0,0,3763,348,13.8425,Feature
TypeScript,58,78,864.1332986111111,MERGED,69,429,16,1,7,223,True,0,1,1,5090,498,1.431111111111111,Feature
JavaScript,9664,43889,3698.9687152777774,MERGED,378,682,18,0,15,321,True,0,0,0,570,1060,163.46694444444444,Feature
TypeScript,85,723,357.12831018518517,MERGED,105,135,10,0,6,103,False,0,0,0,4076,240,142.18305555555557,Document
TypeScript,15,34,531.7587731481482,MERGED,7,13,3,0,1,1017,False,0,0,0,439,20,19.093611111111112,Feature
JavaScript,9664,43889,3701.8541435185184,MERGED,80,79,9,0,1,268,True,0,0,0,625,159,0.39805555555555555,Feature
Go,2083,11769,1559.0091435185186,MERGED,3,3,1,2,1,0,False,0,2,2,1486,6,1.413888888888889,Document
C#,80,125,860.6628587962963,MERGED,8,8,2,0,4,2,True,0,0,0,591,16,195.43416666666667,Document
Go,2083,11769,1562.8597916666668,CLOSED,1,2,1,3,1,2,False,1,2,2,1753,3,70.31527777777778,Document
TypeScript,58,78,863.1540393518518,MERGED,39,42,3,1,3,101,False,0,1,1,3838,81,0.31722222222222224,Bug
TypeScript,15,34,531.5440277777778,MERGED,101,235,7,0,8,1012,False,0,0,0,416,336,2.446111111111111,Document
TypeScript,15,34,533.660150462963,MERGED,121,121,2,1,1,1025,False,0,1,1,529,242,92.69416666666666,Bug
TypeScript,41369,87413,2978.6252662037036,CLOSED,0,14,1,0,1,1937,True,0,0,0,2095,14,0.6822222222222222,Document
TypeScript,178,1359,364.0426967592593,MERGED,48,48,2,1,1,30,True,0,1,1,3997,96,0.3952777777777778,Bug
F#,153,337,2960.7130208333333,MERGED,116,170,14,6,13,38,False,2,4,2,3783,286,267.77722222222224,Bug
V,2097,34362,1593.2219907407407,MERGED,1,0,1,1,1,3,False,1,0,0,1754,1,3.2383333333333333,Document
Go,2083,11769,1562.8538541666667,CLOSED,1,2,1,0,3,1,False,0,0,0,1739,3,0.05388888888888889,Document
TypeScript,85,723,358.0215625,MERGED,47,67,7,0,6,8,False,0,0,0,3986,114,0.5705555555555556,Document
JavaScript,9664,43889,3700.0075347222223,MERGED,0,1,1,0,1,64,True,0,0,0,605,1,0.2038888888888889,Bug
TypeScript,2070,16640,1284.2024074074075,CLOSED,1,15,2,4,2,0,False,1,3,1,2711,16,221.7411111111111,Bug
TypeScript,41369,87413,2979.460810185185,CLOSED,3,0,1,0,1,0,False,0,0,0,2039,3,3.688888888888889,Document
TypeScript,7,6,685.1951273148148,MERGED,3232,3639,131,0,28,292,False,0,0,0,3080,6871,215.2411111111111,Feature
JavaScript,9664,43889,3699.0615162037034,MERGED,58,79,6,0,2,265,True,0,0,0,513,137,0.2713888888888889,Bug
TypeScript,85,723,356.9996180555556,MERGED,1,24,6,0,3,24,False,0,0,0,3894,25,1.1077777777777778,Document
TypeScript,202,107,1184.1683564814814,MERGED,231,319,2,12,9,9,False,3,9,4,2655,550,374.8858333333333,Bug
TypeScript,41369,87413,2978.8311574074073,MERGED,2,2,1,0,1,1938,True,0,0,0,2088,4,0.08361111111111111,Document
Go,54,353,776.1888773148148,MERGED,0,5,2,0,2,76,True,0,0,0,2571,5,188.1461111111111,Document
TypeScript,41369,87413,2978.5843287037037,MERGED,3,5,1,0,1,1935,True,0,0,0,2134,8,5.998055555555555,Document
TypeScript,15,34,532.7202546296296,MERGED,1,2,1,0,1,1022,False,0,0,0,524,3,4.920277777777778,Bug
TypeScript,261,3765,717.5542361111111,MERGED,429,78,33,0,2,964,True,0,0,0,4019,507,2.8697222222222223,Document
JavaScript,34,25,238.27244212962964,MERGED,1,63,2,0,2,0,False,0,0,0,1619,64,12.644722222222223,Document
TypeScript,261,3765,717.5257291666667,MERGED,183,35,10,0,2,963,True,0,0,0,3189,218,0.5858333333333333,Document
TypeScript,3393,2334,1008.1301157407407,CLOSED,2,2,2,2,3,482,False,0,2,1,1115,4,339.18416666666667,Bug
Python,19248,70258,2504.562997685185,CLOSED,1726,1774,4,3,5,1625,False,3,0,0,719,3500,106.58,Bug
JavaScript,9664,43889,3698.089560185185,MERGED,31,33,3,0,2,636,False,0,0,0,549,64,1.3677777777777778,Feature
TypeScript,41369,87413,2977.6404398148147,MERGED,0,9,1,0,1,605,True,0,0,0,2091,9,18.690277777777776,Document
JavaScript,9664,43889,3697.8371875,MERGED,8,8,50,0,1,264,True,0,0,0,556,16,0.48,Feature
JavaScript,9664,43889,3700.315428240741,MERGED,3,5,3,0,3,1,False,0,0,0,1077,8,685.0502777777778,Bug
TypeScript,202,107,1187.9461111111111,MERGED,180,32,7,3,8,278,True,0,3,3,2989,212,134.49055555555555,Document
TypeScript,41369,87413,2977.769189814815,MERGED,4,4,1,0,2,1934,True,0,0,0,2098,8,0.31777777777777777,Document
TypeScript,7,6,687.0064814814815,MERGED,1,596,12,0,21,250,False,0,0,0,3491,597,46.83611111111111,Feature
C++,2234,23696,2399.984479166667,MERGED,7,0,1,0,2,344,False,0,0,0,1001,7,95.4275,Feature
TypeScript,15,34,531.4475462962963,MERGED,15,75,6,0,3,178,False,0,0,0,632,90,16.531111111111112,Bug
TypeScript,15,34,531.2725115740741,MERGED,72,102,4,0,3,177,False,0,0,0,532,174,21.259444444444444,Feature
Python,72,25,1679.6883680555557,MERGED,8,66,2,1,2,34,False,1,0,0,3489,74,18.452222222222222,Bug
C#,80,125,863.8909953703704,MERGED,1537,1731,124,1,37,203,True,1,0,0,914,3268,161.9936111111111,Document
C#,80,125,862.4656828703704,MERGED,312,1392,51,0,16,222,False,0,0,0,865,1704,218.2375,Document
TypeScript,7,6,686.9348263888888,MERGED,5,76,17,5,4,233,False,0,5,1,2770,81,2.8069444444444445,Feature
C#,655,7879,1870.3476041666665,MERGED,0,97,3,2,1,19,False,0,2,1,1902,97,669.5997222222222,Document
TypeScript,7,6,685.9459143518519,MERGED,53,337,5,1,19,29,True,0,1,1,2427,390,48.63027777777778,Feature
JavaScript,5139,7050,1245.5668171296295,MERGED,20,753,8,4,6,99,False,1,3,2,3493,773,146.87777777777777,Feature
Go,421,1654,1551.1968287037037,MERGED,149,171,6,0,1,467,True,0,0,0,5019,320,15.983611111111111,Bug
Go,421,1654,1550.959710648148,MERGED,15,136,7,1,3,114,False,1,0,0,4023,151,23.216944444444444,Document
Go,1835,11245,1769.8842939814815,CLOSED,0,0,0,0,2,40,False,0,0,0,639,0,19.813055555555554,Document
TypeScript,2070,16640,1283.8514699074074,MERGED,1,1,1,0,1,76,True,0,0,0,2318,2,28.725555555555555,Bug
TypeScript,4,33,803.2671296296297,MERGED,0,1,1,2,1,242,True,1,1,1,822,1,192.16333333333333,Feature
Starlark,440,286,532.7314814814814,MERGED,0,1,1,2,1,75,False,0,2,2,842,1,0.021388888888888888,Document
TypeScript,4,33,807.0772453703704,MERGED,1,1,1,0,1,62,False,0,0,0,842,2,0.06138888888888889,Document
JavaScript,9664,43889,3701.894768518519,MERGED,2,7,2,0,1,269,True,0,0,0,789,9,0.2338888888888889,Bug
C#,80,125,861.7373842592592,MERGED,134,128,17,0,10,95,False,0,0,0,917,262,185.89944444444444,Document
Vue,10806,21163,1064.4003472222223,MERGED,44,65,2,1,2,32,False,0,1,1,3359,109,137.45944444444444,Bug
Go,421,1654,1550.351365740741,MERGED,7,291,7,0,2,112,False,0,0,0,4235,298,12.188611111111111,Document
TypeScript,202,107,1187.7024652777777,MERGED,70,107,2,4,4,255,True,0,4,3,3329,177,13.8375,Document
JavaScript,9664,43889,3701.1515740740742,MERGED,7,147,3,0,1,270,True,0,0,0,787,154,2.3644444444444446,Bug
JavaScript,9664,43889,3701.0686574074075,MERGED,4,11,2,0,1,266,True,0,0,0,813,15,0.7452777777777778,Bug
JavaScript,9664,43889,3701.0435416666664,MERGED,62,558,21,0,2,269,True,0,0,0,799,620,0.905,Feature
TypeScript,261,3765,718.7791898148148,MERGED,42,53,3,0,2,231,False,0,0,0,3208,95,0.31194444444444447,Document
Python,137,75,727.1832060185185,MERGED,0,5,2,0,1,77,False,0,0,0,2190,5,27.66722222222222,Document
Erlang,2054,12122,3839.1102546296297,MERGED,27,31,17,0,2,170,False,0,0,0,1197,58,437.9313888888889,Document
TypeScript,261,3765,718.6887499999999,MERGED,16,41,8,0,2,230,False,0,0,0,3732,57,0.7758333333333334,Document
F#,153,337,2959.0662847222225,MERGED,11,77,3,2,1,27,False,1,1,1,3737,88,52.91416666666667,Feature
TypeScript,4,33,805.6506481481482,MERGED,117,161,3,2,1,641,True,1,1,1,1028,278,0.7897222222222222,Document
V,2097,34362,1594.1684375000002,MERGED,9,22,1,0,3,0,False,0,0,0,2751,31,36.7025,Feature
V,2097,34362,1594.0530092592592,MERGED,16,105,1,0,2,0,False,0,0,0,2000,121,26.3025,Document
JavaScript,5139,7050,1244.0911342592592,MERGED,7,883,15,3,38,62,False,0,3,2,3810,890,108.72611111111111,Feature
TypeScript,202,107,1186.7238425925925,CLOSED,216,160,7,3,3,11,True,0,3,2,3217,376,3.908333333333333,Document
TypeScript,1297,21107,458.0162384259259,MERGED,138,142,6,1,1,1083,True,0,1,1,3231,280,0.0275,Document
Erlang,2054,12122,3837.694918981482,MERGED,3,3,2,0,2,512,True,0,0,0,1063,6,458.82694444444445,Document
Java,450,746,4115.055057870371,CLOSED,23,80,9,1,6,11,False,0,1,1,904,103,26.948333333333334,Feature
TypeScript,12,11,1031.5054861111112,CLOSED,1659,2575,8,0,24,170,False,0,0,0,7156,4234,336.43111111111114,Feature
TypeScript,41369,87413,2979.659490740741,MERGED,3,193,7,0,4,0,False,0,0,0,3081,196,70.89805555555556,Document
TypeScript,3393,2334,1008.8724652777778,CLOSED,79,158,6,2,3,483,False,0,2,1,1440,237,570.2247222222222,Feature
Erlang,2054,12122,3836.0551967592596,MERGED,3,15,3,0,1,78,False,0,0,0,834,18,2.5477777777777777,Document
V,2097,34362,1592.4787962962964,MERGED,4,116,4,0,2,234,True,0,0,0,2660,120,18.48111111111111,Bug
TypeScript,41369,87413,2977.6641319444443,MERGED,2,30,6,0,6,461,True,0,0,0,3088,32,145.90444444444444,Document
TypeScript,1297,21107,457.043599537037,MERGED,10,71,5,1,5,1079,True,0,1,1,2929,81,0.4072222222222222,Document
Java,450,746,4114.154386574074,MERGED,27,62,7,1,7,157,False,0,1,1,3362,89,25.793055555555554,Bug
Python,137,75,728.9942824074074,MERGED,0,598,8,0,21,1,False,0,0,0,2282,598,693.3508333333333,Document
TypeScript,41369,87413,2977.4422106481484,CLOSED,1,3,2,1,3,1932,True,0,1,1,2329,4,2.9433333333333334,Document
Python,137,75,727.2562847222222,CLOSED,0,1,1,1,2,0,False,0,1,1,1155,1,385.83722222222224,Bug
TypeScript,202,107,1184.961412037037,CLOSED,2,2,1,5,4,130,False,2,3,3,963,4,38.79638888888889,Document
PHP,883,2338,1873.7292708333334,CLOSED,1,22,2,2,2,2,False,0,2,2,3431,23,487.46666666666664,Document
TypeScript,15,34,531.7611689814815,MERGED,838,1915,66,0,23,346,False,0,0,0,823,2753,62.97222222222222,Feature
Java,450,746,4114.096122685185,MERGED,11,108,9,1,3,10,False,0,1,1,864,119,26.93777777777778,Feature
TypeScript,15,34,532.4869097222222,MERGED,249,309,13,0,10,139,False,0,0,0,786,558,19.584444444444443,Feature
TypeScript,4,33,803.124386574074,CLOSED,0,2,1,3,1,241,True,2,1,1,1011,2,26.161666666666665,Bug
TypeScript,3393,2334,1009.1130902777778,MERGED,1,1,1,1,1,139,False,0,1,1,982,2,0.11694444444444445,Bug
C#,80,125,860.6350462962963,MERGED,5,29,3,0,2,202,True,0,0,0,796,34,71.64861111111111,Document
Go,395,660,1307.9559837962963,MERGED,149,222,11,0,3,131,False,0,0,0,812,371,22.48611111111111,Feature
TypeScript,41369,87413,2979.766875,MERGED,4,3,1,0,2,20,False,0,0,0,2108,7,0.8441666666666666,Document
TypeScript,41369,87413,2979.5974074074074,MERGED,4,17,2,0,1,1612,True,0,0,0,2777,21,0.48083333333333333,Document
TypeScript,41369,87413,2979.4441782407407,MERGED,4,4,2,0,1,0,False,0,0,0,2311,8,0.06944444444444445,Document
TypeScript,41369,87413,2979.402662037037,MERGED,2,2,2,0,1,28,False,0,0,0,2488,4,0.4797222222222222,Document
TypeScript,41369,87413,2978.9630902777776,MERGED,1,1,1,0,1,466,True,0,0,0,2372,2,13.009444444444444,Document
TypeScript,41369,87413,2978.95349537037,MERGED,1,1,1,0,1,55,False,0,0,0,2245,2,11.438888888888888,Document
TypeScript,41369,87413,2978.767673611111,MERGED,1,1,1,2,1,41,False,1,1,1,2182,2,16.92888888888889,Document
TypeScript,41369,87413,2978.716724537037,MERGED,12,12,4,0,1,3,False,0,0,0,2482,24,5.315555555555555,Document
Erlang,2054,12122,3839.2246875,MERGED,46,236,9,2,10,83,True,2,0,0,975,282,194.60194444444446,Document
TypeScript,41369,87413,2977.744189814815,MERGED,1,1,1,0,3,0,False,0,0,0,2499,2,40.55111111111111,Document
TypeScript,15,34,531.1307870370371,MERGED,1,4,1,0,2,1011,False,0,0,0,694,5,7.375555555555556,Document
TypeScript,15,34,531.1123842592593,MERGED,40,87,1,0,2,1010,False,0,0,0,702,127,7.82,Feature
TypeScript,41369,87413,2978.447766203704,MERGED,1,0,1,0,1,121,True,0,0,0,2139,1,0.8502777777777778,Document
TypeScript,4,33,805.5904398148149,MERGED,12,36,3,2,6,1,False,0,2,2,1024,48,334.13388888888886,Document
TypeScript,41369,87413,2977.669606481482,MERGED,1,6,1,0,1,462,True,0,0,0,2622,7,1.4252777777777779,Document
TypeScript,41369,87413,2977.648333333333,CLOSED,52,52,2,0,1,27,False,0,0,0,2472,104,0.07944444444444444,Document
TypeScript,3393,2334,1009.0107870370371,MERGED,4,4,2,1,3,351,False,0,1,1,1403,8,388.3038888888889,Feature
TypeScript,15,34,533.3299537037037,MERGED,1302,3810,76,0,24,349,False,0,0,0,1567,5112,361.6838888888889,Document
PHP,883,2338,1874.0385300925927,CLOSED,25,59,13,5,1,3,False,2,3,3,3771,84,333.6430555555556,Document
TypeScript,2147,14724,1513.8378125,MERGED,121,920,6,0,1,57,False,0,0,0,7182,1041,218.33916666666667,Bug
Starlark,440,286,534.1018981481482,MERGED,0,59,2,2,4,0,False,1,1,1,1665,59,116.71916666666667,Feature
Java,450,746,4116.085555555555,MERGED,46,121,1,1,1,377,False,0,1,1,4049,167,262.8438888888889,Document
TypeScript,1073,11366,1137.820763888889,CLOSED,12,17,1,1,1,9,True,0,1,1,2020,29,625.8902777777778,Document
TypeScript,7,6,686.7840856481481,MERGED,20,115,4,0,13,8,False,0,0,0,3824,135,48.45805555555555,Bug
TypeScript,58,78,863.2673726851853,MERGED,28,43,7,1,2,181,False,0,1,1,5817,71,0.17166666666666666,Feature
C#,80,125,864.0245023148149,MERGED,247,699,36,0,16,183,True,0,0,0,1065,946,179.02555555555554,Document
Python,19249,70258,2502.576828703704,CLOSED,57,290,20,2,5,1622,False,1,1,1,1264,347,14.155833333333334,Bug
TypeScript,3393,2334,1010.8174305555555,MERGED,57,55,2,2,1,0,False,0,2,1,1458,112,128.92694444444444,Bug
TypeScript,7,6,686.0076851851851,MERGED,7,476,9,0,9,293,False,0,0,0,3892,483,2.1005555555555557,Feature
TypeScript,7,6,688.1294328703704,MERGED,5,66,4,0,3,279,False,0,0,0,3530,71,20.307777777777776,Feature
TypeScript,7,6,687.9199305555557,MERGED,7,682,12,0,40,252,False,0,0,0,4429,689,29.738333333333333,Feature
TypeScript,1073,11366,1136.5840740740741,MERGED,3,3,1,1,1,145,True,0,1,1,1492,6,0.14416666666666667,Bug
C#,655,7879,1872.1719791666667,MERGED,612,71,29,1,6,1510,True,0,1,1,1650,683,105.24194444444444,Document
TypeScript,85,723,358.2477083333333,MERGED,17728,71326,148,0,39,108,False,0,0,0,8447,89054,40.9175,Document
Erlang,2054,12122,3837.4973148148147,MERGED,1,3258,20,0,49,84,False,0,0,0,1290,3259,101.54527777777778,Document
Python,2407,12185,283.52221064814813,MERGED,2,2,1,3,3,8,False,1,2,1,1518,4,57.378055555555555,Document
TypeScript,7,6,687.1441435185185,MERGED,1,3,2,0,5,234,False,0,0,0,3562,4,43.193333333333335,Feature
TypeScript,3393,2334,1009.415162037037,MERGED,1,1,1,2,1,0,False,0,2,1,1571,2,13.629166666666666,Document
TypeScript,58,78,862.1007291666666,MERGED,25,136,9,1,7,128,False,0,1,1,4978,161,5.208055555555555,Feature
F#,153,337,2961.2107986111114,MERGED,441,1083,30,3,12,28,False,3,0,0,5253,1524,230.02138888888888,Document
Erlang,2054,12122,3839.1242476851853,MERGED,14,18,6,0,2,396,False,0,0,0,1054,32,1.3811111111111112,Document
TypeScript,202,107,1187.4783564814813,CLOSED,50,133,7,2,3,271,True,0,2,2,6727,183,967.005,Document
Vue,0,1,290.3790046296296,CLOSED,1,2,1,0,1,44,False,0,0,0,1145,3,68.53,Feature
TypeScript,178,1359,362.9628587962963,MERGED,149,138,6,1,3,29,True,0,1,1,7365,287,1.1588888888888889,Bug
Java,450,746,4113.559594907408,MERGED,147,1063,33,2,32,35,False,0,2,1,1061,1210,227.47305555555556,Bug
Erlang,2054,12122,3838.2597800925923,CLOSED,37,94,4,0,1,82,True,0,0,0,1144,131,23.125,Document
C#,655,7879,1870.1053703703703,MERGED,2,33,2,10,1,5,False,0,10,4,2173,35,505.31916666666666,Document
Starlark,440,286,530.2210648148148,MERGED,0,250,2,2,9,0,False,1,1,1,2076,250,516.3636111111111,Document
Erlang,2054,12122,3838.302662037037,MERGED,7,8,8,0,2,79,False,0,0,0,1009,15,3.8336111111111113,Document
TypeScript,149,2900,422.62041666666664,CLOSED,1,8,2,3,1,121,False,1,2,2,1470,9,34.619166666666665,Feature
Erlang,2054,12122,3838.257650462963,CLOSED,1,3,1,1,1,395,False,1,0,0,1049,4,3.0441666666666665,Document
Erlang,2054,12122,3838.1700115740737,MERGED,1,21,3,0,2,394,False,0,0,0,1277,22,5.1338888888888885,Document
Erlang,2054,12122,3837.4306481481485,MERGED,26,109,6,0,3,393,False,0,0,0,1304,135,40.04527777777778,Document
TypeScript,85,723,357.02,MERGED,58,48,9,0,2,176,False,0,0,0,8092,106,3.276388888888889,Document
TypeScript,2070,16640,1284.5466435185185,MERGED,5,11,1,0,1,0,False,0,0,0,3262,16,11.933055555555555,Bug
Erlang,2054,12122,3837.9250578703704,MERGED,1,35,5,0,2,487,False,0,0,0,1077,36,0.7163888888888889,Document
C#,80,125,860.968599537037,CLOSED,190,351,13,0,6,3,True,0,0,0,1261,541,188.1263888888889,Document
TypeScript,261,3765,718.7980555555555,MERGED,27,126,9,0,2,635,True,0,0,0,5387,153,0.26416666666666666,Document
TypeScript,261,3765,718.7266203703704,MERGED,333,416,126,0,5,971,True,0,0,0,6698,749,0.63,Document
Erlang,2054,12122,3837.1357060185182,MERGED,10,4,4,0,1,139,False,0,0,0,961,14,22.74361111111111,Document
TypeScript,261,3765,718.5471412037036,MERGED,252,194,18,0,10,969,True,0,0,0,6578,446,2.86,Document
TypeScript,3393,2334,1011.0911689814815,MERGED,37,61,10,2,3,486,False,0,2,1,1290,98,3.8027777777777776,Bug
Erlang,2054,12122,3837.3039814814815,MERGED,1,42,3,0,1,392,False,0,0,0,1137,43,2.006666666666667,Document
JavaScript,8844,63474,4117.6485416666665,MERGED,12,153,11,1,2,120,True,1,0,0,4052,165,61.02166666666667,Document
TypeScript,3393,2334,1011.0508217592593,MERGED,11,2,3,2,1,485,False,0,2,1,1540,13,0.7455555555555555,Feature
TypeScript,1073,11366,1136.8774074074074,MERGED,16,6,1,3,17,0,False,1,2,2,2734,22,982.4591666666666,Document
Erlang,2054,12122,3837.1521990740744,CLOSED,1,1,1,3,1,391,False,1,2,2,1022,2,0.18416666666666667,Document
Erlang,2054,12122,3836.9814930555553,CLOSED,1,1,1,3,1,252,True,1,2,2,1140,2,4.5425,Document
Python,2407,12185,281.58804398148146,MERGED,9,12,4,0,3,82,True,0,0,0,1914,21,9.20888888888889,Feature
Erlang,2054,12122,3836.919351851852,MERGED,3,2,3,2,2,83,False,0,2,1,1166,5,2.493611111111111,Document
Erlang,2054,12122,3836.779780092593,MERGED,27,1724,47,0,10,379,True,0,0,0,1438,1751,7.318888888888889,Document
Erlang,2054,12122,3836.8413425925924,MERGED,1,1,1,0,1,511,True,0,0,0,1135,2,3.453888888888889,Document
Erlang,2054,12122,3836.4512384259256,MERGED,4,31,4,0,1,390,False,0,0,0,1248,35,15.983333333333333,Document
TypeScript,3393,2334,1010.0908912037038,MERGED,20,21,2,2,1,484,False,0,2,1,1535,41,23.77,Bug
Erlang,2054,12122,3836.6853935185186,MERGED,1,1,1,0,1,419,True,0,0,0,1116,2,3.5216666666666665,Document
Erlang,2054,12122,3836.6831944444443,MERGED,1,5,1,0,1,486,False,0,0,0,1136,6,1.0244444444444445,Document
Erlang,2054,12122,3836.3193287037034,MERGED,0,4,1,0,1,169,False,0,0,0,1140,4,15.804722222222223,Document
Erlang,2054,12122,3838.4879861111112,MERGED,410,1110,26,0,12,80,False,0,0,0,1873,1520,302.7705555555556,Document
Erlang,2054,12122,3836.102881944444,CLOSED,0,23,3,0,1,251,True,0,0,0,1121,23,0.2388888888888889,Document
Erlang,2054,12122,3836.306979166666,CLOSED,14,3,5,0,1,81,False,0,0,0,1090,17,0.028055555555555556,Document
C#,655,7879,1868.6905671296297,CLOSED,0,3,1,0,1,623,True,0,0,0,2133,3,460.4886111111111,Document
TypeScript,4,33,804.5552546296295,MERGED,1,1,1,3,1,640,True,2,1,1,1144,2,0.07416666666666667,Document
Erlang,2054,12122,3836.0108333333333,MERGED,1,1,1,0,1,418,True,0,0,0,1108,2,4.626111111111111,Document
Erlang,2054,12122,3836.003912037037,MERGED,16,28,2,0,2,417,True,0,0,0,1134,44,4.733055555555556,Document
TypeScript,261,3765,716.8553472222221,MERGED,5,652,9,0,2,962,True,0,0,0,7394,657,16.18777777777778,Document
TypeScript,4,33,804.4421180555555,MERGED,3,9,1,0,1,230,False,0,0,0,1100,12,0.035,Bug
Erlang,2054,12122,3835.9698726851852,MERGED,1,1,1,0,1,510,True,0,0,0,1090,2,0.2588888888888889,Document
Erlang,2054,12122,3835.910659722222,MERGED,4,4,3,0,3,416,True,0,0,0,1108,8,3.2130555555555556,Document
Erlang,2054,12122,3835.9025231481482,CLOSED,2,2,1,1,1,1,True,0,1,1,1066,4,3.495833333333333,Document
TypeScript,4,33,804.2408333333333,MERGED,47,122,11,2,4,244,True,1,1,1,1434,169,1.7466666666666666,Feature
Python,2407,12185,280.37587962962965,MERGED,4,1,2,2,2,81,True,0,2,1,1455,5,12.468055555555555,Document
TypeScript,4,33,804.2469907407408,MERGED,1,1,1,1,1,385,False,0,1,1,1352,2,0.1322222222222222,Bug
Erlang,2054,12122,3835.6877430555555,MERGED,86,124,27,0,28,415,True,0,0,0,1310,210,4.575833333333334,Document
TypeScript,3393,2334,1008.2968402777778,MERGED,23,23,1,4,3,278,False,1,3,2,1676,46,64.06527777777778,Feature
TypeScript,261,3765,716.5320949074074,MERGED,31,64,5,0,3,116,False,0,0,0,5315,95,6.179444444444444,Document
TypeScript,261,3765,716.5987731481482,MERGED,351,240,25,0,3,959,True,0,0,0,6774,591,0.9680555555555556,Document
TypeScript,261,3765,716.5248148148148,MERGED,91,76,15,0,2,193,False,0,0,0,5108,167,0.37222222222222223,Document
TypeScript,41369,87413,2977.7600694444445,MERGED,8,28,6,0,11,464,True,0,0,0,4339,36,165.67361111111111,Document
TypeScript,41369,87413,2980.6686111111107,MERGED,5,28,3,2,3,29,False,1,1,1,3268,33,9.093333333333334,Document
Python,137,75,725.6120717592593,MERGED,0,349,13,0,75,0,False,0,0,0,3445,349,1547.0627777777777,Document
TypeScript,3393,2334,1008.4301273148149,MERGED,1,4,1,2,1,0,False,0,2,1,1210,5,5.280277777777778,Feature
TypeScript,41369,87413,2977.682905092593,MERGED,2,31,6,0,7,463,True,0,0,0,3976,33,146.46944444444443,Document
TypeScript,4,33,803.2288657407407,MERGED,1,1,1,3,1,638,True,2,1,1,1619,2,0.16833333333333333,Bug
TypeScript,41369,87413,2980.1486342592593,CLOSED,7,162,8,0,2,0,False,0,0,0,3843,169,14.559722222222222,Document
TypeScript,7,6,686.995011574074,MERGED,6145,7355,166,3,93,225,False,0,3,1,6334,13500,657.4597222222222,Document
TypeScript,3393,2334,1008.2853240740741,MERGED,1,5,1,2,1,277,False,0,2,1,1189,6,0.22916666666666666,Feature
TypeScript,3393,2334,1008.1797685185185,MERGED,8,7,1,1,1,349,False,0,1,1,1421,15,1.7513888888888889,Feature
TypeScript,15,34,531.5069097222222,MERGED,514,607,25,0,12,138,False,0,0,0,1521,1121,21.011388888888888,Bug
TypeScript,3393,2334,1008.0909375,MERGED,0,9,1,2,2,481,False,0,2,1,1249,9,0.3447222222222222,Feature
Go,421,1654,1550.3109490740742,MERGED,9,698,8,0,2,109,False,0,0,0,5809,707,4.474722222222222,Document
TypeScript,41369,87413,2978.6900925925925,MERGED,0,197,4,1,25,465,True,0,1,1,2963,197,53.00111111111111,Document
TypeScript,41369,87413,2978.5394444444446,MERGED,3,2563,9,2,6,20,True,1,1,1,4239,2566,22.932777777777776,Document
TypeScript,1073,11366,1134.5608912037037,MERGED,2,2,2,1,2,144,True,0,1,1,1367,4,0.14888888888888888,Bug
TypeScript,1073,11366,1134.5039699074075,MERGED,2,2,2,1,1,143,True,0,1,1,1289,4,0.21333333333333335,Bug
Erlang,2054,12122,3839.237314814815,MERGED,590,540,65,1,13,1040,True,0,1,1,1655,1130,117.68416666666667,Document
TypeScript,85,723,359.19214120370367,MERGED,2,122,11,0,5,28,False,0,0,0,10504,124,188.81694444444443,Document
TypeScript,41369,87413,2978.512037037037,MERGED,5,32,3,1,3,1611,True,0,1,1,3544,37,1.781111111111111,Document
TypeScript,41369,87413,2978.621331018519,MERGED,13,19,4,0,2,1936,True,0,0,0,3459,32,5.114166666666667,Document
TypeScript,3393,2334,1011.4977199074074,MERGED,64,35,7,2,1,0,False,0,2,1,1996,99,14.515,Bug
Starlark,440,286,531.1097569444445,CLOSED,1,19,1,2,1,0,False,1,1,1,2122,20,744.8955555555556,Feature
TypeScript,41369,87413,2977.6946064814815,MERGED,9,0,2,2,1,53,False,1,1,1,3290,9,41.74666666666667,Document
TypeScript,41369,87413,2978.4607291666666,CLOSED,11,40,8,0,2,1,False,0,0,0,4126,51,0.058611111111111114,Document
Starlark,440,286,531.2279398148148,MERGED,0,60,2,2,3,0,False,1,1,1,2262,60,187.74055555555555,Feature
C#,655,7879,1872.2245601851853,MERGED,1,28,2,2,3,595,True,0,2,2,2216,29,20.841666666666665,Document
TypeScript,41369,87413,2977.6946875,MERGED,12,10,3,1,1,119,True,0,1,1,3097,22,3.943611111111111,Document
Python,2407,12185,283.7682986111111,CLOSED,0,15,1,3,2,0,False,1,2,1,1750,15,51.06472222222222,Document
Kotlin,164,4296,446.9527083333333,MERGED,88,154,3,2,9,23,False,1,1,1,1726,242,43.98916666666667,Feature
Python,2407,12185,282.9342939814815,MERGED,0,1,1,7,5,0,False,3,4,1,2040,1,70.88083333333333,Document
Go,789,5551,1082.044236111111,CLOSED,0,3,1,1,1,0,False,0,1,1,2006,3,1.0025,Document
Python,19249,70259,2503.728009259259,CLOSED,119,46,16,1,2,1624,False,1,0,0,1653,165,7.776944444444444,Bug
TypeScript,4,33,806.6316666666667,MERGED,44,149,6,1,1,231,False,0,1,1,1881,193,0.15611111111111112,Feature
Python,2407,12185,282.97362268518515,MERGED,1,1,1,0,1,341,True,0,0,0,1796,2,0.043611111111111114,Document
C#,655,7879,1871.385173611111,MERGED,22,68,3,1,3,20,False,0,1,1,2061,90,20.39666666666667,Document
TypeScript,85,723,359.3368634259259,MERGED,27197,17325,457,0,202,178,False,0,0,0,9432,44522,0.3705555555555556,Document
JavaScript,0,0,34.07428240740741,CLOSED,13,21,6,0,1,8,False,0,0,0,1781,34,100.9275,Document
TypeScript,58,78,862.3325694444444,MERGED,69,258,12,1,4,100,False,0,1,1,8017,327,0.47333333333333333,Bug
C#,655,7879,1871.3480671296295,MERGED,105,101,38,1,3,1507,True,0,1,1,2297,206,5.880833333333333,Document
Erlang,2054,12122,3836.185925925926,MERGED,348,2320,26,1,12,389,False,1,0,0,1855,2668,69.705,Document
C#,655,7879,1870.2840046296296,MERGED,97,85,3,0,2,626,True,0,0,0,2208,182,18.32638888888889,Document
C#,655,7879,1870.1943402777779,MERGED,2,3,1,1,1,624,True,0,1,1,2279,5,19.927222222222223,Document
Starlark,440,286,533.1348032407408,MERGED,0,214,2,3,4,0,False,2,1,1,2577,214,446.4763888888889,Document
Starlark,440,286,531.7347916666666,MERGED,0,233,4,3,11,48,False,2,1,1,3151,233,175.77666666666667,Document
Python,137,75,728.935,MERGED,2,260,9,4,96,0,False,3,1,1,3571,262,1113.7397222222223,Bug
Go,182,37,1751.0566898148147,MERGED,223,783,8,3,8,461,False,3,0,0,6915,1006,115.89277777777778,Document
V,2097,34362,1593.8565856481482,MERGED,258,1651,16,12,40,15,True,4,8,3,4739,1909,511.1616666666667,Document
Python,2407,12185,280.44759259259257,MERGED,1,1,1,1,1,7,False,0,1,1,1831,2,16.620277777777776,Document
C#,655,7879,1869.3646527777776,MERGED,229,2170,19,1,2,1505,True,0,1,1,2415,2399,22.21361111111111,Document
TypeScript,85,723,355.94083333333333,MERGED,15825,9038,147,0,95,7,False,0,0,0,9703,24863,77.28305555555555,Document
TypeScript,4,33,804.0732407407407,MERGED,2,2,2,1,2,384,False,0,1,1,1724,4,0.22027777777777777,Feature
TypeScript,4,33,803.7439583333334,MERGED,213,658,33,1,23,390,True,0,1,1,2074,871,15.069166666666666,Document
TypeScript,4,33,803.2830092592593,MERGED,4,5,4,2,17,243,True,1,1,1,2029,9,19.087777777777777,Bug
TypeScript,1073,11366,1134.5454861111111,MERGED,1,1,1,0,1,0,False,0,0,0,1914,2,33.52027777777778,Bug
Go,421,1654,1550.0024305555555,MERGED,752,2579,42,1,2,462,True,1,0,0,9197,3331,145.23944444444444,Bug
TypeScript,261,3765,717.6845949074074,MERGED,276,274,15,0,6,227,False,0,0,0,8937,550,0.8697222222222222,Document
TypeScript,7,6,688.8700578703703,CLOSED,9,1008,22,1,9,33,True,1,0,0,7594,1017,74.59833333333333,Feature
TypeScript,3393,2334,1008.1774074074074,MERGED,20,26,8,3,2,0,False,0,3,2,3179,46,336.8563888888889,Bug
Starlark,440,286,533.9688541666667,MERGED,0,234,3,2,1,43,False,1,1,1,2310,234,120.16888888888889,Feature
C#,655,7879,1871.5943055555556,MERGED,1061,993,52,5,2,1509,True,0,5,1,2447,2054,182.18444444444444,Document
TypeScript,7,6,687.2277546296297,MERGED,94,163,9,0,8,251,False,0,0,0,5745,257,39.98916666666667,Bug
Python,547,7160,2280.6046643518516,MERGED,13,146,6,1,12,31,False,0,1,1,5340,159,25.912777777777777,Document
TypeScript,4,33,805.7707870370369,MERGED,31,31,8,1,4,391,True,0,1,1,2824,62,158.4975,Document
Python,2407,12185,284.58091435185185,MERGED,4,5,1,1,4,0,False,0,1,1,2131,9,31.33388888888889,Document
TypeScript,41370,87413,2979.511909722222,CLOSED,79,210,4,2,1,56,False,1,1,1,4922,289,221.89944444444444,Document
TypeScript,41370,87413,2979.4816435185185,MERGED,5075,7263,18,2,13,21,True,1,1,1,5894,12338,192.5872222222222,Document
Java,450,746,4114.9875694444445,MERGED,17,54,13,2,2,83,True,0,2,1,6248,71,118.75444444444445,Bug
TypeScript,307,2556,578.5927199074074,MERGED,4,92,7,0,3,190,True,0,0,0,4858,96,221.81472222222223,Feature
Python,2407,12185,283.1047916666667,MERGED,15,96,5,0,7,342,True,0,0,0,3083,111,3.799722222222222,Document
TypeScript,1073,11366,1137.8947916666666,MERGED,20,20,7,1,2,281,True,0,1,1,2926,40,63.85916666666667,Bug
TypeScript,4803,40785,3800.548449074074,MERGED,63,543,25,1,11,148,True,0,1,1,2623,606,73.00083333333333,Bug
Vue,10806,21163,1064.948263888889,MERGED,392,742,65,1,29,158,False,0,1,1,7131,1134,0.36333333333333334,Document
TypeScript,1297,21107,457.97053240740746,MERGED,1122,51,71,1,5,1081,True,0,1,1,6437,1173,0.24222222222222223,Document
TypeScript,41370,87413,2978.0250462962963,MERGED,2,30,6,0,4,39,False,0,0,0,4956,32,158.40972222222223,Document
TypeScript,41370,87413,2978.026886574074,MERGED,71,49,6,0,5,40,False,0,0,0,5030,120,155.44416666666666,Document
TypeScript,85,723,359.3650694444445,MERGED,212,349,34,0,108,179,False,0,0,0,13179,561,89.30638888888889,Document
TypeScript,41370,87413,2978.4444212962967,MERGED,67,109,10,0,3,120,True,0,0,0,4775,176,3.4258333333333333,Document
Python,2407,12185,280.79908564814815,MERGED,1,1,1,3,4,0,False,2,1,1,2295,2,8.314444444444444,Document
TypeScript,202,107,1185.518888888889,MERGED,45,69,5,2,4,39,True,0,2,2,5337,114,0.023333333333333334,Document
TypeScript,41370,87413,2977.4625925925925,MERGED,3,30,6,0,10,460,True,0,0,0,5586,33,149.6186111111111,Document
TypeScript,1073,11366,1136.766099537037,MERGED,3,3,2,0,1,35,True,0,0,0,2232,6,0.017222222222222222,Bug
TypeScript,1073,11366,1136.757349537037,MERGED,10,17,10,0,7,34,True,0,0,0,2731,27,0.0475,Bug
Python,2407,12185,280.1611574074074,MERGED,2,10,2,3,2,339,True,2,1,1,2729,12,0.26222222222222225,Document
TypeScript,1073,11366,1136.0012037037038,MERGED,33,61,4,1,3,760,True,0,1,1,2873,94,11.065,Feature
TypeScript,1073,11366,1135.7525231481482,MERGED,3,18,1,1,1,86,True,0,1,1,2875,21,0.17666666666666667,Document
TypeScript,3393,2334,1008.1543287037038,MERGED,10,12,4,1,1,348,False,0,1,1,2909,22,0.12805555555555556,Document
TypeScript,7,6,688.0950578703704,MERGED,256,454,27,4,8,226,False,2,2,2,9789,710,285.6538888888889,Document
TypeScript,1073,11366,1134.537025462963,MERGED,0,9,1,1,2,33,True,0,1,1,2867,9,21.482222222222223,Bug
TypeScript,1073,11366,1134.8736111111111,MERGED,10,17,10,1,5,188,False,0,1,1,2458,27,0.565,Bug
TypeScript,1073,11366,1134.8738541666667,MERGED,1,1,1,0,1,189,False,0,0,0,2377,2,0.11416666666666667,Bug
Go,1835,11245,1770.6083449074074,MERGED,1,433,10,0,1,567,False,0,0,0,3099,434,1.5363888888888888,Document
TypeScript,85,723,356.29466435185185,MERGED,14,3930,32,0,10,102,False,0,0,0,14181,3944,17.295,Document
Go,1835,11245,1769.614826388889,MERGED,9,36,9,0,1,176,False,0,0,0,3059,45,25.410833333333333,Document
TypeScript,261,3765,718.6693055555555,MERGED,261,284,171,0,1,970,True,0,0,0,13485,545,0.3322222222222222,Document
TypeScript,261,3765,717.6733680555554,MERGED,73,528,40,0,12,631,True,0,0,0,12687,601,2.5452777777777778,Document
Starlark,440,286,532.1004050925926,MERGED,0,210,3,4,1,0,False,3,1,1,3668,210,234.10555555555555,Document
TypeScript,1073,11366,1138.444837962963,MERGED,2,3,2,5,6,3,False,2,3,2,2993,5,238.80916666666667,Document
Python,4516,54989,967.4896990740741,MERGED,0,38,2,0,1,108,True,0,0,0,3719,38,37.14277777777778,Document
Python,4516,54989,966.9928472222223,MERGED,0,141,2,2,46,1,False,1,1,1,4048,141,303.3063888888889,Document
Go,789,5551,1081.1151157407407,MERGED,31,105,8,0,1,33,False,0,0,0,3390,136,198.155,Document
C++,2234,23696,2398.4116782407405,MERGED,26,703,27,1,28,5,False,0,1,1,5126,729,167.21416666666667,Document
TypeScript,202,107,1185.8509027777777,MERGED,128,384,12,4,5,251,True,1,3,3,8819,512,34.24527777777778,Bug
TypeScript,1073,11366,1135.764849537037,MERGED,38,153,7,1,3,758,True,0,1,1,3818,191,209.8738888888889,Feature
Java,450,746,4116.24925925926,MERGED,50,115,20,1,24,53,False,0,1,1,4078,165,93.8163888888889,Bug
Python,4516,54989,969.4949305555556,MERGED,1,1,1,0,1,0,False,0,0,0,3508,2,1.8847222222222222,Document
TypeScript,15,31,499.8225347222222,MERGED,31,56,16,0,13,33,False,0,0,0,2851,87,189.80416666666667,Document
TypeScript,41370,87413,2977.4186689814815,MERGED,383,602,12,1,8,26,False,0,1,1,7697,985,58.30305555555555,Document
TypeScript,1073,11366,1137.6175347222222,MERGED,1,3,1,1,1,192,False,0,1,1,3123,4,1.1375,Document
Python,2407,12185,281.14649305555554,MERGED,7,27,6,0,5,340,True,0,0,0,4250,34,0.035277777777777776,Document
TypeScript,140,827,790.2527314814815,MERGED,6,57,2,2,2,59,False,0,2,2,3958,63,3.1975,Bug
TypeScript,3393,2334,1009.428125,MERGED,36,33,5,2,3,355,False,0,2,1,3727,69,0.8813888888888889,Bug
Python,4516,54989,966.3079861111111,CLOSED,0,0,2,2,1,0,False,0,2,2,3801,0,40.20638888888889,Document
TypeScript,4,33,803.8010879629629,MERGED,1078,832,46,1,10,229,False,0,1,1,4662,1910,7.417222222222223,Document
TypeScript,1073,11366,1136.578900462963,MERGED,70,1,1,1,3,279,True,0,1,1,3587,71,0.7811111111111111,Bug
Go,1835,11245,1769.6237037037038,MERGED,0,2035,62,3,5,1,False,1,2,2,3165,2035,220.4622222222222,Document
TypeScript,1073,11366,1134.3119212962963,CLOSED,4,4,3,8,10,2,False,5,3,1,3317,8,44.52055555555555,Document
TypeScript,1073,11366,1135.9938194444444,MERGED,1,31,5,1,3,759,True,0,1,1,5170,32,11.227222222222222,Feature
TypeScript,4,33,803.4321527777778,CLOSED,89,206,7,0,2,228,False,0,0,0,5165,295,1.1477777777777778,Document
Go,1835,11245,1769.9962384259259,MERGED,49,89,7,1,1,566,False,1,0,0,3288,138,1.1033333333333333,Document
JavaScript,8844,63474,4120.626099537037,MERGED,160,406,25,0,3,122,True,0,0,0,20666,566,158.77388888888888,Document
TypeScript,261,3765,716.7707060185185,MERGED,189,304,10,0,1,961,True,0,0,0,16808,493,0.34,Document
TypeScript,41370,87413,2980.469247685185,CLOSED,56,71,29,1,3,202,False,1,0,0,13531,127,1.2905555555555555,Document
Python,4516,54989,970.2106712962964,MERGED,10,9,1,2,4,0,False,1,1,1,4720,19,280.8488888888889,Document
C++,2234,23696,2398.99900462963,MERGED,101,183,4,1,6,342,False,1,0,0,4993,284,119.07916666666667,Feature
TypeScript,1073,11366,1138.5814120370371,MERGED,2,322,3,2,5,6,False,0,2,2,4045,324,102.85138888888889,Bug
TypeScript,4,33,806.5954050925926,MERGED,101,353,63,1,10,386,False,0,1,1,5291,454,14.288055555555555,Bug
TypeScript,4,33,806.632013888889,MERGED,48,139,10,1,7,388,False,0,1,1,6236,187,12.365277777777777,Bug
TypeScript,1073,11366,1136.6253819444444,MERGED,44,47,7,1,2,280,True,0,1,1,7155,91,0.2788888888888889,Bug
TypeScript,2147,14724,1515.1749652777778,MERGED,1286,1353,3,0,1,186,False,0,0,0,25121,2639,86.98805555555556,Document
Go,1835,11245,1770.5665509259259,MERGED,118,244,18,0,7,28,True,0,0,0,9518,362,172.41444444444446,Document
Go,1835,11245,1768.602233796296,CLOSED,576,1400,37,1,3,11,False,0,1,1,11801,1976,527.9463888888889,Document
TypeScript,3393,2334,1007.6723148148149,MERGED,87,253,9,1,12,347,False,0,1,1,11463,340,232.23888888888888,Bug
TypeScript,4,33,805.0542476851851,MERGED,162,319,19,2,32,245,True,1,1,1,11511,481,29.501944444444444,Bug
TypeScript,1073,11366,1136.756550925926,MERGED,201,272,28,1,41,191,False,0,1,1,13525,473,0.8952777777777777,Document
JavaScript,34,25,240.1427314814815,MERGED,1779,1866,17,2,2,4,False,1,1,1,19206,3645,167.3375,Bug
JavaScript,22,26,960.9944212962963,MERGED,730,3511,95,8,57,16,True,4,4,2,17027,4241,41.98,Feature
TypeScript,3393,2334,1009.4895486111112,MERGED,115,242,19,2,110,2,False,0,2,2,18483,357,164.99416666666667,Bug
Go,1835,11245,1770.745324074074,MERGED,482,1060,49,1,7,41,False,0,1,1,17436,1542,140.09222222222223,Document
Go,1835,11245,1768.6542708333334,MERGED,282,678,45,0,5,39,False,0,0,0,16278,960,6.358611111111111,Document
Vue,10806,21163,1071.2366087962962,MERGED,0,44,2,5,3,13,False,2,3,2,1402,44,1368.4747222222222,Bug
TypeScript,58,78,865.137337962963,MERGED,35,229,31,1,4,104,False,0,1,1,1222,264,694.6677777777778,Feature
Go,395,660,1314.0962731481482,MERGED,71,285,7,0,11,120,False,0,0,0,444,356,1146.8794444444445,Bug
TypeScript,2147,14724,1521.2011574074074,MERGED,16,0,4,0,1,190,False,0,0,0,824,16,0.024722222222222222,Feature
TypeScript,2147,14724,1520.9731250000002,MERGED,2,4,1,0,1,749,False,0,0,0,871,6,27.59111111111111,Bug
TypeScript,2147,14724,1520.9600231481481,MERGED,1,2,1,0,1,748,False,0,0,0,920,3,27.912777777777777,Feature
TypeScript,2147,14724,1520.2624189814815,MERGED,152,607,3,0,1,745,False,0,0,0,1014,759,63.13361111111111,Bug
TypeScript,2147,14724,1520.0449074074074,MERGED,8,19,1,0,1,744,False,0,0,0,840,27,50.681111111111115,Bug
TypeScript,12,11,1037.3694212962962,MERGED,0,8,1,0,2,12,False,0,0,0,873,8,20.20638888888889,Feature
TypeScript,178,1359,370.51645833333333,MERGED,6,10,2,1,1,22,True,0,1,1,942,16,3.871111111111111,Bug
TypeScript,85,723,364.0527083333333,MERGED,0,23,1,0,1,12,False,0,0,0,1266,23,18.88277777777778,Document
TypeScript,261,3765,723.7663310185185,MERGED,3,3,1,0,1,114,True,0,0,0,970,6,0.018333333333333333,Document
TypeScript,85,723,363.99927083333336,MERGED,1,10,1,0,1,183,False,0,0,0,1235,11,0.37166666666666665,Document
TypeScript,2147,14724,1521.0385300925927,MERGED,17,147,15,0,4,89,False,0,0,0,988,164,2.4530555555555558,Feature
Vue,10806,21163,1069.9342824074074,MERGED,0,31,1,1,1,1,False,0,1,1,1370,31,579.1480555555555,Document
TypeScript,85,723,363.2446875,MERGED,1,1,1,0,1,30,False,0,0,0,1226,2,0.25166666666666665,Document
TypeScript,85,723,363.02502314814814,MERGED,0,1,1,0,1,180,False,0,0,0,1096,1,1.475,Document
TypeScript,85,723,363.0008680555556,MERGED,0,23,1,1,1,5,False,0,1,1,1252,23,1.2544444444444445,Document
TypeScript,2147,14724,1519.8133333333333,MERGED,3,3,1,0,1,179,False,0,0,0,1065,6,0.09888888888888889,Feature
TypeScript,2147,14724,1519.100428240741,MERGED,1,1,1,1,1,0,False,0,1,1,692,2,17.907222222222224,Document
TypeScript,2147,14724,1520.7422569444443,MERGED,28,48,2,1,1,746,False,0,1,1,1630,76,54.28944444444444,Bug
TypeScript,85,723,363.04657407407404,CLOSED,0,8,1,0,5,106,False,0,0,0,1687,8,191.50416666666666,Document
TypeScript,2147,14724,1520.0085069444447,MERGED,7,10,6,0,1,743,False,0,0,0,1317,17,50.785833333333336,Feature
TypeScript,2147,14724,1519.9904976851851,MERGED,6,18,2,0,1,742,False,0,0,0,1474,24,51.2025,Bug
TypeScript,58,78,869.0763310185185,MERGED,141,139,2,1,9,107,False,0,1,1,1202,280,48.283611111111114,Bug
TypeScript,178,1359,370.9563425925926,MERGED,2,2,2,2,1,1,False,0,2,2,1567,4,4.222777777777778,Bug
C++,2234,23696,2405.8345949074073,MERGED,132,411,3,1,4,299,False,0,1,1,596,543,49.95805555555555,Feature
Python,547,7160,2286.104050925926,MERGED,2,595,2,0,12,11,False,0,0,0,995,597,525.4969444444445,Feature
TypeScript,261,3765,724.7096875000001,MERGED,0,52,3,0,1,273,True,0,0,0,1361,52,30.679166666666667,Document
Python,547,7160,2285.6759953703704,MERGED,1431,2421,60,1,54,303,True,1,0,0,1260,3852,236.16833333333332,Bug
TypeScript,85,723,360.25299768518516,MERGED,1,1,1,0,1,105,False,0,0,0,1123,2,0.08138888888888889,Document
TypeScript,178,1359,370.1307638888889,MERGED,643,207,2,1,1,32,True,0,1,1,1687,850,0.3252777777777778,Bug
Python,547,7160,2284.920138888889,MERGED,0,0,0,0,11,36,False,0,0,0,1132,0,569.8547222222222,Bug
Python,547,7160,2284.9187847222224,MERGED,0,6,1,0,5,35,False,0,0,0,1071,6,566.7377777777778,Bug
TypeScript,261,3765,724.665162037037,MERGED,3,8,3,0,2,637,True,0,0,0,1283,11,0.49666666666666665,Document
Python,547,7160,2284.9169328703706,MERGED,28,30,2,0,5,34,False,0,0,0,1213,58,568.0038888888889,Bug
PHP,1334,2960,4256.002164351852,MERGED,5,6,2,1,2,880,False,0,1,1,1613,11,213.58444444444444,Document
TypeScript,58,78,868.1606597222222,MERGED,0,1,1,1,1,129,False,0,1,1,1119,1,0.8508333333333333,Feature
TypeScript,2147,14724,1520.1494444444445,MERGED,5,15,3,0,1,188,False,0,0,0,1614,20,0.5755555555555556,Feature
TypeScript,2147,14724,1521.0909375,MERGED,13,45,3,0,2,44,False,0,0,0,1618,58,2.7558333333333334,Feature
C#,80,125,868.587349537037,CLOSED,4,6898698,24,0,5,8,False,0,0,0,896,6898702,1224.8202777777778,Document
Python,547,7160,2285.723622685185,MERGED,0,17,1,0,3,89,False,0,0,0,940,17,91.23861111111111,Bug
Python,547,7160,2286.5086805555557,MERGED,1,70,2,1,7,90,False,1,0,0,977,71,239.0377777777778,Bug
Go,421,1654,1556.2202199074075,MERGED,1,1,1,0,1,469,True,0,0,0,1111,2,1.6305555555555555,Bug
Go,421,1654,1556.172025462963,MERGED,2,21,1,0,2,15,False,0,0,0,1049,23,1.8733333333333333,Document
Python,547,7160,2282.7214583333334,MERGED,238,1282,52,0,133,33,False,0,0,0,1286,1520,739.8069444444444,Bug
Go,395,660,1314.106099537037,MERGED,1,1,1,0,1,121,False,0,0,0,183,2,475.6641666666667,Feature
TypeScript,2147,14724,1519.8858912037037,MERGED,1,11,2,0,1,187,False,0,0,0,1554,12,1.138611111111111,Feature
JavaScript,5139,7050,1249.0712037037038,CLOSED,1,1,1,2,2,4,False,0,2,2,748,2,0.08277777777777778,Feature
JavaScript,8844,63474,4125.619097222222,MERGED,0,92,5,0,1,6,False,0,0,0,3061,92,1032.3641666666667,Feature
Go,395,660,1313.8740625,MERGED,1,34,1,0,7,119,False,0,0,0,252,35,648.1352777777778,Feature
Go,395,660,1314.0101967592593,CLOSED,0,14,1,1,3,2,False,0,1,1,238,14,477.5258333333333,Feature
Python,547,7160,2286.5146180555553,MERGED,1,1,1,0,1,304,True,0,0,0,716,2,0.09222222222222222,Bug
JavaScript,5139,7050,1251.5692476851852,CLOSED,1,7,3,1,3,186,False,0,1,1,1060,8,0.23555555555555555,Feature
TypeScript,261,3765,722.6829861111111,MERGED,10,22,6,0,2,974,True,0,0,0,1424,32,0.56,Document
C++,2234,23696,2403.870324074074,MERGED,1,2,1,1,1,346,False,0,1,1,663,3,1.1277777777777778,Bug
Python,547,7160,2285.315509259259,MERGED,524,843,9,1,27,38,False,0,1,1,1201,1367,559.2858333333334,Bug
Python,547,7160,2284.929652777778,MERGED,244,466,4,2,18,37,False,2,0,0,1129,710,568.5219444444444,Bug
Vue,10806,21163,1069.7930902777778,MERGED,4,16,1,1,2,1,False,0,1,1,2048,20,585.0666666666667,Bug
Go,421,1654,1558.0660416666667,MERGED,215,213,4,3,1,249,False,1,2,2,1197,428,74.05,Bug
JavaScript,5139,7050,1249.074409722222,CLOSED,1,4,2,2,2,5,False,0,2,2,894,5,62.42611111111111,Bug
Python,547,7160,2282.4930439814816,MERGED,46,89,3,1,5,232,False,0,1,1,669,135,2.846388888888889,Document
TypeScript,261,3765,725.0067476851851,MERGED,0,130,7,0,1,978,True,0,0,0,1782,130,12.215833333333334,Document
TypeScript,58,78,865.2866898148148,MERGED,6,16,6,1,4,105,False,0,1,1,2107,22,114.0225,Feature
TypeScript,58,78,868.132962962963,MERGED,62,74,2,1,2,183,False,0,1,1,2136,136,12.024444444444445,Feature
TypeScript,85,723,360.26163194444445,MERGED,15,15,3,0,2,10,False,0,0,0,1994,30,1.5763888888888888,Document
TypeScript,261,3765,724.7958217592592,MERGED,61,57,5,0,1,977,True,0,0,0,2046,118,0.9405555555555556,Document
TypeScript,85,723,360.1133564814815,MERGED,2,8,2,0,2,9,False,0,0,0,1385,10,4.2186111111111115,Document
Go,421,1654,1557.9887847222224,MERGED,0,63,1,0,1,472,True,0,0,0,1399,63,1.9480555555555557,Bug
TypeScript,85,723,364.05428240740736,MERGED,6,6,1,0,1,33,False,0,0,0,2399,12,0.12861111111111112,Document
TypeScript,261,3765,724.5508564814814,MERGED,106,206,7,0,3,234,False,0,0,0,2069,312,2.268611111111111,Document
Vue,10806,21163,1068.7773032407406,CLOSED,10,57,2,1,1,3,False,0,1,1,2054,67,527.2741666666667,Bug
JavaScript,9664,43889,3702.0007291666666,CLOSED,9,149,4,1,1,639,False,0,1,1,341,158,600.265,Feature
TypeScript,261,3765,723.6582986111111,MERGED,32,10,4,0,2,112,True,0,0,0,2222,42,20.296944444444446,Document
TypeScript,85,723,363.2705787037037,MERGED,4,6,3,0,1,108,False,0,0,0,2547,10,0.10805555555555556,Document
F#,153,337,2966.0915393518517,MERGED,3,44,3,3,2,13,False,2,1,1,1597,47,59.56361111111111,Document
TypeScript,261,3765,723.5386805555555,MERGED,5,98,5,0,3,272,True,0,0,0,2032,103,0.3502777777777778,Document
TypeScript,261,3765,723.4908680555556,MERGED,2,9,3,0,1,232,False,0,0,0,1631,11,0.23055555555555557,Document
C++,2234,23696,2404.847222222222,CLOSED,0,1051,1,3,2,349,False,2,1,1,153,1051,8.04888888888889,Feature
TypeScript,41370,87413,2983.588680555555,CLOSED,23,40,9,7,13,1,False,3,4,1,2933,63,1133.1775,Document
TypeScript,202,107,1188.820810185185,MERGED,0,1,1,3,1,258,True,0,3,3,773,1,0.8861111111111111,Document
Go,182,37,1756.2070254629627,MERGED,7,22,1,1,1,463,False,1,0,0,1771,29,14.96861111111111,Document
TypeScript,261,3765,722.7629282407407,MERGED,4,10,2,0,2,146,True,0,0,0,1911,14,0.2997222222222222,Document
TypeScript,261,3765,722.6716782407407,MERGED,2,18,5,0,2,271,True,0,0,0,1959,20,0.2625,Document
TypeScript,2147,14724,1518.9792592592594,MERGED,13,14,2,0,4,2,False,0,0,0,2128,27,19.838333333333335,Bug
V,2097,34362,1599.7894675925927,MERGED,0,16,3,0,1,241,True,0,0,0,804,16,10.002222222222223,Bug
C#,80,125,868.5237268518518,CLOSED,1,552,2,0,3,96,False,0,0,0,1014,553,1226.3291666666667,Document
JavaScript,5139,7050,1251.6350462962962,MERGED,2,10,2,5,6,0,False,0,5,3,1738,12,193.48583333333335,Document
Vue,293,495,875.656724537037,MERGED,27,8,2,5,2,404,False,1,4,4,991,35,52.46472222222222,Bug
TypeScript,2147,14724,1520.86,MERGED,11,17,2,0,1,747,False,0,0,0,2429,28,30.989722222222223,Bug
Go,395,660,1312.8959722222223,MERGED,24,84,2,0,16,71,False,0,0,0,331,108,409.87194444444447,Feature
TypeScript,85,723,360.35283564814813,MERGED,251,277,10,0,6,110,False,0,0,0,2603,528,17.264722222222222,Document
JavaScript,9664,43889,3702.150729166666,MERGED,4,4,1,0,1,5,False,0,0,0,291,8,424.0363888888889,Feature
TypeScript,3393,2334,1015.4406828703704,CLOSED,8,4,1,1,1,354,False,0,1,1,1302,12,0.9469444444444445,Feature
Vue,293,495,875.6106249999999,MERGED,0,2,1,2,1,403,False,0,2,2,868,2,7.703888888888889,Bug
TypeScript,85,723,360.0937847222222,MERGED,4,10,5,0,2,109,False,0,0,0,2403,14,0.07361111111111111,Document
TypeScript,202,107,1189.9725925925925,MERGED,0,9,2,3,1,260,True,0,3,3,876,9,5.719444444444444,Feature
TypeScript,202,107,1189.7402199074074,MERGED,1,1,1,3,1,259,True,0,3,3,972,2,0.25416666666666665,Feature
TypeScript,202,107,1189.6838425925926,MERGED,1,2,1,3,1,280,True,0,3,3,1074,3,0.895,Document
PHP,1334,2960,4254.930335648148,MERGED,2,351,3,1,3,79,False,0,1,1,2049,353,4.1241666666666665,Document
V,2097,34362,1596.8235763888888,MERGED,3,34,4,0,2,238,True,0,0,0,1139,37,24.211111111111112,Bug
Go,395,660,1314.3409027777777,CLOSED,1,1,1,0,1,350,False,0,0,0,249,2,2.8022222222222224,Feature
Vue,293,495,878.1251967592593,MERGED,63,116,13,18,12,3,False,2,16,7,1708,179,405.36555555555555,Bug
TypeScript,3393,2334,1013.9737037037038,MERGED,37,0,1,1,1,5,False,0,1,1,226,37,10.479722222222222,Feature
Go,395,660,1313.1667592592592,MERGED,33,68,1,0,2,347,False,0,0,0,171,101,19.634722222222223,Feature
Vue,10806,21163,1067.3344675925925,CLOSED,0,76,1,1,2,3,False,0,1,1,1236,76,0.39666666666666667,Bug
C++,2234,23696,2405.3868634259256,MERGED,14,48,3,1,9,7,False,0,1,1,1398,62,48.51611111111111,Bug
C++,2234,23696,2405.3809837962963,MERGED,98,970,2,1,2,6,False,0,1,1,1585,1068,48.645833333333336,Feature
TypeScript,85,723,364.28686342592596,MERGED,107,277,15,0,4,184,False,0,0,0,2955,384,0.8875,Document
TypeScript,85,723,364.1104629629629,MERGED,10,2,4,0,1,109,False,0,0,0,2609,12,5.425833333333333,Document
Python,19249,70259,2505.817314814815,CLOSED,1,1,1,2,2,1629,False,2,0,0,184,2,8.515277777777778,Feature
C#,80,125,868.8217361111111,CLOSED,2,2,2,1,2,5,True,1,0,0,1116,4,1219.213611111111,Document
F#,33,60,2303.1130092592593,MERGED,416,117,9,2,8,0,False,0,2,2,2518,533,76.33888888888889,Bug
Go,395,660,1314.078113425926,MERGED,102,61,10,1,4,32,False,1,0,0,508,163,307.55694444444447,Feature
Go,395,660,1313.0098611111111,MERGED,17,59,2,2,6,31,False,2,0,0,559,76,553.4097222222222,Feature
TypeScript,261,3765,723.7642708333333,MERGED,2,11,3,0,1,233,False,0,0,0,2784,13,0.4711111111111111,Document
TypeScript,261,3765,723.6808101851852,MERGED,3,54,3,0,1,273,True,0,0,0,2243,57,0.2886111111111111,Document
C#,80,125,867.952511574074,CLOSED,2757,21203,129,1,100,4,True,1,0,0,1002,23960,1240.066111111111,Document
TypeScript,85,723,362.90260416666666,MERGED,8,29,4,0,2,106,False,0,0,0,2826,37,5.836944444444445,Document
Go,395,660,1313.4611342592593,MERGED,4,5,2,0,2,348,False,0,0,0,192,9,11.385,Feature
TypeScript,1297,21107,464.6775578703703,MERGED,15,23,1,1,3,1108,True,0,1,1,1337,38,0.22138888888888889,Document
TypeScript,261,3765,722.8224421296296,MERGED,33,99,11,1,2,118,False,0,1,1,3211,132,19.420833333333334,Document
TypeScript,15,34,537.7071064814814,MERGED,52,71,2,0,1,1029,False,0,0,0,257,123,1.2755555555555556,Feature
Go,395,660,1313.4267476851853,MERGED,1,2,1,0,1,93,False,0,0,0,217,3,0.023333333333333334,Bug
TypeScript,261,3765,722.7971875,MERGED,3,17,4,0,1,975,True,0,0,0,2387,20,0.94,Document
Vue,293,495,878.0049189814814,MERGED,3,3,4,5,7,315,True,1,4,3,1425,6,15.487777777777778,Bug
Go,395,660,1312.9183912037038,MERGED,16,37,2,0,2,72,False,0,0,0,303,53,169.59722222222223,Bug
TypeScript,261,3765,722.5822106481481,MERGED,40,73,6,0,3,270,True,0,0,0,2933,113,2.1369444444444445,Document
Go,395,660,1314.3372222222222,CLOSED,1,1,1,0,1,349,False,0,0,0,269,2,2.888611111111111,Feature
Vue,10806,21163,1070.9090393518518,CLOSED,1,4,1,1,1,0,False,0,1,1,1540,5,20.904166666666665,Bug
V,2097,34362,1599.9071875,MERGED,2,23,3,0,2,242,True,0,0,0,1482,25,27.318055555555556,Bug
TypeScript,202,107,1191.5919444444444,MERGED,1,5,3,3,2,262,True,0,3,3,1707,6,45.469166666666666,Bug
Go,421,1654,1557.4944791666667,CLOSED,0,12,2,4,2,16,False,1,3,3,2832,12,12.569722222222222,Bug
TypeScript,307,2556,586.750011574074,MERGED,0,1,1,0,1,195,True,0,0,0,863,1,25.98111111111111,Feature
TypeScript,307,2556,586.7452893518519,MERGED,1,8,1,0,1,194,True,0,0,0,1311,9,26.10472222222222,Bug
Go,421,1654,1558.1988541666667,MERGED,16,9,2,0,1,474,True,0,0,0,2252,25,22.414444444444445,Bug
Go,395,660,1312.9973032407408,MERGED,44,21,4,0,3,117,False,0,0,0,279,65,94.38888888888889,Feature
TypeScript,307,2556,586.8772106481482,MERGED,2,2,1,0,1,12,False,0,0,0,1171,4,13.015,Bug
Go,395,660,1314.1629282407407,MERGED,4,13,2,0,1,122,False,0,0,0,291,17,48.504444444444445,Bug
JavaScript,5139,7050,1251.5714814814814,MERGED,86,268,13,5,6,267,False,1,4,3,3282,354,166.835,Feature
Go,421,1654,1558.0905439814815,MERGED,46,52,1,0,1,473,True,0,0,0,2811,98,0.6833333333333333,Bug
Vue,293,495,875.7491550925926,MERGED,17,64,6,7,2,405,False,1,6,4,1338,81,50.22611111111111,Bug
Python,137,75,733.9536689814814,MERGED,5,11,4,0,10,90,False,0,0,0,1165,16,46.288333333333334,Bug
JavaScript,8844,63474,4122.306863425926,MERGED,0,126,5,0,1,4,False,0,0,0,3375,126,1111.8191666666667,Feature
TypeScript,85,723,360.0773263888889,MERGED,12,36,4,0,3,103,False,0,0,0,3254,48,0.06777777777777778,Document
Python,137,75,733.2018518518518,MERGED,1,10,2,0,2,89,False,0,0,0,1508,11,69.88888888888889,Document
Python,137,75,733.1873726851851,MERGED,1,8,2,0,1,88,False,0,0,0,1139,9,70.13388888888889,Document
Go,421,1654,1555.9101504629627,MERGED,66,306,4,1,5,115,False,0,1,1,2956,372,78.30888888888889,Document
Python,137,75,733.0893171296296,MERGED,2,10,2,0,3,87,False,0,0,0,1530,12,73.34361111111112,Document
Python,137,75,732.9939467592593,MERGED,5,9,2,0,2,85,False,0,0,0,1519,14,75.77944444444445,Document
Python,137,75,732.9750115740741,MERGED,13,15,2,0,4,84,False,0,0,0,1523,28,76.34972222222223,Document
TypeScript,15,34,538.1090740740741,MERGED,0,7,1,0,3,1031,False,0,0,0,261,7,10.441944444444445,Feature
Go,421,1654,1556.2296643518519,MERGED,29,162,3,0,1,13,False,0,0,0,2697,191,40.48111111111111,Bug
Go,395,660,1313.4110532407408,MERGED,1,1,1,0,1,92,False,0,0,0,290,2,13.63888888888889,Feature
JavaScript,9664,43889,3706.1479976851856,MERGED,45,38,2,0,1,271,True,0,0,0,476,83,0.3705555555555556,Bug
Python,19249,70259,2505.650474537037,CLOSED,8,0,1,1,1,1628,False,1,0,0,264,8,3.2847222222222223,Feature
TypeScript,85,723,364.21530092592593,MERGED,9,146,3,0,3,34,False,0,0,0,2188,155,0.7030555555555555,Document
V,2097,34362,1597.4016319444445,MERGED,2,37,5,0,2,239,True,0,0,0,1120,39,18.261944444444445,Bug
Go,395,660,1313.0497222222223,MERGED,9,15,1,0,4,118,False,0,0,0,276,24,1.521388888888889,Bug
Java,450,746,4120.221041666667,MERGED,9,40,8,5,6,13,False,0,5,3,770,49,44.93944444444445,Feature
V,2097,34362,1596.8103587962962,MERGED,5,27,4,0,1,237,True,0,0,0,1291,32,19.51361111111111,Bug
Python,547,7160,2282.4211689814815,MERGED,4,6,1,0,2,621,True,0,0,0,1197,10,0.9252777777777778,Bug
TypeScript,15,34,537.4324652777779,MERGED,10,107,2,0,2,352,False,0,0,0,477,117,100.56361111111111,Feature
Java,450,746,4121.13443287037,MERGED,170,178,5,3,10,5,False,0,3,2,2823,348,74.5675,Bug
Vue,10806,21163,1071.3030671296297,MERGED,28,38,4,1,1,102,True,0,1,1,2640,66,71.80555555555556,Document
TypeScript,307,2556,586.6734606481481,MERGED,23,24,3,1,2,310,True,0,1,1,2968,47,506.1875,Feature
Go,2083,11769,1566.0061689814813,MERGED,5,5,2,0,1,929,True,0,0,0,1785,10,0.11888888888888889,Document
Go,395,660,1310.0521875,MERGED,2,17,1,0,2,115,False,0,0,0,275,19,68.05083333333333,Feature
JavaScript,5139,7050,1251.6380902777778,MERGED,4,185,3,1,10,119,False,0,1,1,2872,189,0.18611111111111112,Bug
TypeScript,15,34,534.5550462962963,MERGED,18,65,5,0,7,350,False,0,0,0,303,83,71.84666666666666,Feature
TypeScript,15,34,538.5628009259259,MERGED,39,26,2,0,1,1032,False,0,0,0,432,65,0.21638888888888888,Feature
JavaScript,9664,43889,3703.9175,MERGED,2,2,1,0,1,0,False,0,0,0,634,4,219.74138888888888,Feature
TypeScript,3393,2334,1012.3200115740741,CLOSED,11,26,6,1,4,3,False,0,1,1,2606,37,6.081111111111111,Document
TypeScript,15,34,537.3921759259259,MERGED,32,165,7,0,12,507,True,0,0,0,493,197,47.659166666666664,Feature
TypeScript,15,34,537.7570949074073,MERGED,21,238,11,0,9,353,False,0,0,0,449,259,1.8558333333333332,Feature
TypeScript,15,34,534.8650462962963,MERGED,8,16,1,0,2,351,False,0,0,0,336,24,0.13305555555555557,Bug
TypeScript,307,2556,586.9213888888888,MERGED,24,24,2,3,2,20,False,2,1,1,1716,48,38.05833333333333,Bug
TypeScript,12,11,1037.2742592592592,MERGED,37,840,14,0,5,59,False,0,0,0,4474,877,23.009166666666665,Bug
TypeScript,58,78,865.3511689814815,MERGED,19,11,9,1,2,106,False,0,1,1,3614,30,112.77944444444445,Feature
TypeScript,307,2556,586.7340277777778,MERGED,2,25,2,0,3,193,True,0,0,0,1635,27,40.7625,Feature
Go,2083,11769,1566.997175925926,MERGED,1,1,1,1,1,2,False,1,0,0,589,2,1.5291666666666666,Document
V,2097,34362,1599.4632291666667,MERGED,5,1,2,0,1,0,False,0,0,0,1745,6,8.350833333333334,Document
TypeScript,1297,21107,462.6134837962963,MERGED,29,15,3,1,1,1096,True,0,1,1,2196,44,0.02361111111111111,Document
TypeScript,2147,14724,1521.1430439814815,MERGED,111,135,10,0,1,189,False,0,0,0,4483,246,1.331388888888889,Feature
C#,80,125,868.5469675925925,MERGED,182,857,31,1,6,223,False,0,1,1,856,1039,335.9683333333333,Document
TypeScript,41370,87413,2985.8583912037034,MERGED,19,28,1,0,1,0,False,0,0,0,2178,47,3.3986111111111112,Document
C#,655,7879,1877.1153819444444,MERGED,121,420,20,8,9,22,False,0,8,3,1967,541,1027.5580555555555,Document
Java,450,746,4117.135173611111,CLOSED,124557,125553,258,0,11,36,False,0,0,0,550,250110,0.435,Feature
TypeScript,85,723,363.3725578703704,MERGED,18,26,6,0,11,11,False,0,0,0,4755,44,14.965277777777779,Document
TypeScript,85,723,363.1396759259259,MERGED,12,117,11,0,9,29,False,0,0,0,4581,129,18.871944444444445,Document
TypeScript,15,34,537.4649074074074,MERGED,55,3385,20,1,25,180,False,1,0,0,895,3440,425.18416666666667,Feature
TypeScript,178,1359,367.78414351851853,MERGED,16,189,10,2,1,46,True,0,2,2,4838,205,46.52777777777778,Feature
TypeScript,261,3765,723.8368402777778,MERGED,9,52,4,0,2,976,True,0,0,0,4174,61,0.6786111111111112,Document
Python,137,75,734.0164583333334,MERGED,0,347,13,0,36,4,False,0,0,0,2699,347,1520.5994444444445,Feature
TypeScript,261,3765,723.6572916666668,MERGED,15,85,13,0,4,636,True,0,0,0,4203,100,1.1388888888888888,Document
TypeScript,15,34,538.5687152777778,MERGED,0,23,3,0,1,61,False,0,0,0,711,23,2.310277777777778,Feature
TypeScript,15,34,537.4701273148148,MERGED,426,1062,33,0,36,141,False,0,0,0,665,1488,44.49583333333333,Feature
TypeScript,261,3765,722.7493055555556,MERGED,9,42,4,0,2,196,False,0,0,0,3497,51,0.6880555555555555,Document
Go,395,660,1313.0477777777778,MERGED,38,368,9,0,8,133,False,0,0,0,626,406,22.585,Feature
TypeScript,15,34,537.6636689814815,MERGED,5,49,2,0,4,60,False,0,0,0,694,54,0.6016666666666667,Feature
Go,395,660,1312.8972916666667,MERGED,78,30,8,0,2,116,False,0,0,0,598,108,24.361666666666668,Feature
Python,137,75,730.0295023148147,MERGED,0,404,15,0,42,0,False,0,0,0,2234,404,1134.0491666666667,Document
TypeScript,15,34,535.0948263888889,MERGED,93,224,18,1,14,506,True,0,1,1,702,317,121.1275,Bug
TypeScript,41370,87413,2983.0227083333334,CLOSED,16,24,6,2,4,0,False,1,1,1,2296,40,13.490555555555556,Document
Python,137,75,733.0435648148149,MERGED,19,28,2,0,4,86,False,0,0,0,2144,47,74.31277777777778,Document
TypeScript,2070,16640,1291.3751157407407,CLOSED,4,6,1,0,3,0,False,0,0,0,2855,10,1.3308333333333333,Bug
Python,137,75,732.831400462963,MERGED,8,20,2,0,3,83,False,0,0,0,2169,28,78.87777777777778,Document
C#,655,7879,1876.3871527777776,MERGED,10,59,3,3,2,21,False,0,3,3,2152,69,1045.5080555555555,Document
TypeScript,41370,87413,2982.5746296296297,CLOSED,1,0,1,0,1,1940,True,0,0,0,2022,1,0.5969444444444445,Document
C#,655,7879,1876.1483449074074,MERGED,0,2,1,0,1,80,False,0,0,0,1141,2,0.5186111111111111,Document
Python,137,75,732.2113888888889,MERGED,3,9,2,1,4,82,False,1,0,0,2062,12,94.80583333333334,Document
Python,137,75,732.1966087962963,MERGED,10,12,2,8,4,81,False,5,3,1,1752,22,95.28166666666667,Bug
TypeScript,41370,87413,2982.525162037037,MERGED,2,2,1,0,1,123,True,0,0,0,2126,4,0.6911111111111111,Document
Python,137,75,731.9549305555556,MERGED,8,14,3,1,5,80,False,0,1,1,2074,22,101.14333333333333,Document
JavaScript,9664,43889,3702.153738425926,MERGED,16,1,3,0,2,65,True,0,0,0,528,17,0.1527777777777778,Feature
TypeScript,85,723,360.1232638888889,MERGED,18,30,7,0,8,104,False,0,0,0,4199,48,1.3869444444444445,Document
Go,421,1654,1556.2892824074072,MERGED,32,596,8,0,1,470,True,0,0,0,4710,628,63.172222222222224,Bug
JavaScript,9664,43889,3702.0506597222225,MERGED,8,8,248,0,1,270,True,0,0,0,474,16,0.25805555555555554,Feature
Python,137,75,731.1266550925926,MERGED,23,197,8,3,11,79,False,1,2,2,1776,220,0.2866666666666667,Bug
Java,450,746,4117.275023148149,MERGED,48,202,9,1,9,378,False,0,1,1,2941,250,287.6225,Feature
TypeScript,7,6,689.9009259259259,MERGED,5,45,1,0,2,30,False,0,0,0,2944,50,90.70861111111111,Feature
Erlang,2054,12122,3844.216458333334,MERGED,57,106,2,0,2,82,False,0,0,0,813,163,0.4247222222222222,Document
Starlark,440,286,537.867662037037,MERGED,4,0,1,1,1,14,False,0,1,1,854,4,25.79111111111111,Feature
Erlang,2054,12122,3844.037210648148,MERGED,0,6,2,0,1,81,False,0,0,0,716,6,2.165277777777778,Document
JavaScript,3618,9016,2333.2103125,MERGED,2,7,1,1,1,406,True,0,1,1,877,9,23.634166666666665,Bug
V,2097,34362,1600.3117013888889,MERGED,0,13,3,0,3,221,True,0,0,0,1962,13,6.711111111111111,Document
TypeScript,202,107,1191.517824074074,MERGED,2,55,1,3,2,261,True,0,3,3,2618,57,47.260555555555555,Bug
TypeScript,85,723,360.17249999999996,MERGED,0,1,1,1,2,7,False,1,0,0,913,1,73.84666666666666,Document
Python,547,7160,2283.745011574074,MERGED,68,129,4,1,9,148,False,1,0,0,2483,197,70.595,Document
TypeScript,3393,2334,1015.8987037037036,MERGED,2,1,1,2,1,358,False,0,2,1,1072,3,0.18194444444444444,Feature
TypeScript,307,2556,586.673275462963,MERGED,1,19,4,0,1,192,True,0,0,0,2075,20,26.31888888888889,Bug
Python,137,75,729.9937847222222,MERGED,0,65,4,0,18,25,False,0,0,0,1186,65,556.7891666666667,Document
TypeScript,4,33,810.2390509259259,MERGED,1,7,1,2,3,249,True,1,1,1,993,8,0.19833333333333333,Bug
C#,80,125,868.6695601851852,MERGED,8,11,2,0,1,185,False,0,0,0,652,19,1.105,Document
C#,655,7879,1877.0579050925926,MERGED,4,10,1,5,1,44,False,2,3,3,2147,14,316.86083333333335,Document
TypeScript,4,33,810.0415393518518,MERGED,13,94,63,2,4,390,False,0,2,2,768,107,2.601111111111111,Feature
C,5530,39711,104.87099537037038,MERGED,40,98,2,1,3,32,False,1,0,0,761,138,19.084722222222222,Feature
TypeScript,307,2556,586.7339583333334,MERGED,3,3,1,0,1,11,False,0,0,0,1519,6,0.945,Bug
TypeScript,41369,87413,2985.711331018518,MERGED,4,6,4,0,1,31,False,0,0,0,3094,10,17.878333333333334,Document
V,2097,34362,1596.6336574074076,MERGED,3,80,3,0,5,220,True,0,0,0,2745,83,112.51722222222222,Document
TypeScript,41369,87413,2985.5163425925925,MERGED,1,6,1,0,2,609,True,0,0,0,2808,7,8.046666666666667,Document
TypeScript,41369,87413,2985.638125,MERGED,1,2,1,0,1,125,True,0,0,0,2323,3,0.5033333333333333,Document
TypeScript,41369,87413,2985.5250810185184,MERGED,2,2,2,0,1,124,True,0,0,0,2415,4,2.8047222222222223,Document
TypeScript,41369,87413,2984.838854166667,MERGED,2,73,2,0,2,57,False,0,0,0,2661,75,38.01638888888889,Document
TypeScript,41369,87413,2985.495115740741,MERGED,0,8,2,0,1,1616,True,0,0,0,2409,8,4.0761111111111115,Document
TypeScript,1297,21107,462.0253125,MERGED,31,17,4,1,2,1092,True,0,1,1,2565,48,0.29583333333333334,Document
Python,137,75,732.2117013888889,CLOSED,0,16,2,1,12,0,False,0,1,1,1150,16,399.2625,Bug
TypeScript,1297,21107,461.99760416666663,MERGED,6,103,7,1,2,1091,True,0,1,1,3036,109,0.23694444444444446,Document
TypeScript,1297,21107,461.7106481481481,MERGED,0,58,6,1,1,1090,True,0,1,1,2817,58,0.17583333333333334,Document
TypeScript,1297,21107,461.6292824074074,MERGED,22,64,6,1,1,1089,True,0,1,1,2714,86,0.17527777777777778,Document
Java,450,746,4117.161631944445,MERGED,16,1030,16,2,12,37,False,0,2,1,844,1046,118.02888888888889,Feature
V,2097,34362,1597.5192708333334,MERGED,10,17,1,0,2,15,True,0,0,0,1961,27,28.113611111111112,Document
V,2097,34362,1597.6578703703706,MERGED,984,950,7,0,3,27,True,0,0,0,2143,1934,12.045555555555556,Document
TypeScript,41369,87413,2984.751377314815,MERGED,1,39,3,0,2,1614,True,0,0,0,2775,40,1.4986111111111111,Document
TypeScript,41369,87413,2984.5977083333332,MERGED,0,2,2,0,1,470,True,0,0,0,2344,2,4.8741666666666665,Document
TypeScript,41369,87413,2983.765787037037,MERGED,1,0,1,0,1,3,False,0,0,0,2438,1,40.37777777777778,Document
TypeScript,41369,87413,2984.4490972222225,MERGED,7,11,1,0,1,469,True,0,0,0,2668,18,1.7905555555555555,Document
Python,547,7160,2282.594537037037,MERGED,1,23,2,0,5,238,False,0,0,0,1012,24,3.5375,Document
TypeScript,41369,87413,2983.738287037037,MERGED,7,471,3,2,2,22,True,1,1,1,2157,478,3.3955555555555557,Document
TypeScript,202,107,1188.7476504629628,MERGED,11,12,1,3,1,267,True,0,3,3,2739,23,2.890277777777778,Document
TypeScript,41369,87413,2982.981134259259,MERGED,0,232,2,3,1,1613,True,1,2,2,2374,232,1.5547222222222221,Document
JavaScript,9664,43889,3702.003993055556,MERGED,5,17,1,0,1,272,True,0,0,0,859,22,0.45472222222222225,Feature
TypeScript,12,11,1036.3327546296296,CLOSED,46,1374,11,0,32,172,False,0,0,0,7945,1420,220.57888888888888,Feature
TypeScript,41369,87413,2983.479282407407,MERGED,1,1,1,0,3,606,True,0,0,0,2329,2,0.5519444444444445,Document
TypeScript,41369,87413,2982.708715277778,MERGED,4,4,3,1,2,12,False,0,1,1,2728,8,0.7611111111111111,Document
TypeScript,41369,87413,2982.4844097222226,MERGED,2,1,1,0,1,122,True,0,0,0,2435,3,2.743333333333333,Document
Python,137,75,733.7252893518518,MERGED,15,199,7,0,25,6,False,0,0,0,1948,214,561.2022222222222,Document
TypeScript,2070,16640,1290.0981597222224,CLOSED,3,14,2,3,3,0,False,1,2,1,3887,17,198.0102777777778,Document
Erlang,2054,12122,3844.0833564814816,MERGED,9,53,6,0,6,383,True,0,0,0,1124,62,167.81833333333333,Document
Erlang,2054,12122,3844.2149074074073,MERGED,58,95,35,0,4,55,False,0,0,0,1082,153,21.97861111111111,Document
Python,2407,12185,287.3253587962963,MERGED,4,3,2,7,9,351,True,4,3,1,1718,7,19.033055555555556,Document
TypeScript,261,3765,723.6651273148149,MERGED,65,1240,38,0,26,69,False,0,0,0,5049,1305,217.64833333333334,Document
Erlang,2054,12122,3843.2013888888887,MERGED,59,129,34,1,7,54,False,1,0,0,1254,188,21.97,Document
C#,655,7879,1876.9259490740742,MERGED,2,326,5,3,1,634,True,1,2,2,2213,328,245.895,Document
Python,19249,70259,2508.5351041666668,CLOSED,1,1,1,1,1,591,True,1,0,0,1462,2,3.738888888888889,Bug
Erlang,2054,12122,3843.9519675925926,MERGED,4,90,1,0,2,85,False,0,0,0,1149,94,48.2725,Document
Erlang,2054,12122,3843.9069560185185,MERGED,16,30,3,0,2,422,True,0,0,0,1279,46,43.18083333333333,Document
Erlang,2054,12122,3843.2674537037037,MERGED,236,1873,11,0,2,397,False,0,0,0,1281,2109,71.49888888888889,Document
Erlang,2054,12122,3844.1435185185182,MERGED,5,29,7,0,1,25,False,0,0,0,1157,34,16.385555555555555,Document
TypeScript,2147,14724,1520.181087962963,MERGED,51,1478,12,0,4,58,False,0,0,0,5469,1529,15.22888888888889,Document
Erlang,2054,12122,3844.0016435185184,MERGED,4,16,1,0,1,423,True,0,0,0,1223,20,16.592222222222222,Document
Erlang,2054,12122,3842.2522569444445,MERGED,31,139,10,1,3,420,True,1,0,0,1308,170,105.76916666666666,Document
Starlark,440,286,538.3254166666667,MERGED,1,4,1,1,2,78,False,0,1,1,1311,5,14.53111111111111,Document
Erlang,2054,12122,3843.9990856481486,MERGED,3,19,4,0,1,24,False,0,0,0,988,22,1.625,Document
TypeScript,7,6,691.9887962962963,MERGED,32,46,10,0,6,281,False,0,0,0,3616,78,0.7713888888888889,Feature
C++,2234,23696,2404.847152777778,CLOSED,1,33,2,0,1,348,False,0,0,0,1592,34,8.050277777777778,Bug
Python,19249,70259,2508.719074074074,CLOSED,1,4,1,6,2,1630,False,5,1,1,1132,5,17.20888888888889,Bug
Erlang,2054,12122,3840.968668981481,MERGED,4,35,2,0,3,381,True,0,0,0,1084,39,124.34444444444445,Document
TypeScript,41369,87413,2983.4441782407407,MERGED,249,316,9,5,13,30,False,2,3,3,3546,565,287.62194444444447,Document
Python,2407,12185,287.7245138888889,MERGED,2,3,1,0,1,83,True,0,0,0,1549,5,1.575,Bug
C++,2234,23696,2403.9561458333333,CLOSED,2,29,2,1,2,347,False,1,0,0,1082,31,16.245555555555555,Feature
TypeScript,4,33,811.3136226851852,MERGED,12,8,2,2,2,251,True,1,1,1,1149,20,0.13,Feature
TypeScript,41369,87413,2984.4549652777782,MERGED,44,87,7,3,2,607,True,1,2,1,4889,131,0.855,Document
TypeScript,4,33,811.2404861111112,MERGED,30,290,8,1,5,392,False,0,1,1,1497,320,0.1622222222222222,Bug
TypeScript,4,33,811.1082175925926,MERGED,0,35,6,2,6,250,True,1,1,1,1813,35,4.2275,Bug
C#,655,7879,1877.062337962963,MERGED,28,55,1,4,1,45,False,0,4,2,2380,83,36.460277777777776,Document
Starlark,440,286,535.29625,MERGED,0,127,2,2,1,76,False,1,1,1,1608,127,91.53916666666667,Document
Starlark,440,286,537.0969097222222,CLOSED,1,1,1,1,1,6,False,0,1,1,1226,2,0.31027777777777776,Feature
TypeScript,4,33,810.6797337962963,MERGED,54,141,3,1,3,233,False,0,1,1,1720,195,5.9783333333333335,Bug
C++,363,552,584.9307175925926,MERGED,51,52,6,0,1,257,False,0,0,0,1675,103,3.535,Document
C#,655,7879,1877.1174074074072,MERGED,27,320,9,1,2,6,False,0,1,1,2595,347,526.1144444444444,Document
Python,2407,12185,287.02524305555556,MERGED,4,9,3,0,9,347,True,0,0,0,1514,13,1.8255555555555556,Document
JavaScript,22,26,963.0083912037038,MERGED,4,5,2,0,1,17,True,0,0,0,1286,9,2.3608333333333333,Feature
TypeScript,4,33,810.1975115740742,MERGED,11,11,1,5,2,649,True,4,1,1,1045,22,24.499444444444446,Bug
TypeScript,202,107,1192.9487037037036,MERGED,193,156,4,2,5,13,True,0,2,2,3553,349,1.2336111111111112,Document
TypeScript,261,3765,722.8366203703704,MERGED,66,134,16,0,1,119,False,0,0,0,6519,200,20.851111111111113,Document
TypeScript,3393,2334,1015.9156134259259,MERGED,6,0,1,1,1,142,False,0,1,1,1301,6,0.12194444444444444,Feature
V,2097,34362,1600.3983217592593,MERGED,22,118,13,0,10,243,True,0,0,0,3906,140,15.607222222222223,Bug
TypeScript,261,3765,722.8804166666667,MERGED,7,242,16,0,2,272,True,0,0,0,5898,249,14.957222222222223,Document
Erlang,2054,12122,3841.1256597222223,MERGED,9,19,2,0,2,382,True,0,0,0,1040,28,45.75555555555555,Document
TypeScript,3393,2334,1015.4247800925926,MERGED,0,8,1,1,1,353,False,0,1,1,1098,8,14.505277777777778,Feature
Starlark,440,286,536.7241319444445,MERGED,3,8,1,3,2,49,False,2,1,1,2158,11,53.52388888888889,Bug
TypeScript,307,2556,586.8798611111112,MERGED,1,62,8,0,1,197,True,0,0,0,3244,63,42.30277777777778,Feature
TypeScript,4,33,810.1820138888888,MERGED,10,11,4,2,4,248,True,1,1,1,1474,21,0.3447222222222222,Feature
TypeScript,261,3765,722.6655787037038,MERGED,298,26,104,0,1,973,True,0,0,0,6502,324,0.40055555555555555,Document
C#,655,7879,1876.1319675925924,MERGED,16,85,5,4,4,633,True,1,3,2,2316,101,362.0988888888889,Document
TypeScript,3393,2334,1015.2138078703703,MERGED,1,4,1,1,1,352,False,0,1,1,1141,5,0.32,Feature
V,2097,34362,1599.569351851852,MERGED,52,26,2,1,5,4,False,1,0,0,3664,78,24.540277777777778,Document
C++,363,552,583.8839236111111,MERGED,31,51,1,0,2,255,False,0,0,0,1605,82,8.815277777777778,Document
TypeScript,3393,2334,1015.1099537037038,MERGED,7,17,4,1,2,141,False,0,1,1,1294,24,1.8902777777777777,Feature
TypeScript,3706,54076,1404.7400578703703,MERGED,6,11,3,0,2,174,True,0,0,0,1730,17,5.988888888888889,Bug
V,2097,34362,1599.3310648148147,MERGED,3,153,6,0,3,16,True,0,0,0,4310,156,11.532222222222222,Document
Erlang,2054,12122,3840.2853125,MERGED,5,11,4,0,2,380,True,0,0,0,1157,16,32.69638888888889,Document
TypeScript,4,33,808.4498958333334,MERGED,0,24,1,2,2,2,False,1,1,1,1484,24,43.001666666666665,Document
TypeScript,41369,87414,2985.515520833333,MERGED,16,29,3,4,3,472,True,2,2,1,3469,45,49.06861111111111,Document
TypeScript,1297,21107,463.044375,MERGED,98,2,11,1,1,1101,True,0,1,1,4270,100,0.2627777777777778,Document
Python,2407,12185,284.8412962962963,MERGED,1,2,1,3,6,0,False,1,2,1,1371,3,29.863611111111112,Document
Erlang,2054,12122,3840.0747453703702,MERGED,4,4,1,0,1,23,False,0,0,0,1087,8,0.7388888888888889,Document
TypeScript,41369,87414,2985.607453703704,MERGED,4,24,6,0,3,45,False,0,0,0,4156,28,3.0077777777777777,Document
Go,421,1654,1556.1698379629631,MERGED,542,645,16,0,3,468,True,0,0,0,6099,1187,2.8469444444444445,Bug
TypeScript,41369,87414,2985.4462500000004,MERGED,0,58,6,0,2,44,False,0,0,0,4371,58,6.890833333333333,Document
C#,655,7879,1873.0555439814816,MERGED,35,62,6,1,7,597,True,0,1,1,1723,97,25.008055555555554,Document
TypeScript,41369,87414,2984.8903472222223,MERGED,13,17,1,0,1,1615,True,0,0,0,4126,30,12.918055555555556,Document
TypeScript,41369,87414,2984.75037037037,MERGED,1,50,6,0,2,43,False,0,0,0,4316,51,17.224166666666665,Document
TypeScript,1297,21107,461.60167824074074,MERGED,10,50,12,1,3,1088,True,0,1,1,3905,60,0.41944444444444445,Document
TypeScript,4,33,807.4382291666667,MERGED,1,7,2,2,1,647,True,1,1,1,1434,8,1.0397222222222222,Bug
JavaScript,5139,7050,1251.9522916666667,MERGED,21,1146,21,3,7,0,False,0,3,2,4610,1167,63.03055555555556,Document
TypeScript,41369,87414,2984.6862152777776,MERGED,1,42,6,0,2,42,False,0,0,0,4279,43,1.0730555555555557,Document
TypeScript,4,33,807.2090740740741,MERGED,2,11,2,2,1,643,True,1,1,1,1119,13,1.5386111111111112,Document
Starlark,440,286,536.8302546296296,CLOSED,4,3,3,3,38,1,False,2,1,1,1873,7,178.36833333333334,Bug
TypeScript,41369,87414,2983.7095254629626,CLOSED,10,17,5,0,1,468,True,0,0,0,3189,27,0.3011111111111111,Document
TypeScript,41369,87414,2983.651261574074,MERGED,1,39,3,0,5,45,True,0,0,0,4949,40,2.096111111111111,Document
TypeScript,7,6,692.1383912037037,MERGED,165,1183,14,0,66,254,False,0,0,0,6222,1348,572.615,Feature
TypeScript,41369,87414,2982.7317939814816,MERGED,19,4,1,0,1,1941,True,0,0,0,3482,23,0.4047222222222222,Document
TypeScript,41369,87414,2982.5711226851854,MERGED,11,12,1,0,1,1939,True,0,0,0,3131,23,2.5122222222222224,Document
Erlang,2054,12122,3842.719375,MERGED,6,29,3,0,2,421,True,0,0,0,1538,35,101.6375,Document
Starlark,440,286,538.6589236111112,MERGED,0,248,2,1,1,81,False,0,1,1,2176,248,3.996111111111111,Document
Starlark,440,286,538.6553587962964,MERGED,0,708,2,1,1,80,False,0,1,1,1608,708,5.905277777777778,Document
Starlark,440,286,538.6420138888889,MERGED,0,228,2,2,2,79,False,1,1,1,1917,228,6.906666666666666,Document
TypeScript,2070,16640,1291.222349537037,MERGED,59,328,6,5,10,22,True,3,2,1,8323,387,792.0391666666667,Bug
Starlark,440,286,537.8489236111111,CLOSED,0,39,2,1,1,130,True,0,1,1,2181,39,26.281388888888888,Document
C#,655,7879,1875.826712962963,MERGED,0,67,4,0,3,631,True,0,0,0,2235,67,91.3525,Document
Python,137,75,731.1687152777778,MERGED,0,544,9,0,11,2,False,0,0,0,2370,544,622.2619444444445,Bug
Starlark,440,286,537.2071180555555,MERGED,4,5,1,1,1,77,False,0,1,1,2161,9,41.39472222222222,Document
C#,655,7879,1875.688738425926,MERGED,2515,171,39,1,9,629,True,0,1,1,2284,2686,81.62777777777778,Document
Java,450,746,4119.962361111111,MERGED,476,3072,42,0,23,751,False,0,0,0,1769,3548,102.78083333333333,Feature
C#,655,7879,1875.9052430555555,MERGED,0,8,2,0,1,632,True,0,0,0,2197,8,44.46611111111111,Document
Starlark,440,286,536.0618981481481,MERGED,0,108,3,3,2,0,False,2,1,1,1642,108,70.38277777777778,Document
TypeScript,85,723,364.10994212962964,MERGED,17,364,10,0,10,106,False,0,0,0,9890,381,1.9175,Document
Starlark,440,286,535.291099537037,MERGED,0,128,2,2,1,75,False,1,1,1,1977,128,91.66666666666667,Document
Python,2407,12185,287.2525,MERGED,4,5,4,0,1,350,True,0,0,0,1961,9,0.18777777777777777,Document
C#,655,7879,1876.1230092592593,MERGED,4,34,3,0,2,11,False,0,0,0,2182,38,11.035277777777777,Document
Python,2407,12185,287.1409837962963,MERGED,3,5,1,1,10,348,True,1,0,0,2208,8,1.1372222222222221,Document
TypeScript,85,723,363.95835648148153,MERGED,106,199,37,0,8,32,False,0,0,0,10523,305,1.208611111111111,Document
TypeScript,3393,2334,1016.0680208333333,MERGED,3,5,1,1,2,355,False,0,1,1,2456,8,2.7358333333333333,Feature
C#,655,7879,1875.7353587962962,MERGED,1,54,3,0,2,630,True,0,0,0,2372,55,20.200833333333332,Document
Python,2407,12185,286.7808101851852,MERGED,2,108,3,1,5,346,True,1,0,0,1986,110,0.7366666666666667,Document
TypeScript,4,33,808.3445833333334,MERGED,162,257,20,1,13,392,True,0,1,1,2248,419,97.20166666666667,Document
Python,137,75,729.8953009259259,MERGED,21,152,6,0,7,78,False,0,0,0,3781,173,29.84,Document
TypeScript,4,33,810.1750347222222,MERGED,1,1,1,2,1,247,True,1,1,1,1740,2,0.08138888888888889,Feature
TypeScript,4,33,808.4786689814815,MERGED,204,1623,34,1,41,393,True,0,1,1,1739,1827,76.35055555555556,Feature
TypeScript,85,723,363.0614699074074,MERGED,13,4124,41,0,3,181,False,0,0,0,8189,4137,3.285,Document
C#,655,7879,1872.9520486111112,MERGED,73,43,2,0,2,628,True,0,0,0,2176,116,103.23277777777778,Document
Python,14533,41188,1133.5098611111111,MERGED,7,9,2,0,3,1427,True,0,0,0,2111,16,0.08666666666666667,Document
TypeScript,3393,2334,1013.03875,MERGED,18,18,1,2,1,279,False,0,2,1,1860,36,32.925555555555555,Feature
TypeScript,4,33,807.7189351851852,MERGED,73,193,9,1,6,232,False,0,1,1,1585,266,69.96777777777778,Bug
Go,421,1654,1557.0993171296295,MERGED,158,472,19,0,1,471,True,0,0,0,8534,630,96.4588888888889,Document
TypeScript,4,33,808.5297337962962,MERGED,6,12,2,2,1,246,True,1,1,1,2080,18,0.09916666666666667,Bug
C#,655,7879,1876.609872685185,MERGED,104057,77139,6675,0,752,1514,True,0,0,0,2443,181196,10.825833333333334,Document
TypeScript,1073,11366,1139.8123611111112,MERGED,0,2,1,1,1,762,True,0,1,1,1892,2,0.3055555555555556,Bug
TypeScript,4,33,807.3097800925925,MERGED,15,16,15,4,3,644,True,3,1,1,2405,31,3.8533333333333335,Document
Go,1835,11245,1774.924224537037,MERGED,12,24,4,0,1,19,False,0,0,0,2099,36,0.6441666666666667,Document
Go,1835,11245,1775.874803240741,MERGED,13,9,4,1,1,569,False,1,0,0,1939,22,19.399444444444445,Document
Go,1835,11245,1774.695474537037,MERGED,0,15,1,1,1,568,False,1,0,0,1702,15,6.413333333333333,Document
Go,1835,11245,1774.7982407407408,MERGED,8,8,5,0,1,98,False,0,0,0,2021,16,0.5755555555555556,Feature
C#,655,7879,1876.057326388889,CLOSED,38,143,6,0,7,12,False,0,0,0,3324,181,889.8755555555556,Document
Starlark,440,286,538.4286458333333,MERGED,0,211,5,2,2,1,False,1,1,1,2743,211,22.476111111111113,Document
Python,2408,12185,288.7853587962963,MERGED,1,10,1,0,3,353,True,0,0,0,2962,11,3.7330555555555556,Document
TypeScript,1073,11366,1139.799548611111,MERGED,4,9,1,1,10,1,False,0,1,1,2393,13,190.80555555555554,Document
Starlark,440,286,536.0238541666666,MERGED,0,152,3,3,1,44,False,2,1,1,2010,152,70.84361111111112,Document
TypeScript,307,2556,586.8353472222223,MERGED,27,135,9,0,3,196,True,0,0,0,6207,162,18.739444444444445,Bug
Python,2408,12185,287.19266203703705,MERGED,70,35,5,0,4,349,True,0,0,0,3058,105,0.7047222222222222,Document
TypeScript,41369,87414,2986.0990046296297,MERGED,18,18,6,7,7,0,False,4,3,2,5085,36,45.961666666666666,Document
TypeScript,1073,11366,1142.796724537037,MERGED,1,1,1,1,2,198,False,0,1,1,2139,2,15.516388888888889,Bug
Python,4516,54990,973.6158101851852,MERGED,2,13,1,2,3,0,False,1,1,1,3073,15,26.121111111111112,Document
Starlark,440,286,535.8863888888889,MERGED,0,102,3,2,1,0,False,1,1,1,2958,102,47.14472222222222,Document
Java,450,746,4121.041481481481,MERGED,25,37,5,1,3,55,False,0,1,1,3361,62,2.769722222222222,Feature
TypeScript,1297,21107,463.02310185185183,MERGED,571,297,111,1,4,1100,True,0,1,1,7951,868,0.14888888888888888,Document
TypeScript,1073,11366,1142.5378703703702,MERGED,7,171,4,1,1,197,False,0,1,1,3146,178,0.5352777777777777,Bug
TypeScript,1073,11366,1142.5311574074074,MERGED,591,1,2,2,1,36,True,1,1,1,2622,592,0.515,Bug
TypeScript,1073,11366,1142.5104166666667,MERGED,1,7,2,1,1,196,False,0,1,1,2848,8,1.1144444444444443,Bug
TypeScript,1073,11366,1142.508275462963,MERGED,0,4,1,1,1,195,False,0,1,1,2677,4,1.2075,Bug
TypeScript,1297,21107,462.943599537037,MERGED,75,163,34,1,4,1099,True,0,1,1,7391,238,0.9227777777777778,Document
TypeScript,41369,87414,2985.7827662037034,MERGED,4,24,6,0,4,48,False,0,0,0,5339,28,19.81111111111111,Document
TypeScript,41369,87414,2984.8124305555557,MERGED,18,83,6,0,21,471,True,0,0,0,5045,101,69.59805555555556,Document
TypeScript,1297,21107,462.7054166666667,MERGED,253,8035,44,1,9,1097,True,0,1,1,5948,8288,0.2063888888888889,Document
TypeScript,1297,21107,462.5146990740741,MERGED,14840,12635,35,1,2,1094,True,0,1,1,6450,27475,0.3030555555555556,Document
TypeScript,4,33,810.0843981481481,MERGED,12,12,6,1,1,391,False,0,1,1,2928,24,0.14555555555555555,Bug
Python,2408,12185,285.871875,MERGED,5,8,2,0,1,343,True,0,0,0,2485,13,0.3672222222222222,Bug
TypeScript,7046,76149,2675.7941898148147,MERGED,3479,14347,50,3,1,107,False,0,3,2,5893,17826,0.03888888888888889,Feature
TypeScript,41369,87414,2985.624375,MERGED,2,34,6,0,1,46,False,0,0,0,4592,36,2.6275,Document
TypeScript,41369,87414,2985.447291666667,MERGED,1,41,3,8,4,608,True,2,6,3,5516,42,3.339166666666667,Document
TypeScript,41369,87414,2985.4734375000003,MERGED,13,34,3,0,2,203,False,0,0,0,4815,47,0.4091666666666667,Document
TypeScript,1297,21107,462.0525925925926,MERGED,98,99,100,1,1,1093,True,0,1,1,7499,197,0.16333333333333333,Document
TypeScript,3393,2334,1012.5747222222222,MERGED,28,51,8,2,1,4,False,0,2,2,3666,79,82.005,Document
TypeScript,1073,11366,1141.784050925926,MERGED,54,52,2,1,4,284,True,0,1,1,3424,106,0.575,Bug
TypeScript,41369,87414,2983.5118634259256,MERGED,7,86,5,0,1,467,True,0,0,0,6319,93,0.5430555555555555,Document
TypeScript,85,723,363.07488425925925,MERGED,84,114,26,0,7,107,False,0,0,0,11776,198,4.3975,Document
TypeScript,178,1359,367.3611111111111,MERGED,207,210,4,1,1,31,True,0,1,1,11070,417,56.602777777777774,Bug
Go,1835,11245,1776.7646412037038,MERGED,1,54,2,0,1,570,False,0,0,0,2485,55,0.6427777777777778,Document
TypeScript,85,723,360.06247685185184,MERGED,158,981,28,0,17,105,False,0,0,0,12117,1139,92.19583333333334,Document
TypeScript,1073,11366,1142.9582060185185,CLOSED,3,4,2,0,1,2,False,0,0,0,3165,7,519.7252777777778,Bug
Go,182,37,1755.1759259259259,MERGED,64,176,12,0,10,462,False,0,0,0,10570,240,39.94833333333333,Document
Python,2408,12185,287.6508449074074,MERGED,6,942,8,32,39,0,False,14,18,3,3637,948,229.99027777777778,Document
Python,137,75,732.3194791666666,MERGED,0,17,13,0,2,217,False,0,0,0,3780,17,88.01138888888889,Document
JavaScript,22,26,965.1755208333334,MERGED,26,76,6,0,6,18,True,0,0,0,4452,102,8.295,Bug
TypeScript,41369,87415,2985.759131944444,MERGED,7,59,6,2,5,47,False,1,1,1,7507,66,18.048055555555557,Document
TypeScript,41369,87415,2985.662824074074,MERGED,19,189,17,3,8,473,True,2,1,1,8066,208,0.8947222222222222,Document
Python,4516,54990,972.492523148148,MERGED,0,151,2,0,5,109,True,0,0,0,3758,151,2.022222222222222,Document
TypeScript,1073,11366,1142.0697685185185,MERGED,21,61,1,1,1,764,True,0,1,1,3872,82,133.23805555555555,Feature
Python,4516,54990,973.2825347222223,MERGED,14,173,4,5,14,0,False,1,4,2,4527,187,103.28916666666667,Document
Python,4516,54990,972.9538773148148,MERGED,1,24,1,0,2,146,False,0,0,0,4062,25,92.16583333333334,Document
Python,4516,54990,974.4740162037037,MERGED,2,18,1,1,3,0,False,1,0,0,3640,20,4.714722222222222,Document
TypeScript,1073,11366,1142.8353587962963,MERGED,6,16,2,1,2,285,True,0,1,1,3180,22,22.683888888888887,Bug
TypeScript,1073,11366,1142.8960648148147,MERGED,6,34,2,1,1,286,True,0,1,1,3636,40,19.51527777777778,Document
TypeScript,1073,11366,1142.507627314815,MERGED,1,8,2,1,1,194,False,0,1,1,3192,9,26.345,Document
Python,2408,12185,286.33131944444443,MERGED,7,32,4,0,6,345,True,0,0,0,3871,39,0.2525,Document
Java,450,746,4120.212835648148,MERGED,15,126,6,1,7,54,False,0,1,1,3546,141,1.1508333333333334,Bug
Python,4516,54990,972.716412037037,CLOSED,2,25,4,1,15,0,False,1,0,0,4181,27,0.03777777777777778,Document
Python,4516,54990,972.5472916666666,MERGED,2,4,1,0,1,0,False,0,0,0,3604,6,2.8602777777777777,Document
TypeScript,1073,11366,1141.0006597222223,MERGED,22,73,14,1,2,763,True,0,1,1,4195,95,15.195277777777777,Document
JavaScript,0,0,38.15549768518519,CLOSED,0,11339,64,0,2,9,False,0,0,0,4022,11339,2.9816666666666665,Document
Go,1835,11245,1777.1585763888888,MERGED,166,72,8,0,3,6,False,0,0,0,3381,238,44.74638888888889,Document
TypeScript,1073,11366,1139.9234027777777,MERGED,22,55,6,1,2,283,True,0,1,1,4932,77,0.6197222222222222,Bug
TypeScript,4,33,807.3930555555556,MERGED,74,213,61,3,1,646,True,2,1,1,5154,287,1.718611111111111,Feature
TypeScript,1073,11366,1138.9205902777778,MERGED,2,22,4,1,2,282,True,0,1,1,3776,24,19.476944444444445,Bug
Java,450,746,4117.1052314814815,MERGED,230,443,10,2,4,382,True,0,2,1,3573,673,2.404166666666667,Bug
TypeScript,85,723,363.9951388888889,MERGED,167,568,37,0,2,182,False,0,0,0,17515,735,0.5922222222222222,Document
Python,547,7160,2286.0133333333333,MERGED,12,33,8,0,38,33,False,0,0,0,5276,45,352.7375,Document
Python,2408,12185,288.71096064814816,CLOSED,15395,15689,218,10,24,84,True,6,4,1,6291,31084,410.96222222222224,Document
Java,450,746,4119.996412037037,MERGED,288,358,19,2,4,84,True,0,2,1,11871,646,46.12777777777778,Document
TypeScript,41369,87415,2983.4663657407405,MERGED,717,2031,124,1,63,1942,True,0,1,1,11862,2748,2.6758333333333333,Document
Erlang,2054,12122,3840.1560532407407,MERGED,1693,3203,57,0,5,140,False,0,0,0,4439,4896,406.65972222222223,Document
Rust,413,5118,514.3185532407407,MERGED,10,510,14,0,12,18,False,0,0,0,7120,520,50.959722222222226,Document
TypeScript,184,377,1959.0424189814814,MERGED,21,22,2,0,3,43,False,0,0,0,5134,43,17.48027777777778,Document
TypeScript,3393,2334,1016.1639699074075,MERGED,345,2167,64,2,57,487,False,0,2,1,8017,2512,6.5777777777777775,Feature
TypeScript,4803,40785,3807.6347685185187,MERGED,35,190,11,1,4,149,True,0,1,1,6773,225,1.1608333333333334,Bug
TypeScript,4,33,811.3032060185186,MERGED,42,365,29,2,2,651,True,1,1,1,6941,407,4.748333333333333,Document
TypeScript,3393,2334,1015.3298032407407,MERGED,210,777,18,3,4,726,False,0,3,2,5311,987,19.44638888888889,Bug
Python,968,6760,100.11004629629629,MERGED,36,116,3,3,6,0,False,0,3,2,4938,152,45.29416666666667,Document
TypeScript,4,33,810.5265277777777,MERGED,1109,1206,33,5,1,650,True,4,1,1,6376,2315,16.740555555555556,Feature
TypeScript,1073,11366,1142.8163078703703,MERGED,74,72,52,1,1,199,False,0,1,1,7939,146,0.5425,Bug
TypeScript,4,33,810.1974652777777,MERGED,295,191,21,5,3,648,True,4,1,1,7340,486,24.415277777777778,Feature
Python,2408,12185,285.915474537037,MERGED,156,473,16,0,32,344,True,0,0,0,5450,629,8.968055555555555,Document
TypeScript,4,33,807.3634953703704,MERGED,331,1091,73,4,2,645,True,3,1,1,5129,1422,92.31666666666666,Document
TypeScript,1073,11366,1139.598148148148,MERGED,160,585,25,1,6,761,True,0,1,1,8168,745,2.26,Bug
Go,1835,11245,1777.1544675925925,MERGED,53,99,14,0,5,42,False,0,0,0,6071,152,11.018055555555556,Document
Go,1835,11245,1776.0633796296297,MERGED,75,562,12,0,3,29,True,0,0,0,5693,637,66.83555555555556,Document
Go,1835,11245,1776.8539583333334,MERGED,581,1780,39,1,1,12,False,0,1,1,9679,2361,44.85194444444444,Document
Go,752,2399,775.7172106481481,MERGED,402,228,12,0,15,440,False,0,0,0,8904,630,306.3330555555556,Bug
TypeScript,3393,2334,1015.9213657407407,MERGED,2167,345,64,2,1,359,False,0,2,1,9077,2512,0.2761111111111111,Feature
Go,1835,11245,1777.0770833333333,MERGED,1133,1,22,0,1,571,False,0,0,0,9625,1134,185.41666666666666,Document
Go,1835,11245,1776.5991203703704,MERGED,1,5564,67,1,20,14,False,0,1,1,7544,5565,175.085,Document
TypeScript,3393,2334,1014.9001851851853,MERGED,469,1277,103,3,65,140,False,1,2,2,11900,1746,0.6077777777777778,Bug
Java,450,746,4117.2662152777775,MERGED,104,345,15,1,7,667,False,0,1,1,11453,449,145.99444444444444,Feature
C,5531,39710,107.54083333333334,MERGED,409,531,13,21,20,7,False,10,11,4,14975,940,272.4538888888889,Document
Python,4516,54990,970.2821412037038,CLOSED,32,58,4,0,5,40,True,0,0,0,14309,90,325.5338888888889,Document
PHP,1334,2960,4264.129895833333,MERGED,1,1,1,1,1,19,False,0,1,1,734,2,336.90833333333336,Document
TypeScript,15,34,544.7617476851852,CLOSED,0,0,2,0,1,1040,False,0,0,0,333,0,1271.3130555555556,Feature
TypeScript,2147,14724,1528.0749305555555,MERGED,40,37,1,2,5,1,False,1,1,1,667,77,137.09805555555556,Document
TypeScript,12,11,1045.5140393518518,MERGED,97,1118,8,0,13,180,False,0,0,0,784,1215,142.9788888888889,Feature
Vue,10806,21163,1071.7266435185186,MERGED,1,36,2,4,1,14,False,2,2,2,1892,37,1371.0425,Bug
V,2097,34362,1601.8975925925924,MERGED,0,39,3,0,1,44,True,0,0,0,1303,39,18.045277777777777,Bug
TypeScript,2147,14724,1529.1540277777776,MERGED,1,2,1,0,1,2,False,0,0,0,617,3,17.467777777777776,Bug
TypeScript,2147,14724,1529.1655324074075,MERGED,1,1,1,0,1,3,False,0,0,0,645,2,0.5544444444444444,Document
PHP,1334,2960,4257.23943287037,MERGED,1,1,1,2,1,24,False,0,2,2,688,2,524.6605555555556,Feature
TypeScript,2147,14724,1527.997824074074,MERGED,1,1,1,0,1,195,False,0,0,0,763,2,0.4986111111111111,Bug
TypeScript,2147,14724,1527.7859722222222,MERGED,2,2,1,0,1,194,False,0,0,0,673,4,1.6419444444444444,Feature
TypeScript,178,1359,378.24997685185184,MERGED,1,1,1,1,1,34,True,0,1,1,831,2,13.801944444444445,Bug
C#,80,125,876.782662037037,MERGED,10,12,3,0,3,1,False,0,0,0,432,22,1032.2177777777779,Feature
TypeScript,58,78,877.061701388889,MERGED,7,136,3,1,6,131,False,0,1,1,1768,143,390.1011111111111,Bug
TypeScript,85,723,371.06409722222224,MERGED,35,46,4,0,3,116,False,0,0,0,1175,81,0.45444444444444443,Document
C++,2234,23696,2408.934502314815,MERGED,1,35,2,1,1,560,False,0,1,1,812,36,638.9191666666667,Feature
TypeScript,85,723,370.94200231481483,MERGED,0,2,1,0,1,113,False,0,0,0,1406,2,24.1575,Document
Python,547,7160,2294.627465277778,MERGED,98,122,7,0,11,237,False,0,0,0,947,220,1.2927777777777778,Document
TypeScript,85,723,371.1368518518518,MERGED,7,8,1,0,1,118,False,0,0,0,1072,15,0.08888888888888889,Document
TypeScript,85,723,370.9777777777778,MERGED,1,2,1,0,1,114,False,0,0,0,1030,3,0.10722222222222222,Document
Vue,10806,21163,1071.8738194444445,MERGED,5,57,5,3,16,0,False,1,2,2,2523,62,1373.7466666666667,Document
TypeScript,58,78,869.2118518518519,MERGED,0,22,4,5,5,130,False,2,3,3,2367,22,723.1261111111111,Feature
TypeScript,2147,14724,1522.7189930555558,MERGED,8,22,3,0,2,192,False,0,0,0,696,30,5.638888888888889,Bug
TypeScript,85,723,369.988125,MERGED,0,3,1,0,1,111,False,0,0,0,1071,3,45.39416666666666,Document
TypeScript,85,723,370.23145833333336,MERGED,1,1,1,0,1,186,False,0,0,0,1055,2,17.620277777777776,Document
Vue,293,495,886.8326736111111,MERGED,1,1,1,3,1,318,True,0,3,2,308,2,0.26805555555555555,Feature
TypeScript,2147,14724,1522.0311574074074,MERGED,282,260,3,0,1,191,False,0,0,0,679,542,1.926388888888889,Document
PHP,1334,2960,4262.227025462963,MERGED,3,0,1,3,1,2,False,0,3,3,1698,3,408.03055555555557,Document
TypeScript,85,723,370.0496180555556,MERGED,8,19,1,0,2,111,False,0,0,0,1130,27,5.325833333333334,Document
TypeScript,2147,14724,1527.1203935185185,MERGED,1,3,1,1,1,0,False,0,1,1,765,4,2.6169444444444445,Feature
TypeScript,2147,14724,1527.072835648148,MERGED,16,6,3,0,2,91,False,0,0,0,883,22,1.05,Feature
TypeScript,85,723,369.94063657407406,MERGED,3,10,1,0,2,110,False,0,0,0,1313,13,1.1869444444444444,Document
C++,2234,23696,2413.992685185185,MERGED,0,3,1,1,1,16,True,0,1,1,1231,3,517.4902777777778,Feature
JavaScript,5139,7050,1260.6972453703704,CLOSED,0,35,1,3,1,0,False,0,3,2,718,35,0.07916666666666666,Feature
TypeScript,2147,14724,1526.8002893518517,MERGED,1,9,1,0,1,755,False,0,0,0,1085,10,3.4322222222222223,Feature
TypeScript,2147,14724,1523.8786342592593,MERGED,0,2,1,0,1,681,False,0,0,0,669,2,3.0155555555555558,Document
TypeScript,2147,14724,1523.8733101851851,MERGED,0,4,1,0,1,311,False,0,0,0,738,4,2.1191666666666666,Feature
TypeScript,2147,14724,1528.8653356481482,MERGED,31,39,2,0,1,312,False,0,0,0,1501,70,120.18444444444444,Document
PHP,1334,2960,4261.523344907408,MERGED,1,1,1,2,1,210,False,0,2,2,703,2,14.68361111111111,Document
Go,421,1654,1564.1184837962962,MERGED,6,30,1,0,1,69,False,0,0,0,914,36,94.93111111111111,Bug
TypeScript,2147,14724,1523.0226273148148,MERGED,50,57,1,0,1,754,False,0,0,0,800,107,18.311666666666667,Feature
TypeScript,2147,14724,1522.821574074074,MERGED,2,2,1,0,1,752,False,0,0,0,946,4,3.193611111111111,Bug
TypeScript,261,3765,732.7426736111111,MERGED,0,8,2,0,1,277,True,0,0,0,1268,8,0.4002777777777778,Document
TypeScript,261,3765,732.7236226851852,MERGED,4,10,3,0,5,242,False,0,0,0,1385,14,0.5158333333333334,Document
TypeScript,261,3765,732.5096296296297,MERGED,53,60,3,0,1,202,False,0,0,0,1534,113,1.0427777777777778,Document
TypeScript,85,723,371.3082523148148,MERGED,10,65,2,0,2,15,False,0,0,0,1803,75,72.66388888888889,Document
TypeScript,261,3765,732.4924768518518,MERGED,0,34,2,0,2,201,False,0,0,0,1450,34,0.6225,Document
V,2097,34362,1607.7693865740741,MERGED,3,11,2,0,2,251,True,0,0,0,510,14,23.02888888888889,Bug
TypeScript,7,6,700.0704166666666,MERGED,0,2,1,1,10,229,False,0,1,1,681,2,0.034444444444444444,Document
TypeScript,2147,14724,1521.8025,MERGED,1,1,1,0,1,45,False,0,0,0,681,2,1.3197222222222222,Document
TypeScript,85,723,372.1471759259259,MERGED,1,2,1,0,1,107,False,0,0,0,1591,3,0.2825,Document
TypeScript,2147,14724,1529.2017824074073,MERGED,0,7,1,0,2,43,False,0,0,0,1038,7,0.14666666666666667,Bug
TypeScript,2147,14724,1529.03875,MERGED,19,19,1,0,2,760,False,0,0,0,1430,38,2.111111111111111,Feature
TypeScript,261,3765,731.5301736111111,MERGED,2,10,2,0,1,991,True,0,0,0,1587,12,0.4027777777777778,Document
TypeScript,85,723,371.19114583333334,MERGED,0,16,2,0,1,14,False,0,0,0,1358,16,18.593611111111112,Document
TypeScript,85,723,371.0061689814815,MERGED,10,39,3,0,2,188,False,0,0,0,1819,49,23.04611111111111,Document
TypeScript,2147,14724,1528.1532291666665,MERGED,2,36,3,0,1,112,False,0,0,0,1496,38,14.619166666666667,Bug
TypeScript,2147,14724,1527.8540740740739,MERGED,10,44,5,0,2,757,False,0,0,0,1240,54,29.523888888888887,Bug
TypeScript,2147,14724,1523.1739467592595,MERGED,8,17,1,0,1,111,False,0,0,0,988,25,14.2275,Feature
TypeScript,2147,14724,1522.9557060185186,MERGED,0,28,1,1,1,0,False,0,1,1,944,28,21.02638888888889,Document
TypeScript,85,723,371.1141435185186,MERGED,1,16,2,0,1,117,False,0,0,0,1915,17,0.43833333333333335,Document
Go,421,1654,1563.4744791666665,MERGED,1,1,1,0,1,479,True,0,0,0,816,2,11.752777777777778,Bug
TypeScript,85,723,370.97517361111113,MERGED,4,11,3,0,2,112,False,0,0,0,1843,15,0.6111111111111112,Document
JavaScript,5139,7050,1255.9493287037037,MERGED,2,1,1,1,1,14,False,0,1,1,650,3,53.78194444444444,Bug
TypeScript,261,3765,730.7761458333333,MERGED,435,0,20,0,1,990,True,0,0,0,1629,435,0.1386111111111111,Document
TypeScript,2147,14724,1522.9925462962963,CLOSED,1,8,2,2,2,55,False,0,2,1,929,9,1.53,Feature
C#,80,125,875.8846412037037,CLOSED,4,26,5,1,2,100,False,1,0,0,869,30,17.315277777777776,Document
TypeScript,7,6,701.9404398148148,CLOSED,0,0,0,0,0,285,False,0,0,0,765,0,1.6411111111111112,Feature
PHP,1334,2960,4258.242337962963,CLOSED,2,2,1,5,3,209,False,2,3,2,1095,4,166.17277777777778,Bug
V,2097,34362,1605.7587847222221,MERGED,1,35,6,2,3,248,True,0,2,2,467,36,23.043055555555554,Bug
TypeScript,7,6,701.0914351851852,CLOSED,8,18,1,0,3,236,False,0,0,0,1134,26,46.285833333333336,Feature
TypeScript,85,723,370.19796296296295,MERGED,3,3,3,0,1,107,False,0,0,0,1434,6,19.780277777777776,Document
TypeScript,2147,14724,1528.726539351852,MERGED,4,46,3,0,3,758,False,0,0,0,1998,50,9.954722222222221,Document
Go,421,1654,1562.151724537037,MERGED,1,1,1,0,2,477,True,0,0,0,918,2,42.11361111111111,Bug
TypeScript,2147,14724,1526.7670949074075,MERGED,34,55,6,2,1,1,False,1,1,1,1572,89,4.9286111111111115,Bug
TypeScript,2147,14724,1527.2439583333335,MERGED,7,5,6,0,2,756,False,0,0,0,970,12,13.046944444444444,Feature
TypeScript,2147,14724,1522.0420023148147,MERGED,1,1,1,0,1,110,False,0,0,0,777,2,17.89,Bug
TypeScript,85,723,365.19738425925925,MERGED,0,4,1,0,1,37,False,0,0,0,1097,4,0.008888888888888889,Document
V,2097,34362,1604.4667476851853,MERGED,3,5,1,0,2,245,True,0,0,0,515,8,61.66138888888889,Bug
Python,547,7160,2289.446886574074,MERGED,2,2,1,0,5,150,False,0,0,0,933,4,145.01333333333332,Bug
TypeScript,2147,14724,1526.9471180555556,MERGED,10,17,2,1,1,90,False,0,1,1,1073,27,0.9205555555555556,Feature
TypeScript,2147,14724,1522.0251851851851,MERGED,3,8,1,0,1,71,False,0,0,0,1001,11,0.43,Bug
TypeScript,261,3765,731.7344675925925,MERGED,26,130,11,0,3,49,False,0,0,0,1347,156,29.836388888888887,Document
V,2097,34362,1606.9424074074075,MERGED,4,67,5,1,6,250,True,0,1,1,750,71,18.14611111111111,Bug
TypeScript,202,107,1200.041701388889,CLOSED,0,0,0,6,0,0,False,2,4,3,1487,0,502.00694444444446,Bug
Go,421,1654,1565.2271296296296,MERGED,9,12,5,0,1,481,True,0,0,0,1659,21,71.68583333333333,Bug
Python,72,25,1691.6705787037038,MERGED,0,32,2,0,1,37,False,0,0,0,1090,32,67.17833333333333,Bug
TypeScript,2147,14724,1528.9401851851853,MERGED,46,4599,9,0,4,197,False,0,0,0,2316,4645,50.47138888888889,Document
PHP,883,2338,1882.9163541666667,CLOSED,1,1,1,4,1,0,False,2,2,1,2843,2,1269.5572222222222,Document
TypeScript,261,3765,732.7701967592593,MERGED,0,120,3,0,4,999,True,0,0,0,1810,120,0.4152777777777778,Document
TypeScript,261,3765,732.7637152777778,MERGED,6,9,3,0,2,998,True,0,0,0,2260,15,0.4483333333333333,Document
Go,421,1654,1564.1008796296298,MERGED,13,13,2,0,1,480,True,0,0,0,1948,26,98.71861111111112,Bug
TypeScript,261,3765,732.6943981481481,MERGED,11,12,2,0,2,241,False,0,0,0,1896,23,0.44277777777777777,Document
TypeScript,202,107,1198.4948032407408,MERGED,1,1,1,3,1,270,True,0,3,3,698,2,1.701111111111111,Bug
TypeScript,261,3765,732.5186226851852,MERGED,1,9,2,0,1,994,True,0,0,0,1960,10,0.6619444444444444,Document
TypeScript,58,78,872.1178125,MERGED,1,12,1,1,1,196,False,0,1,1,1476,13,0.3641666666666667,Feature
TypeScript,58,78,872.116388888889,MERGED,1,3,1,1,1,195,False,0,1,1,1173,4,0.4083333333333333,Feature
TypeScript,85,723,371.98145833333336,MERGED,16,19,3,0,2,119,False,0,0,0,2378,35,0.30583333333333335,Document
Rust,3809,5431,496.1022800925926,MERGED,1,1,1,0,1,190,False,0,0,0,200,2,16.421666666666667,Document
TypeScript,2147,14724,1527.9966666666667,MERGED,1,3,1,2,6,1,False,1,1,1,1298,4,52.68222222222222,Bug
TypeScript,85,723,371.01,MERGED,23,40,2,1,2,115,False,1,0,0,2288,63,1.0825,Document
Vue,293,495,886.872048611111,MERGED,5,5,3,2,2,319,True,0,2,2,708,10,0.16305555555555556,Bug
Go,421,1654,1564.2521412037038,MERGED,4,20,2,0,1,70,False,0,0,0,1148,24,43.59444444444444,Bug
TypeScript,58,78,872.1161689814816,MERGED,37,40,1,1,1,194,False,0,1,1,1963,77,170.73194444444445,Feature
TypeScript,261,3765,727.4860648148148,MERGED,2,9,3,0,1,640,True,0,0,0,1341,11,0.4061111111111111,Document
Python,547,7160,2294.6920601851853,MERGED,2,4,1,0,4,238,False,0,0,0,948,6,0.9058333333333334,Bug
Vue,293,495,885.6120138888888,MERGED,40,59,4,20,10,71,False,5,15,5,970,99,52.58111111111111,Bug
Go,421,1654,1563.9754050925924,MERGED,1,10,1,0,1,68,False,0,0,0,1157,11,50.242777777777775,Bug
Python,547,7160,2294.561238425926,CLOSED,1,0,1,0,4,236,False,0,0,0,780,1,2.731388888888889,Document
Python,547,7160,2294.5944907407406,MERGED,20,42,5,0,3,307,True,0,0,0,936,62,0.16916666666666666,Document
TypeScript,261,3765,731.506400462963,MERGED,6,11,3,0,3,116,True,0,0,0,2086,17,4.556666666666667,Document
Go,395,660,1316.1068518518518,MERGED,8,33,1,0,1,125,False,0,0,0,204,41,594.9522222222222,Feature
TypeScript,58,78,871.1659027777778,MERGED,1,1,1,1,1,110,False,0,1,1,1516,2,0.08527777777777777,Feature
TypeScript,58,78,871.0710648148148,MERGED,2,2,2,1,1,190,False,0,1,1,1547,4,0.38,Feature
Python,72,25,1690.6066435185185,MERGED,1,36,2,3,1,36,False,3,0,0,986,37,21.379444444444445,Feature
JavaScript,5139,7050,1260.527638888889,MERGED,5,5,5,3,1,270,False,1,2,2,1618,10,23.12388888888889,Feature
C++,2234,23696,2407.86619212963,MERGED,3,3,2,1,1,353,False,0,1,1,711,6,19.762777777777778,Bug
JavaScript,5139,7050,1255.8994097222223,MERGED,1,34,2,1,3,13,False,0,1,1,1071,35,1.0258333333333334,Document
JavaScript,5139,7050,1255.2219791666666,MERGED,1,1,1,3,1,0,False,0,3,3,772,2,10.57611111111111,Document
TypeScript,202,107,1197.0272222222222,MERGED,31,112,3,3,2,269,True,0,3,3,976,143,0.5758333333333333,Feature
PHP,883,2338,1886.0462847222223,CLOSED,8,25,3,3,2,70,False,1,2,2,1807,33,425.4141666666667,Document
TypeScript,58,78,870.2696643518519,MERGED,3,1,1,1,1,189,False,0,1,1,1380,4,18.30388888888889,Bug
TypeScript,261,3765,726.6367013888889,MERGED,0,11,3,0,1,982,True,0,0,0,1604,11,0.43694444444444447,Document
TypeScript,202,107,1196.750162037037,MERGED,0,8,1,3,1,265,True,0,3,3,829,8,0.7033333333333334,Bug
TypeScript,3393,2334,1024.2150694444445,MERGED,344,149,2,1,4,162,False,0,1,1,226,493,16.628333333333334,Feature
Vue,293,495,885.6196064814816,MERGED,1,3,1,2,1,72,False,0,2,2,937,4,2.147222222222222,Bug
TypeScript,261,3765,730.706875,MERGED,0,8,2,0,2,239,False,0,0,0,1678,8,0.8563888888888889,Document
TypeScript,202,107,1193.8805787037038,MERGED,5,9,2,3,4,264,True,0,3,3,755,14,141.1627777777778,Bug
TypeScript,261,3765,730.5325462962963,MERGED,0,16,2,0,2,275,True,0,0,0,1811,16,3.1694444444444443,Document
JavaScript,5139,7050,1254.7869097222222,MERGED,0,34,2,1,3,12,False,0,1,1,926,34,26.141944444444444,Document
TypeScript,261,3765,725.8840624999999,MERGED,29,35,6,0,3,121,False,0,0,0,1376,64,15.2525,Document
Python,547,7160,2286.7947685185186,CLOSED,15,57,6,0,5,305,True,0,0,0,901,72,332.7725,Bug
TypeScript,2147,14724,1527.0341319444444,MERGED,1,17,1,0,1,38,False,0,0,0,2340,18,3.4758333333333336,Feature
Java,1,10,283.92449074074074,MERGED,2,67,3,1,4,34,True,0,1,1,1471,69,50.13444444444445,Document
TypeScript,261,3765,725.9166435185185,MERGED,0,8,2,0,3,237,False,0,0,0,1215,8,0.22666666666666666,Document
Vue,10807,21163,1078.0190162037036,MERGED,38,40,1,0,1,190,False,0,0,0,1299,78,29.98472222222222,Document
TypeScript,2147,14724,1522.9403935185185,MERGED,3,5,5,0,1,54,False,0,0,0,1529,8,5.452222222222222,Feature
TypeScript,261,3765,725.789398148148,CLOSED,1,7,2,0,2,274,True,0,0,0,1160,8,0.09388888888888888,Document
TypeScript,261,3765,725.7208564814815,MERGED,207,543,37,0,2,120,False,0,0,0,1449,750,0.8116666666666666,Document
TypeScript,2147,14724,1526.7626157407406,CLOSED,7,9,2,0,3,0,False,0,0,0,2176,16,0.017222222222222222,Bug
TypeScript,12,11,1038.565763888889,CLOSED,58,2134,13,0,32,175,False,0,0,0,2402,2192,166.98888888888888,Feature
TypeScript,261,3765,725.5173379629629,MERGED,87,26,4,0,3,235,False,0,0,0,1525,113,2.7116666666666664,Document
TypeScript,261,3765,725.4778703703704,MERGED,53,72,3,0,2,198,False,0,0,0,1460,125,0.9305555555555556,Document
TypeScript,261,3765,725.4742361111112,MERGED,36,0,2,0,1,197,False,0,0,0,1204,36,0.9480555555555555,Document
JavaScript,8844,63474,4130.809988425925,MERGED,3,2655,9,1,1,12,True,0,1,1,3062,2658,251.34916666666666,Bug
TypeScript,2147,14724,1522.177986111111,MERGED,3,5,5,0,1,53,False,0,0,0,1631,8,0.9130555555555555,Feature
TypeScript,202,107,1198.3743055555556,MERGED,1,2,1,3,1,287,True,0,3,3,958,3,33.286944444444444,Document
TypeScript,85,723,365.0728240740741,MERGED,4,8,2,0,1,36,False,0,0,0,1858,12,0.0030555555555555557,Document
Vue,10807,21163,1077.2700810185186,MERGED,1,1,1,0,1,188,False,0,0,0,1369,2,19.455555555555556,Document
TypeScript,85,723,365.00706018518514,MERGED,4,4,2,0,1,35,False,0,0,0,1833,8,1.0252777777777777,Document
TypeScript,202,107,1198.6073148148148,MERGED,4,0,1,2,1,14,True,0,2,2,1041,4,1.1555555555555554,Document
Python,547,7160,2288.791990740741,MERGED,1,4,1,0,1,149,False,0,0,0,1125,5,160.21722222222223,Bug
Vue,293,495,881.6528356481481,CLOSED,24,90,5,9,2,68,False,4,5,4,950,114,103.37555555555555,Bug
Python,547,7160,2288.661087962963,MERGED,586,150,35,1,21,240,False,1,0,0,907,736,145.23833333333334,Bug
TypeScript,202,107,1196.837974537037,MERGED,5,1,1,3,1,267,True,0,3,3,1170,6,70.16638888888889,Bug
TypeScript,41369,87415,2989.6174074074074,CLOSED,3834,4055,389,7,18,1,False,1,6,5,3017,7889,1113.6952777777778,Document
Python,137,75,739.8975925925926,MERGED,0,14,3,0,10,98,False,0,0,0,1115,14,172.11888888888888,Bug
Java,1,10,286.49649305555556,MERGED,1,1,1,0,1,10,False,0,0,0,1691,2,0.16833333333333333,Document
TypeScript,7,6,695.0322222222222,MERGED,4,4,4,1,2,35,True,0,1,1,1079,8,0.4027777777777778,Bug
TypeScript,58,78,871.3635648148148,MERGED,9,20,1,1,1,112,False,0,1,1,1883,29,5.588333333333333,Bug
Python,547,7160,2287.6565162037036,MERGED,2,2,2,0,3,233,False,0,0,0,791,4,0.4575,Bug
TypeScript,2070,16640,1293.0288194444445,MERGED,4,3,2,0,1,0,False,0,0,0,1164,7,2.149722222222222,Document
TypeScript,261,3765,727.7079976851852,MERGED,5,11,3,0,1,123,False,0,0,0,1733,16,0.01972222222222222,Document
Vue,10807,21163,1073.007175925926,CLOSED,1,1,1,2,1,1,False,0,2,2,1138,2,164.5988888888889,Document
JavaScript,5139,7050,1255.6471875,MERGED,20,31,18,5,3,89,False,2,3,2,1122,51,79.09388888888888,Document
V,2097,34362,1604.61625,MERGED,6,46,2,1,2,247,True,0,1,1,1044,52,10.173055555555555,Bug
TypeScript,202,107,1196.8456481481483,MERGED,7,10,2,5,3,268,True,1,4,3,1064,17,1.7402777777777778,Bug
V,2097,34362,1603.8083217592593,MERGED,1,34,2,0,3,244,True,0,0,0,1068,35,36.96333333333333,Bug
TypeScript,58,78,870.0767824074073,MERGED,0,84,3,1,5,108,False,0,1,1,1758,84,24.262777777777778,Feature
TypeScript,7,6,693.9704629629629,CLOSED,20,10,2,0,1,282,False,0,0,0,771,30,4.637777777777778,Feature
Python,19249,70259,2511.2238078703704,CLOSED,0,4,1,2,3,15,False,2,0,0,946,4,28.947222222222223,Feature
TypeScript,261,3765,732.7963773148149,MERGED,42,83,5,0,3,243,False,0,0,0,2936,125,4.225833333333333,Document
Go,395,660,1322.1039467592593,MERGED,9,39,1,0,1,34,False,0,0,0,274,48,211.75472222222223,Feature
TypeScript,261,3765,732.5935069444445,CLOSED,61,16,4,0,1,995,True,0,0,0,2471,77,0.7391666666666666,Document
Vue,10807,21163,1074.8777314814815,MERGED,1,1,1,0,1,101,False,0,0,0,1138,2,0.10472222222222222,Document
TypeScript,261,3765,732.499375,MERGED,17,18,5,0,4,642,True,0,0,0,2669,35,1.7122222222222223,Document
TypeScript,7,6,694.9466435185185,MERGED,204,794,34,0,49,283,False,0,0,0,1661,998,528.9491666666667,Feature
JavaScript,5139,7050,1255.8173148148148,MERGED,5,8,2,1,1,134,False,0,1,1,1329,13,0.22722222222222221,Document
F#,153,337,2972.9052083333336,MERGED,6,6,2,0,2,15,False,0,0,0,2109,12,42.279444444444444,Document
Python,547,7160,2288.714398148148,MERGED,1,9,1,1,2,0,False,1,0,0,941,10,19.149166666666666,Bug
Vue,10807,21163,1074.4463888888888,MERGED,1,1,1,0,2,100,False,0,0,0,1224,2,0.10222222222222223,Bug
Go,421,1654,1559.2610532407407,CLOSED,2,3,2,0,1,116,False,0,0,0,1464,5,0.01361111111111111,Document
TypeScript,2070,16640,1297.9921296296295,MERGED,5,26,1,2,4,0,False,0,2,2,2268,31,631.4363888888889,Bug
TypeScript,2147,14724,1528.2399305555555,CLOSED,14,376,3,0,1,196,False,0,0,0,2949,390,16.79361111111111,Document
Vue,293,495,880.842337962963,MERGED,13,9,4,4,1,409,False,0,4,3,997,22,1.1919444444444445,Bug
Python,547,7160,2288.754537037037,MERGED,4,95,5,0,5,241,False,0,0,0,853,99,3.129722222222222,Document
TypeScript,2070,16640,1298.8595717592593,MERGED,7,93,2,5,6,0,False,3,2,2,2588,100,608.8813888888889,Bug
TypeScript,15,34,545.6057407407408,MERGED,17,6,1,0,2,1043,False,0,0,0,386,23,213.70416666666668,Feature
TypeScript,261,3765,725.5439004629629,MERGED,0,36,3,0,3,115,True,0,0,0,2123,36,3.888611111111111,Document
F#,271,818,2781.4728125,MERGED,1,13,2,0,1,13,True,0,0,0,2079,14,13.43388888888889,Document
TypeScript,12,11,1040.3818287037036,MERGED,51,336,7,1,10,62,False,1,0,0,3046,387,162.6886111111111,Feature
TypeScript,58,78,871.1915277777779,MERGED,69,76,3,1,2,111,False,0,1,1,3086,145,192.8675,Bug
Rust,433,2229,290.4819791666667,MERGED,19,18,1,0,1,1048,False,0,0,0,241,37,0.8263888888888888,Feature
TypeScript,85,723,365.15202546296297,MERGED,10,36,8,0,2,13,False,0,0,0,2737,46,1.7683333333333333,Document
JavaScript,5139,7050,1254.885798611111,MERGED,36,23,1,1,2,132,False,0,1,1,1356,59,0.22527777777777777,Document
TypeScript,85,723,370.29840277777777,MERGED,51,11,6,0,1,187,False,0,0,0,2581,62,16.17361111111111,Document
V,2097,34362,1608.799699074074,MERGED,1,30,2,1,1,253,True,0,1,1,1247,31,23.323888888888888,Bug
Go,395,660,1320.1980555555556,MERGED,11,54,2,0,5,76,False,0,0,0,309,65,234.3852777777778,Feature
Python,547,7160,2294.6084375,MERGED,1,1,1,0,14,38,False,0,0,0,1572,2,0.5983333333333334,Bug
Python,547,7160,2294.526446759259,MERGED,33,1,2,0,3,37,False,0,0,0,1373,34,2.890833333333333,Bug
TypeScript,15,34,545.5789814814815,MERGED,30,5,2,0,2,1042,False,0,0,0,266,35,1.7755555555555556,Feature
JavaScript,9664,43889,3709.814050925926,MERGED,1,1,1,0,1,6,False,0,0,0,259,2,80.58194444444445,Feature
Python,547,7160,2287.3303124999998,MERGED,1,3,3,0,1,5,False,0,0,0,873,4,27.268055555555556,Document
TypeScript,15,34,545.4841666666667,MERGED,1,1,1,0,1,510,True,0,0,0,219,2,0.8452777777777778,Feature
TypeScript,202,107,1193.6050925925927,MERGED,2,2,2,3,1,72,True,0,3,3,1016,4,51.18,Document
Java,1,10,289.09483796296297,MERGED,6,55,4,0,3,36,True,0,0,0,3009,61,0.4280555555555556,Document
Python,547,7160,2294.4967939814815,MERGED,1,35,2,0,6,36,False,0,0,0,2220,36,3.836388888888889,Bug
TypeScript,85,723,370.1929398148148,MERGED,199,280,5,0,1,185,False,0,0,0,3180,479,0.2961111111111111,Document
TypeScript,261,3765,730.788912037037,MERGED,7,53,6,0,1,274,True,0,0,0,3006,60,0.35638888888888887,Document
Erlang,2054,12122,3851.0413194444445,CLOSED,3,3,3,1,1,85,True,0,1,1,354,6,1.6319444444444444,Bug
V,2097,34362,1608.570486111111,MERGED,21,24,5,0,3,252,True,0,0,0,1512,45,6.929722222222222,Bug
Python,547,7160,2287.4161921296295,MERGED,9,26,4,0,5,622,True,0,0,0,1061,35,4.39,Bug
Rust,433,2229,289.4466087962963,MERGED,0,3,1,0,1,1045,False,0,0,0,226,3,1.0494444444444444,Document
F#,153,337,2971.7425925925927,MERGED,0,75,2,1,1,14,False,0,1,1,1749,75,3.07,Document
Go,54,354,788.8303125000001,MERGED,10,37,7,1,7,243,True,1,0,0,1632,47,27.378055555555555,Bug
Java,450,746,4129.072361111111,MERGED,1,13,2,1,1,159,False,0,1,1,1380,14,0.7286111111111111,Bug
Java,1,10,282.85891203703704,MERGED,2,2,1,0,2,32,True,0,0,0,1913,4,0.21888888888888888,Document
Go,395,660,1314.868125,MERGED,3,3,1,0,2,33,False,0,0,0,183,6,294.4269444444444,Bug
Rust,433,2229,288.8161689814815,MERGED,0,1,1,0,1,1043,False,0,0,0,179,1,16.281388888888888,Feature
Go,182,37,1758.2749884259258,MERGED,3,225,7,1,9,469,False,1,0,0,2475,228,134.86305555555555,Document
TypeScript,15,34,544.6143981481481,MERGED,8,7,2,0,1,70,False,0,0,0,210,15,0.01,Bug
Vue,10807,21163,1075.2093287037037,MERGED,1,4,1,1,2,0,False,0,1,1,1831,5,126.79833333333333,Bug
Vue,10807,21163,1072.042789351852,MERGED,0,1,1,0,1,187,False,0,0,0,1231,1,4.626666666666667,Bug
Java,1,10,282.10422453703706,CLOSED,2,2,1,0,1,29,True,0,0,0,1687,4,0.0275,Document
Java,1,10,282.09819444444446,MERGED,2,2,1,0,1,28,True,0,0,0,1566,4,0.07666666666666666,Document
TypeScript,7,6,693.9988888888888,MERGED,12,566,14,1,20,34,True,0,1,1,1604,578,169.87194444444444,Feature
Vue,10807,21163,1078.008761574074,MERGED,39,39,3,0,1,189,False,0,0,0,1730,78,6.613888888888889,Document
PHP,883,2338,1885.9661805555554,CLOSED,1,13,2,1,1,87,False,0,1,1,1683,14,19.610555555555557,Document
V,2097,34362,1606.9286458333333,MERGED,3,20,3,0,2,249,True,0,0,0,1180,23,12.237222222222222,Bug
Go,395,660,1318.772962962963,MERGED,37,22,1,0,2,135,False,0,0,0,249,59,29.1775,Feature
TypeScript,41369,87415,2994.0620370370366,MERGED,2,2,1,1,1,16,False,0,1,1,1330,4,0.40944444444444444,Document
TypeScript,202,107,1198.6695486111112,MERGED,7,14,3,4,2,271,True,0,4,3,1833,21,26.184722222222224,Bug
TypeScript,7,6,701.1870717592592,MERGED,425,1165,47,0,16,299,False,0,0,0,733,1590,119.52694444444444,Feature
TypeScript,202,107,1198.4600578703705,MERGED,2,16,1,4,2,4,False,1,3,3,1725,18,31.220277777777778,Document
Vue,293,495,882.9659143518519,MERGED,13,23,1,5,2,411,False,1,4,3,1242,36,69.45861111111111,Bug
TypeScript,15,34,546.5059375,MERGED,3,8,2,0,1,512,True,0,0,0,298,11,0.31833333333333336,Feature
TypeScript,2147,14724,1522.8465277777777,MERGED,2,20,4,0,1,753,False,0,0,0,3154,22,23.161666666666665,Document
PHP,1334,2960,4262.175208333333,MERGED,11,10,2,2,2,1,False,0,2,2,2396,21,69.39722222222223,Document
TypeScript,41369,87415,2993.630289351852,MERGED,2,2,1,1,1,14,False,0,1,1,1241,4,0.48194444444444445,Document
TypeScript,12,11,1040.2402662037036,MERGED,1659,2533,7,0,3,176,False,0,0,0,3092,4192,4.795277777777778,Feature
TypeScript,12,11,1040.246851851852,MERGED,30,1070,4,0,4,178,False,0,0,0,2868,1100,4.165,Feature
TypeScript,12,11,1040.243414351852,MERGED,3,1900,4,0,3,177,False,0,0,0,2702,1903,4.338055555555556,Feature
TypeScript,15,34,541.1026041666667,CLOSED,131,402,12,0,6,183,False,0,0,0,225,533,100.29777777777778,Bug
Go,395,660,1315.1193402777778,MERGED,4,11,2,1,2,123,False,0,1,1,417,15,479.6425,Bug
TypeScript,7,6,698.8974652777778,MERGED,6,54,5,4,16,298,False,3,1,1,462,60,0.21805555555555556,Feature
TypeScript,2147,14724,1521.990590277778,MERGED,37,45,4,0,1,750,False,0,0,0,2409,82,23.29722222222222,Bug
Go,395,660,1315.9962962962964,MERGED,2,2,1,0,2,94,False,0,0,0,196,4,118.17611111111111,Feature
Rust,433,2229,286.7810648148148,MERGED,20,18,3,0,1,1032,False,0,0,0,245,38,4.209444444444444,Feature
Python,547,7160,2288.6815046296297,CLOSED,9,62,9,1,9,623,True,0,1,1,1319,71,144.79888888888888,Bug
TypeScript,202,107,1196.7944328703704,MERGED,13,11,2,3,3,266,True,0,3,3,1429,24,71.22,Bug
TypeScript,85,723,372.0898958333333,MERGED,127,96,6,0,5,113,False,0,0,0,5305,223,211.34083333333334,Document
TypeScript,307,2556,592.82875,MERGED,2,5,1,0,1,200,True,0,0,0,976,7,23.58861111111111,Feature
V,2097,34362,1604.185127314815,CLOSED,46,41,8,1,4,46,True,1,0,0,4945,87,27.66722222222222,Bug
V,2097,34362,1604.1822800925927,MERGED,32,32,18,0,4,45,True,0,0,0,4858,64,23.316111111111113,Document
TypeScript,307,2556,594.754375,MERGED,2,5,1,0,1,582,True,0,0,0,1655,7,189.4802777777778,Bug
Go,395,660,1316.1101851851852,MERGED,1,1,1,0,1,75,False,0,0,0,203,2,93.16027777777778,Bug
Go,395,660,1316.0311111111112,MERGED,5,36,1,0,2,74,False,0,0,0,175,41,0.9613888888888888,Feature
V,2097,34362,1605.4996759259259,MERGED,1,1,1,0,1,20,False,0,0,0,1341,2,5.955,Document
JavaScript,5139,7050,1255.7852083333335,MERGED,20,599,10,3,5,100,False,1,2,2,3338,619,263.3377777777778,Document
C#,655,7879,1878.1994560185185,MERGED,16,37,1,0,3,3,False,0,0,0,851,53,312.64444444444445,Document
Vue,10807,21163,1076.3944560185184,MERGED,2,8,3,3,1,201,True,2,1,1,1607,10,0.21138888888888888,Bug
TypeScript,12,11,1045.5231712962964,MERGED,12,394,5,0,8,181,False,0,0,0,3749,406,142.6525,Feature
TypeScript,15,34,545.2489351851851,MERGED,69,218,9,0,3,185,False,0,0,0,405,287,0.5561111111111111,Feature
JavaScript,34,25,254.1529050925926,MERGED,0,43,7,0,1,86,False,0,0,0,484,43,0.2127777777777778,Feature
TypeScript,15,34,544.3939699074074,MERGED,3,98,2,0,2,509,True,0,0,0,399,101,44.22388888888889,Feature
TypeScript,15,34,544.7406481481481,MERGED,27,65,2,0,6,1039,False,0,0,0,477,92,16.600555555555555,Feature
Go,11875,71342,2747.685,MERGED,16,155,8,0,1,297,True,0,0,0,451,171,1.7372222222222222,Document
Go,395,660,1315.0700810185185,MERGED,0,13,1,0,1,351,False,0,0,0,189,13,26.6,Feature
Java,450,746,4127.300763888889,MERGED,2,33,2,1,1,16,False,0,1,1,510,35,65.29222222222222,Feature
Go,54,354,784.6867245370371,MERGED,3,6,2,0,1,26,False,0,0,0,282,9,0.3625,Feature
JavaScript,5139,7050,1258.8321643518518,MERGED,91,161,37,5,8,325,False,1,4,2,3764,252,68.66055555555556,Document
TypeScript,261,3765,726.7712152777777,MERGED,9,83,6,1,3,10,True,0,1,1,2350,92,0.5455555555555556,Document
JavaScript,5139,7050,1253.815613425926,MERGED,3,23,2,2,1,324,False,0,2,2,1774,26,18.360833333333332,Document
JavaScript,9664,43889,3712.966828703704,MERGED,1,3,1,0,1,276,True,0,0,0,441,4,0.15944444444444444,Bug
JavaScript,9664,43889,3712.9367361111113,MERGED,1142,1288,14,0,7,66,True,0,0,0,392,2430,1.6108333333333333,Bug
TypeScript,1297,21107,472.93943287037035,MERGED,380,654,23,1,23,1126,True,0,1,1,1796,1034,27.559166666666666,Document
TypeScript,15,34,544.4474652777777,MERGED,7,50,2,0,1,361,False,0,0,0,319,57,3.0972222222222223,Feature
TypeScript,202,107,1196.8215277777779,MERGED,4,8,1,4,6,286,True,0,4,3,1292,12,3.8722222222222222,Document
TypeScript,202,107,1193.604710648148,MERGED,1399,891,7,3,9,263,True,1,2,2,1453,2290,167.77694444444444,Bug
TypeScript,2147,14724,1522.9925347222222,MERGED,297,1965,28,0,10,59,False,0,0,0,3119,2262,4.445833333333334,Document
TypeScript,202,107,1196.8142592592592,MERGED,1,4,1,3,1,285,True,0,3,3,1556,5,0.8952777777777777,Document
Java,450,746,4121.307569444444,MERGED,1,6,1,1,5,14,False,0,1,1,245,7,47.77361111111111,Feature
C#,80,125,875.671539351852,MERGED,2,24,4,0,1,192,False,0,0,0,464,26,4.869722222222222,Document
TypeScript,261,3765,725.7337152777777,MERGED,14,91,2,0,5,222,True,0,0,0,2469,105,18.196666666666665,Document
F#,271,818,2781.2658449074074,MERGED,64,51,1,0,2,72,False,0,0,0,3051,115,18.36611111111111,Bug
TypeScript,202,107,1195.5082175925925,MERGED,14,22,11,3,1,14,True,0,3,3,1531,36,30.918333333333333,Document
TypeScript,261,3765,725.7624189814815,MERGED,2,41,7,0,2,979,True,0,0,0,2677,43,0.46444444444444444,Document
V,2097,34362,1603.2036342592592,MERGED,1,0,1,0,1,14,False,0,0,0,1461,1,25.275,Document
TypeScript,41369,87415,2992.6371296296297,CLOSED,1,0,1,5,5,0,False,1,4,3,958,1,559.4105555555556,Bug
TypeScript,7,6,696.2024305555556,MERGED,5,8,3,3,14,297,False,2,1,1,483,13,0.24861111111111112,Feature
Vue,10807,21163,1074.2143287037036,MERGED,2,19,5,0,2,99,False,0,0,0,1781,21,0.48194444444444445,Document
TypeScript,15,34,541.8898379629629,MERGED,43,15,3,0,9,69,False,0,0,0,394,58,64.23138888888889,Bug
Rust,433,2229,287.3459375,MERGED,73,76,5,0,1,1035,False,0,0,0,318,149,2.027222222222222,Feature
Vue,10807,21163,1072.273136574074,MERGED,1,2,1,0,1,197,True,0,0,0,1600,3,91.99722222222222,Bug
V,2097,34362,1601.4109606481481,MERGED,31,44,5,2,7,0,False,1,1,1,1436,75,14.908888888888889,Document
Go,395,660,1317.4437731481482,CLOSED,0,21,1,0,1,0,False,0,0,0,278,21,61.71083333333333,Document
C#,80,125,871.6346064814815,MERGED,1,3,1,0,1,224,False,0,0,0,413,4,3.5025,Document
TypeScript,15,34,539.4892013888889,MERGED,1,1,1,0,1,144,False,0,0,0,237,2,5.342777777777778,Feature
TypeScript,15,34,539.5690740740741,CLOSED,7,9,2,0,1,68,False,0,0,0,225,16,0.15138888888888888,Feature
TypeScript,15,34,539.5100925925926,MERGED,7,8,1,0,1,145,False,0,0,0,240,15,0.1786111111111111,Bug
Vue,293,495,879.9682175925926,MERGED,3,36,3,13,4,408,False,4,9,4,1181,39,22.296388888888888,Bug
TypeScript,15,34,545.2810300925926,MERGED,70,191,5,0,2,186,False,0,0,0,485,261,0.9733333333333334,Bug
Go,395,660,1315.9210416666667,MERGED,353,402,6,0,13,352,False,0,0,0,384,755,120.16805555555555,Bug
TypeScript,15,34,546.4644444444444,MERGED,23,389,11,0,10,511,True,0,0,0,479,412,139.49416666666667,Feature
TypeScript,202,107,1193.5534722222221,MERGED,10,95,2,11,12,282,True,4,7,4,2439,105,337.5258333333333,Document
TypeScript,15,34,544.7238194444444,MERGED,15,18,2,0,3,1038,False,0,0,0,541,33,17.020833333333332,Bug
TypeScript,15,34,539.5351157407407,MERGED,278,1291,35,0,23,508,True,0,0,0,333,1569,134.3575,Bug
TypeScript,15,34,538.9442592592592,CLOSED,1,1,1,0,2,66,False,0,0,0,241,2,0.2633333333333333,Document
TypeScript,41369,87416,2986.6820023148152,CLOSED,3,10,4,2,2,204,False,1,1,1,2863,13,46.14555555555555,Document
C++,2234,23696,2408.886296296296,MERGED,92,157,1,1,1,300,False,0,1,1,2348,249,91.14722222222223,Feature
TypeScript,307,2556,589.5064930555556,MERGED,1,0,1,0,1,198,True,0,0,0,884,1,1.8447222222222222,Bug
TypeScript,41369,87416,2993.873148148148,MERGED,2,2,2,1,4,6,False,0,1,1,1919,4,13.1575,Document
Python,547,7160,2289.4711689814817,MERGED,15,144,8,0,32,32,False,0,0,0,1758,159,166.31194444444444,Bug
TypeScript,41369,87416,2993.9384837962966,MERGED,1,1,1,3,2,494,True,1,2,2,2093,2,11.6075,Document
Java,1,10,282.1059953703704,MERGED,0,124,3,0,5,30,True,0,0,0,3020,124,0.16722222222222222,Document
Python,137,75,740.2846064814815,MERGED,13,20,4,0,8,99,False,0,0,0,1533,33,0.7855555555555556,Bug
JavaScript,9664,43889,3713.9299652777777,MERGED,0,16,3,0,1,323,True,0,0,0,503,16,0.21833333333333332,Feature
TypeScript,15,34,541.3876388888889,MERGED,9,18,1,0,1,147,False,0,0,0,310,27,2.7086111111111113,Feature
Python,137,75,739.8333912037037,MERGED,1,10,2,0,2,97,False,0,0,0,1538,11,2.5905555555555555,Document
TypeScript,307,2556,588.6288541666667,MERGED,1,3,1,0,1,581,True,0,0,0,1088,4,24.748333333333335,Bug
JavaScript,5139,7050,1254.7110300925926,MERGED,20,17,4,1,5,0,False,0,1,1,1792,37,96.08166666666666,Bug
Go,421,1654,1560.163877314815,MERGED,124,535,4,0,1,118,False,0,0,0,3090,659,1.0919444444444444,Document
Go,421,1654,1560.1631828703703,MERGED,124,535,4,0,1,117,False,0,0,0,3007,659,1.1094444444444445,Document
V,2097,34362,1606.343553240741,MERGED,0,23,3,0,1,7,False,0,0,0,1706,23,16.543055555555554,Document
Python,137,75,739.1303587962963,MERGED,6,17,2,0,4,96,False,0,0,0,1283,23,6.010833333333333,Bug
Python,137,75,739.1069212962963,MERGED,4,12,2,0,2,95,False,0,0,0,1545,16,6.304722222222222,Document
TypeScript,7,6,696.0833796296297,MERGED,0,79,7,3,10,296,False,2,1,1,2114,79,1.413888888888889,Feature
JavaScript,9664,43889,3706.464351851852,MERGED,1,1,1,0,1,0,False,0,0,0,232,2,16.094722222222224,Bug
TypeScript,261,3765,732.6802777777779,MERGED,16,71,13,0,3,997,True,0,0,0,3632,87,0.8622222222222222,Document
TypeScript,15,34,540.4318402777777,MERGED,30,33,1,0,1,358,False,0,0,0,352,63,21.07638888888889,Bug
TypeScript,261,3765,726.5088541666668,MERGED,9,46,6,0,4,28,True,0,0,0,3107,55,312.85555555555555,Document
JavaScript,9664,43889,3713.087210648148,MERGED,9,20,4,0,2,278,True,0,0,0,513,29,0.8886111111111111,Feature
JavaScript,9664,43889,3713.0359027777777,MERGED,1,3,1,0,1,277,True,0,0,0,549,4,0.33611111111111114,Feature
Python,137,75,738.1296643518518,MERGED,9,16,3,0,2,93,False,0,0,0,1412,25,0.9505555555555556,Bug
Python,137,75,738.0566203703703,MERGED,5,14,3,0,3,92,False,0,0,0,1194,19,0.7461111111111111,Bug
V,2097,34362,1605.6588194444446,MERGED,1,26,4,0,3,223,True,0,0,0,1929,27,21.143333333333334,Document
JavaScript,9664,43889,3712.9557175925925,CLOSED,1,1,1,0,1,275,True,0,0,0,598,2,0.155,Bug
Go,395,660,1316.0196296296297,MERGED,10,10,4,0,1,353,False,0,0,0,375,20,0.07083333333333333,Feature
Java,450,746,4122.111435185186,MERGED,10,37,4,1,4,15,False,0,1,1,483,47,118.16194444444444,Feature
JavaScript,9664,43889,3712.0729976851853,MERGED,627,814,7,0,1,273,True,0,0,0,490,1441,21.15388888888889,Feature
TypeScript,41369,87416,2992.512800925926,CLOSED,2,2,1,1,1,489,True,0,1,1,2128,4,0.058611111111111114,Document
TypeScript,261,3765,731.737337962963,MERGED,14,14,10,0,1,993,True,0,0,0,3612,28,0.8447222222222223,Document
Python,19250,70259,2510.5913541666664,CLOSED,20,32,11,1,3,1634,False,1,0,0,683,52,5.231111111111111,Feature
TypeScript,202,107,1198.9149305555554,MERGED,1,0,1,3,2,131,False,0,3,3,1009,1,20.28527777777778,Document
TypeScript,7,6,694.9454398148149,MERGED,11,116,3,1,3,295,False,0,1,1,2008,127,0.7469444444444444,Bug
TypeScript,15,34,539.5275810185185,MERGED,9,48,4,0,2,356,False,0,0,0,260,57,4.231388888888889,Bug
C++,2234,23696,2408.021574074074,MERGED,1,54,3,1,1,354,False,0,1,1,1771,55,20.531388888888888,Feature
JavaScript,9664,43889,3712.0165046296297,MERGED,0,11,1,0,1,272,True,0,0,0,506,11,0.21611111111111111,Bug
TypeScript,15,34,539.4304861111111,MERGED,4,7,2,0,5,143,False,0,0,0,307,11,1.3605555555555555,Bug
JavaScript,9664,43889,3710.2743287037033,CLOSED,0,191,3,2,1,0,False,0,2,1,820,191,402.5758333333333,Feature
TypeScript,202,107,1194.0020717592593,MERGED,648,579,12,3,17,284,True,0,3,3,2171,1227,160.34083333333334,Document
TypeScript,41369,87416,2986.244201388889,MERGED,1,1,1,0,1,0,False,0,0,0,1383,2,6.136666666666667,Document
TypeScript,261,3765,730.7995601851852,MERGED,0,758,22,0,1,275,True,0,0,0,3833,758,3.491111111111111,Document
V,2097,34362,1604.145914351852,MERGED,0,71,3,0,2,222,True,0,0,0,1761,71,28.621111111111112,Document
TypeScript,15,34,538.9475810185185,MERGED,9,7,2,0,1,67,False,0,0,0,263,16,0.1802777777777778,Bug
TypeScript,15,34,538.9352199074074,CLOSED,1,1,1,0,2,65,False,0,0,0,285,2,0.13555555555555557,Feature
TypeScript,15,34,541.4794560185186,MERGED,90,2321,8,0,8,360,False,0,0,0,416,2411,4.371666666666667,Bug
TypeScript,15,34,541.4740625000001,MERGED,9,15,1,0,1,359,False,0,0,0,493,24,0.2511111111111111,Feature
TypeScript,15,34,545.024537037037,MERGED,26,43,1,0,1,1041,False,0,0,0,705,69,9.783888888888889,Bug
TypeScript,41369,87416,2990.713888888889,MERGED,4,4,1,2,2,482,True,1,1,1,2159,8,17.171666666666667,Document
C#,80,125,869.4950578703703,CLOSED,424,492,34,0,10,97,False,0,0,0,1838,916,1203.046111111111,Document
TypeScript,2147,14724,1524.072222222222,MERGED,23,25,396,0,2,682,False,0,0,0,5239,48,69.08694444444444,Document
V,2097,34362,1603.4662731481483,MERGED,1,13,2,2,2,4,False,1,1,1,1572,14,18.939166666666665,Document
TypeScript,2147,14724,1523.789375,MERGED,1,138,6,0,1,680,False,0,0,0,3500,139,75.68333333333334,Document
Python,72,25,1692.6808912037038,MERGED,21,160,4,0,2,38,False,0,0,0,3043,181,18.445555555555554,Bug
Go,395,660,1315.9323032407408,MERGED,10,15,2,0,1,124,False,0,0,0,420,25,20.730555555555554,Feature
TypeScript,2147,14724,1522.7533680555555,MERGED,24,128,10,0,1,751,False,0,0,0,3661,152,4.969444444444444,Feature
TypeScript,2070,16640,1297.548912037037,CLOSED,0,92,5,1,5,4,False,0,1,1,3443,92,639.5213888888889,Document
TypeScript,261,3765,728.7218287037036,MERGED,1448,643,69,0,7,988,True,0,0,0,4612,2091,42.39611111111111,Document
JavaScript,9664,43889,3708.07337962963,MERGED,2,2,1,0,1,2,False,0,0,0,620,4,122.46388888888889,Feature
TypeScript,2070,16640,1297.1931828703703,MERGED,4,24,2,0,1,0,False,0,0,0,3973,28,650.4075,Bug
Python,19250,70259,2510.3421875,CLOSED,32385,35877,3,1,2,1632,False,1,0,0,583,68262,1.4422222222222223,Feature
TypeScript,58,78,871.0437731481483,MERGED,15,15,3,1,10,109,False,0,1,1,3803,30,1.0444444444444445,Bug
TypeScript,15,34,539.3599074074074,MERGED,1,57,1,0,5,142,False,0,0,0,429,58,5.713888888888889,Bug
TypeScript,15,34,539.1456018518519,MERGED,17,19,3,0,1,1035,False,0,0,0,667,36,7.404444444444445,Feature
Java,1,10,286.08759259259256,MERGED,29,43,5,0,3,9,False,0,0,0,4367,72,0.015,Document
Python,137,75,741.9766550925925,MERGED,0,149,3,0,23,5,False,0,0,0,1490,149,849.0963888888889,Document
TypeScript,12,11,1038.3237847222222,MERGED,67,737,10,0,6,61,False,0,0,0,4445,804,51.70611111111111,Feature
TypeScript,41369,87416,2988.7776157407407,MERGED,1,1,1,1,1,3,False,0,1,1,1560,2,0.9875,Document
TypeScript,307,2556,588.8309143518519,MERGED,1,6,2,0,3,21,True,0,0,0,1308,7,18.12361111111111,Bug
TypeScript,41369,87416,2988.4677314814817,CLOSED,1,2,1,1,1,4,False,0,1,1,1760,3,14.656944444444445,Document
TypeScript,2147,14724,1523.002349537037,MERGED,0,607,16,0,1,678,False,0,0,0,3943,607,19.9425,Document
Erlang,2054,12122,3851.0493171296293,MERGED,1,1,1,0,1,26,True,0,0,0,929,2,14.454444444444444,Document
Go,421,1654,1563.1792708333332,MERGED,138,144,7,0,1,478,True,0,0,0,4843,282,41.19611111111111,Bug
V,2097,34362,1608.4863310185185,MERGED,0,120,2,0,9,0,False,0,0,0,2295,120,37.245555555555555,Document
TypeScript,41369,87416,2988.461840277778,MERGED,0,4,1,0,1,0,False,0,0,0,1997,4,3.181388888888889,Document
TypeScript,261,3765,727.701863425926,MERGED,228,482,28,0,6,987,True,0,0,0,4545,710,1.5252777777777777,Document
JavaScript,5139,7050,1259.5098611111111,MERGED,12,14,7,4,2,269,False,1,3,2,4582,26,47.54472222222222,Bug
TypeScript,307,2556,588.7011111111111,MERGED,3,5,4,0,1,23,False,0,0,0,2069,8,0.7091666666666666,Feature
TypeScript,261,3765,727.5257407407407,MERGED,29,17,27,0,1,122,False,0,0,0,4625,46,2.7933333333333334,Document
TypeScript,3393,2334,1024.210185185185,MERGED,1,0,1,1,1,161,False,0,1,1,961,1,0.05472222222222222,Bug
Python,137,75,739.4559837962962,MERGED,1,5,2,0,1,219,False,0,0,0,976,6,0.2791666666666667,Bug
TypeScript,15,34,539.5276736111111,MERGED,69,218,9,0,4,182,False,0,0,0,591,287,135.73527777777778,Feature
TypeScript,3393,2334,1022.4461226851853,MERGED,2,3,1,2,1,0,False,0,2,1,900,5,7.301388888888889,Bug
Go,395,660,1315.1400694444444,MERGED,185,242,15,1,10,134,False,1,0,0,979,427,23.9025,Feature
C#,80,125,876.6476273148147,CLOSED,1,2,1,0,6,186,False,0,0,0,1065,3,24.575555555555557,Document
Java,450,746,4122.006076388889,MERGED,119,163,7,1,9,14,False,0,1,1,598,282,50.94555555555556,Bug
TypeScript,261,3765,726.8759259259259,MERGED,33,243,2,0,3,984,True,0,0,0,3941,276,0.1338888888888889,Document
TypeScript,261,3765,726.6113888888889,MERGED,62,99,2,0,1,981,True,0,0,0,4049,161,0.9591666666666666,Document
TypeScript,307,2556,587.6548726851852,MERGED,168,204,1,0,1,312,True,0,0,0,1402,372,4.195833333333334,Feature
Erlang,2054,12122,3850.121828703704,MERGED,12,12,2,0,2,84,False,0,0,0,836,24,4.220833333333333,Document
TypeScript,307,2556,587.5189236111111,MERGED,1,12,2,0,1,21,False,0,0,0,1632,13,1.781111111111111,Feature
JavaScript,5139,7050,1254.9764583333333,MERGED,16,17,2,4,3,0,False,1,3,2,2441,33,15.023333333333333,Feature
Go,11875,71342,2746.773043981482,MERGED,18,39,5,0,1,296,True,0,0,0,3244,57,0.10277777777777777,Bug
C#,80,125,871.8424421296296,CLOSED,1,3,1,0,1,225,False,0,0,0,841,4,228.97722222222222,Document
TypeScript,202,107,1199.7503587962963,MERGED,187,212,3,2,2,15,True,0,2,2,3223,399,2.0105555555555554,Document
JavaScript,9664,43889,3713.0278125,MERGED,32,337,12,0,3,19,False,0,0,0,753,369,1.4841666666666666,Feature
TypeScript,15,34,540.3825115740741,MERGED,70,442,6,0,2,357,False,0,0,0,728,512,29.272777777777776,Feature
JavaScript,9664,43889,3712.8381481481483,CLOSED,200,384,6,0,2,274,True,0,0,0,703,584,0.06916666666666667,Bug
TypeScript,1297,21107,470.859849537037,CLOSED,11,11,8,3,1,3,False,1,2,2,2883,22,0.07333333333333333,Document
TypeScript,261,3765,725.7734953703704,MERGED,7,290,6,0,4,980,True,0,0,0,3764,297,5.2225,Document
C#,80,125,875.8224884259258,MERGED,2,2,1,0,1,99,False,0,0,0,934,4,1.3044444444444445,Document
TypeScript,261,3765,725.7592939814814,MERGED,62,188,4,0,2,236,False,0,0,0,4734,250,1.0705555555555555,Document
TypeScript,41369,87416,2986.5870601851852,MERGED,2,1,1,0,1,474,True,0,0,0,2084,3,0.2011111111111111,Document
V,2097,34362,1606.6658796296297,MERGED,8,29,4,0,2,9,False,0,0,0,2268,37,8.825555555555555,Document
TypeScript,41369,87416,2988.648958333333,MERGED,0,4,1,1,1,2,False,1,0,0,2455,4,271.86277777777775,Document
C#,655,7879,1885.1534375,MERGED,10,95,6,5,4,599,True,1,4,3,2301,105,47.31611111111111,Document
V,2097,34362,1606.5299652777778,MERGED,6,28,1,5,2,8,False,2,3,1,2622,34,4.648333333333333,Document
TypeScript,41369,87416,2993.5682175925926,MERGED,31,1,2,11,2,61,False,5,6,3,2338,32,3.528888888888889,Document
JavaScript,9664,43889,3712.076655092593,MERGED,31,180,9,0,5,18,False,0,0,0,702,211,1.9011111111111112,Document
TypeScript,15,34,539.73875,MERGED,124,124,14,0,9,146,False,0,0,0,641,248,20.058333333333334,Feature
Go,1835,11245,1779.8394328703705,MERGED,15,189,12,0,11,102,False,0,0,0,529,204,1.5877777777777777,Feature
Go,421,1654,1561.0790972222221,MERGED,39,35,7,0,1,475,True,0,0,0,4325,74,2.0766666666666667,Bug
TypeScript,7,6,695.9115162037037,MERGED,43,77,5,0,3,228,False,0,0,0,2557,120,1.4297222222222221,Feature
Go,1835,11245,1779.7278356481481,MERGED,48,191,11,1,4,124,False,0,1,1,650,239,3.1416666666666666,Document
Go,1835,11245,1779.7704398148146,CLOSED,0,0,7,0,2,5,False,0,0,0,639,0,0.10388888888888889,Document
Erlang,2054,12122,3847.2376041666666,MERGED,27,5,1,0,1,401,False,0,0,0,946,32,69.24416666666667,Document
Go,1835,11245,1779.9854513888888,MERGED,4,4,1,0,1,104,False,0,0,0,817,8,0.15583333333333332,Document
TypeScript,2070,16640,1294.075173611111,MERGED,1,1,1,0,2,1,False,0,0,0,2147,2,0.8663888888888889,Bug
TypeScript,15,34,539.6969212962963,MERGED,46,81,5,0,3,1036,False,0,0,0,555,127,0.8966666666666666,Bug
TypeScript,41369,87416,2992.7964120370366,MERGED,1,1,1,0,1,1945,True,0,0,0,2133,2,18.40277777777778,Document
PHP,1334,2960,4262.288252314815,CLOSED,35,212,4,3,8,165,False,1,2,2,4771,247,547.7205555555555,Bug
TypeScript,41369,87416,2992.5245717592593,MERGED,2,2,1,5,3,490,True,2,3,2,2190,4,27.48777777777778,Document
TypeScript,41369,87416,2993.006261574074,MERGED,8,4,2,1,1,491,True,0,1,1,2480,12,0.3963888888888889,Document
Erlang,2054,12122,3846.983449074074,MERGED,1,1,1,0,1,25,True,0,0,0,971,2,64.18166666666667,Document
Python,137,75,735.0610995370371,CLOSED,0,307,13,0,3,4,False,0,0,0,2742,307,1512.173611111111,Document
TypeScript,2070,16640,1293.6983912037037,MERGED,1,1,1,1,1,0,False,1,0,0,2464,2,8.303611111111111,Bug
TypeScript,15,34,539.4832291666667,MERGED,40,69,5,0,3,355,False,0,0,0,621,109,0.32944444444444443,Feature
TypeScript,7,6,694.9099884259259,MERGED,105,155,19,1,7,227,False,0,1,1,3451,260,28.528055555555557,Bug
TypeScript,15,34,539.0947800925926,MERGED,5,44,5,0,1,1033,False,0,0,0,539,49,8.626388888888888,Document
JavaScript,5139,7050,1254.8753587962963,MERGED,29,60,26,2,4,268,False,0,2,2,4627,89,112.06972222222223,Bug
TypeScript,15,34,539.1227662037037,MERGED,3,11,1,0,2,1034,False,0,0,0,546,14,0.5991666666666666,Feature
Go,1835,11245,1778.8928935185186,MERGED,0,0,11,0,2,3,False,0,0,0,639,0,3.602777777777778,Document
TypeScript,15,34,545.2298148148149,MERGED,66,349,20,0,8,184,False,0,0,0,1070,415,0.425,Feature
Go,421,1654,1560.1875347222222,MERGED,65,306,4,0,1,119,False,0,0,0,3216,371,0.5236111111111111,Document
TypeScript,69,2219,369.8331134259259,MERGED,960,283,27,8,14,41,False,5,3,1,1473,1243,162.55944444444444,Document
Erlang,2054,12122,3846.9133217592594,MERGED,1,1,1,0,1,141,False,0,0,0,853,2,5.961388888888889,Document
C#,80,125,871.89125,MERGED,3,18,1,0,1,13,False,0,0,0,703,21,89.57555555555555,Document
V,2097,34362,1603.795474537037,MERGED,3,33,5,3,5,42,True,2,1,1,2732,36,54.98888888888889,Document
TypeScript,41369,87416,2991.817986111111,MERGED,0,62,2,1,3,126,True,0,1,1,2449,62,2.1180555555555554,Document
C#,655,7879,1884.858148148148,MERGED,6,38,1,5,1,8,False,2,3,2,1891,44,4.893888888888889,Document
C#,655,7879,1884.314398148148,MERGED,2,2537,49,1,5,598,True,0,1,1,1543,2539,31.85388888888889,Document
Python,2408,12186,291.14756944444446,CLOSED,262,1106,1,0,1,0,False,0,0,0,728,1368,0.017777777777777778,Document
C++,2234,23696,2406.397638888889,MERGED,28,34,5,1,10,8,False,0,1,1,2974,62,52.952777777777776,Document
TypeScript,12,11,1045.5086689814814,MERGED,134,2951,16,0,9,179,False,0,0,0,5453,3085,143.26638888888888,Bug
TypeScript,12,11,1045.2842824074075,MERGED,439,2910,71,0,6,385,False,0,0,0,6244,3349,149.77027777777778,Bug
TypeScript,41369,87416,2989.998923611111,MERGED,16,25,1,3,1,59,False,1,2,2,3016,41,41.60611111111111,Document
TypeScript,149,2900,435.1409953703704,MERGED,4095,9442,398,8,476,195,True,2,6,3,1383,13537,326.3308333333333,Feature
Erlang,2054,12122,3847.968148148148,CLOSED,275,873,16,0,7,83,False,0,0,0,1009,1148,414.83416666666665,Document
JavaScript,9664,43889,3706.9682870370366,MERGED,76,455,13,0,2,322,True,0,0,0,921,531,120.39861111111111,Feature
TypeScript,202,107,1200.658460648148,CLOSED,889,1021,17,6,3,0,False,2,4,4,4589,1910,312.19972222222225,Document
V,2097,34362,1602.610335648148,MERGED,4,32,2,0,2,60,True,0,0,0,2118,36,1.5911111111111111,Document
C++,363,552,587.1654282407408,MERGED,12,19,6,0,1,260,False,0,0,0,1868,31,551.2561111111111,Document
TypeScript,41369,87416,2987.952962962963,MERGED,11,63,3,1,6,58,False,0,1,1,2511,74,644.4466666666667,Document
TypeScript,4,33,812.3317824074074,MERGED,32,273,18,1,25,393,False,0,1,1,924,305,47.82416666666666,Bug
Python,547,7160,2286.819884259259,MERGED,7,12,3,0,12,34,False,0,0,0,2686,19,64.12,Bug
TypeScript,41369,87416,2988.989722222222,MERGED,17,4,3,0,1,1944,True,0,0,0,2260,21,2.1219444444444444,Document
Python,1912,12141,121.84039351851851,MERGED,8,27,1,4,1,0,False,2,2,1,1142,35,6.976111111111111,Feature
Starlark,440,286,546.0326851851852,MERGED,7,5,1,1,2,7,False,0,1,1,1583,12,138.3138888888889,Feature
Erlang,2054,12122,3851.988287037037,CLOSED,1,3,2,1,1,142,False,0,1,1,968,4,53.1375,Document
TypeScript,3393,2334,1017.2808796296296,MERGED,1,1,1,1,1,357,False,0,1,1,1008,2,0.12583333333333332,Bug
TypeScript,41369,87416,2988.4787731481483,MERGED,3,12,1,0,1,32,False,0,0,0,2861,15,6.71,Document
Erlang,2054,12122,3851.0695949074075,MERGED,29,264,13,0,6,85,False,0,0,0,1237,293,151.28527777777776,Document
TypeScript,85,723,372.26304398148153,MERGED,720,858,30,0,16,39,False,0,0,0,5467,1578,23.13388888888889,Document
TypeScript,41369,87416,2988.476956018518,MERGED,1,1,1,1,1,1617,True,0,1,1,2125,2,0.46555555555555556,Document
Erlang,2054,12122,3851.2575694444445,MERGED,35,36,3,0,1,86,False,0,0,0,900,71,137.61083333333335,Document
TypeScript,2147,14724,1529.189849537037,MERGED,182,3391,37,0,4,683,False,0,0,0,5652,3573,16.599166666666665,Document
JavaScript,9664,43889,3706.971921296296,MERGED,4,379,6,0,1,278,True,0,0,0,756,383,0.6636111111111112,Bug
TypeScript,41369,87416,2987.8224421296295,CLOSED,2,2,1,0,1,0,False,0,0,0,2339,4,0.029722222222222223,Document
TypeScript,41369,87416,2987.751724537037,MERGED,1,1,1,0,1,0,False,0,0,0,655,2,1.793611111111111,Document
TypeScript,140,827,805.1782870370371,MERGED,3,6,1,3,2,124,False,1,2,2,1207,9,28.121111111111112,Bug
TypeScript,307,2556,587.5163773148148,MERGED,53,101,7,2,1,311,True,1,1,1,1998,154,26.99361111111111,Feature
TypeScript,41369,87416,2986.7335185185184,MERGED,2,5,2,1,3,0,False,0,1,1,2577,7,48.58888888888889,Document
Erlang,2054,12122,3852.426712962963,MERGED,530,1214,80,0,7,253,True,0,0,0,1481,1744,33.57944444444445,Document
TypeScript,202,107,1201.1149421296298,MERGED,7,184,7,6,8,2,False,2,4,3,3415,191,156.02333333333334,Document
Erlang,2054,12122,3852.1063194444446,MERGED,37,129,5,0,2,143,False,0,0,0,1078,166,48.240833333333335,Document
TypeScript,2147,14724,1528.8078935185185,CLOSED,417,610,76,0,1,180,False,0,0,0,6350,1027,3.1547222222222224,Bug
Erlang,2054,12122,3847.3757291666666,MERGED,4,9,3,7,1,403,False,3,4,2,1250,13,136.2902777777778,Document
Starlark,440,286,543.2098032407407,MERGED,0,59,3,2,2,2,False,1,1,1,1442,59,205.0561111111111,Feature
Erlang,2054,12122,3851.8868865740737,MERGED,85,130,4,0,3,513,True,0,0,0,1195,215,43.89416666666666,Document
TypeScript,2070,16640,1298.9821180555557,CLOSED,0,104,4,6,3,7,False,3,3,1,3132,104,23.310277777777777,Document
Erlang,2054,12122,3852.168657407407,CLOSED,0,10,6,3,3,0,False,2,1,1,1453,10,24.861666666666668,Document
TypeScript,307,2556,587.5052893518518,MERGED,2,8,3,0,1,13,False,0,0,0,2039,10,1.1861111111111111,Document
C#,655,7879,1885.3572222222222,MERGED,14,22,1,2,5,5,False,1,1,1,2326,36,136.9177777777778,Document
Go,1835,11245,1779.9452083333333,MERGED,4,4,1,0,1,103,False,0,0,0,893,8,0.10083333333333333,Bug
Erlang,2054,12122,3851.090347222222,MERGED,7,9,10,2,3,426,True,1,1,1,1361,16,71.74916666666667,Document
C#,80,125,875.8781828703704,CLOSED,30,90,10,0,2,6,False,0,0,0,1407,120,167.68472222222223,Document
Go,1835,11245,1784.9005208333335,MERGED,1,1,1,0,1,33,True,0,0,0,1403,2,0.04055555555555555,Document
Erlang,2054,12122,3852.3052314814813,MERGED,1,1,1,0,1,26,False,0,0,0,1043,2,0.5891666666666666,Document
Python,137,75,736.5428125,MERGED,1,5,2,0,2,25,False,0,0,0,1627,6,235.31972222222223,Document
TypeScript,41369,87416,2986.613969907407,MERGED,2,5,1,0,1,610,True,0,0,0,2364,7,0.16472222222222221,Document
Starlark,440,286,541.2665046296296,MERGED,3,3,1,1,19,10,False,0,1,1,1277,6,251.355,Bug
Erlang,2054,12122,3850.1677662037036,MERGED,1,8,3,0,1,84,True,0,0,0,1015,9,66.185,Document
Erlang,2054,12122,3851.0511342592595,MERGED,0,2,1,0,1,478,True,0,0,0,1108,2,21.227222222222224,Document
TypeScript,261,3765,732.5364004629629,MERGED,14,150,16,0,4,240,False,0,0,0,7002,164,2.6244444444444444,Document
TypeScript,2070,16640,1297.939236111111,CLOSED,0,163,6,1,1,0,False,0,1,1,3739,163,0.2713888888888889,Document
Python,2408,12186,295.5851157407407,MERGED,1,1,1,2,1,85,True,1,1,1,1601,2,1.4497222222222221,Document
TypeScript,3393,2334,1022.141574074074,MERGED,15,7,3,2,1,0,False,0,2,1,1373,22,0.8069444444444445,Feature
TypeScript,3393,2334,1023.9430555555556,MERGED,3,3,1,1,1,159,False,0,1,1,1291,6,0.19111111111111112,Feature
Erlang,2054,12122,3849.9029976851853,MERGED,71,233,7,0,1,425,True,0,0,0,1312,304,25.631666666666668,Document
Starlark,440,286,542.2183796296296,CLOSED,1,4,1,1,1,82,False,0,1,1,1406,5,129.3075,Bug
TypeScript,261,3765,731.5460416666666,MERGED,1,146,12,0,2,992,True,0,0,0,4696,147,5.836666666666667,Document
C#,655,7879,1878.3651736111112,MERGED,1,1,1,0,1,1520,True,0,0,0,1804,2,0.9436111111111111,Document
TypeScript,4,33,819.0591319444444,MERGED,1,1,1,2,1,257,True,1,1,1,1318,2,0.12444444444444444,Feature
TypeScript,3393,2334,1023.3001736111111,CLOSED,1,1,1,4,1,282,False,1,3,2,1394,2,17.015833333333333,Bug
C#,655,7879,1885.1758449074075,MERGED,0,75,2,1,3,9,False,0,1,1,2084,75,13.732777777777779,Document
C#,80,125,869.5512731481481,MERGED,315,352,14,0,6,98,False,0,0,0,1468,667,293.38722222222225,Document
TypeScript,41369,87416,2993.620277777778,MERGED,28,468,12,8,3,24,True,2,6,4,4073,496,119.11888888888889,Document
TypeScript,3393,2334,1023.2480208333333,MERGED,0,24,3,2,2,491,False,0,2,1,1501,24,0.5241666666666667,Feature
TypeScript,3393,2334,1023.0701504629629,MERGED,3,15,1,1,1,157,False,0,1,1,1184,18,0.1638888888888889,Feature
TypeScript,184,377,1966.7188078703703,MERGED,55,318,3,1,15,46,False,0,1,1,1872,373,168.99166666666667,Document
TypeScript,2147,14724,1523.1981944444444,MERGED,66,181,13,0,1,193,False,0,0,0,5394,247,14.041666666666666,Document
TypeScript,41369,87416,2992.8487731481478,MERGED,2,9,1,2,2,0,False,1,1,1,2440,11,134.12083333333334,Document
TypeScript,261,3765,730.7967824074075,MERGED,270,366,13,0,1,200,False,0,0,0,5634,636,0.28583333333333333,Document
TypeScript,3393,2334,1022.905451388889,MERGED,1,2,1,1,1,156,False,0,1,1,1415,3,0.145,Bug
TypeScript,261,3765,730.7566203703703,MERGED,151,152,62,0,3,989,True,0,0,0,7169,303,0.8130555555555555,Document
Erlang,2054,12122,3847.0136574074077,MERGED,33,108,4,0,3,387,True,0,0,0,1208,141,115.88388888888889,Document
TypeScript,307,2556,589.6801967592593,MERGED,4,151,5,0,2,199,True,0,0,0,3232,155,287.84694444444443,Feature
C#,655,7879,1882.142060185185,MERGED,0,1,1,1,1,639,True,0,1,1,2261,1,121.26611111111112,Document
C++,363,552,591.2564583333334,MERGED,7,28,5,0,2,264,False,0,0,0,1726,35,49.034444444444446,Document
C#,80,125,874.8495833333333,MERGED,4,11,2,0,4,10,False,0,0,0,1092,15,43.49138888888889,Document
TypeScript,3393,2334,1019.2207060185186,MERGED,3,8,2,2,1,0,False,0,2,1,1699,11,14.7275,Feature
C#,655,7879,1883.0165625,MERGED,1,7,2,0,2,3,False,0,0,0,1435,8,0.35055555555555556,Document
Java,450,746,4123.249618055555,MERGED,79,165,4,1,7,158,False,0,1,1,3846,244,259.8377777777778,Bug
TypeScript,3393,2334,1022.1804282407408,MERGED,9,15,5,1,4,155,False,0,1,1,1674,24,0.6725,Bug
Erlang,2054,12122,3846.918784722222,MERGED,49,829,14,0,8,56,False,0,0,0,995,878,93.22222222222223,Document
TypeScript,3393,2334,1022.1436921296296,MERGED,1,3,1,1,1,735,False,0,1,1,1310,4,0.405,Feature
Starlark,440,286,543.1686805555556,CLOSED,0,59,3,3,3,0,False,2,1,1,1658,59,0.14583333333333334,Feature
C#,655,7879,1878.3851041666667,MERGED,34,66,18,4,5,1521,True,1,3,2,2114,100,282.9372222222222,Document
C#,655,7879,1880.8903703703702,MERGED,1,1,1,1,1,638,True,0,1,1,2285,2,151.25861111111112,Document
TypeScript,3393,2334,1021.8948263888889,MERGED,1,1,1,2,1,489,False,0,2,1,1168,2,0.22722222222222221,Feature
TypeScript,41369,87416,2993.823611111111,MERGED,3,39,6,1,1,63,False,0,1,1,4420,42,14.175277777777778,Document
TypeScript,15,34,538.6957175925926,CLOSED,120,552,24,0,12,181,False,0,0,0,1143,672,157.28694444444446,Document
Python,14533,41191,1140.788587962963,CLOSED,0,1,1,0,1,0,False,0,0,0,1533,1,0.059166666666666666,Document
TypeScript,3393,2334,1018.124861111111,MERGED,1,1,1,2,1,0,False,0,2,1,1445,2,0.08055555555555556,Bug
C#,655,7879,1877.3013541666667,MERGED,2027,29,5,5,2,2,False,1,4,2,1654,2056,2.2377777777777776,Document
Python,14533,41191,1140.3588078703704,MERGED,1,1,1,0,1,1429,True,0,0,0,1509,2,11.4475,Document
TypeScript,3393,2334,1020.0440856481482,MERGED,57,74,1,2,2,281,False,0,2,1,1429,131,74.53277777777778,Feature
C#,80,125,870.9529398148148,MERGED,322,589,70,0,5,204,True,0,0,0,1195,911,185.9425,Document
TypeScript,3393,2334,1023.5393055555555,MERGED,157,200,38,2,5,0,False,0,2,1,2330,357,229.99722222222223,Feature
TypeScript,41369,87416,2992.3829976851853,MERGED,1,43,6,1,1,60,False,0,1,1,4620,44,34.550555555555555,Document
V,2097,34362,1605.5911921296295,MERGED,0,35,3,2,5,6,False,1,1,1,2709,35,11.886111111111111,Document
TypeScript,3393,2334,1019.9589583333333,MERGED,9,9,1,2,1,280,False,0,2,1,1229,18,46.14972222222222,Feature
Go,1835,11245,1784.9824074074074,MERGED,1,8,3,0,1,108,False,0,0,0,1656,9,0.13194444444444445,Feature
TypeScript,41369,87416,2986.528506944445,MERGED,0,39,3,3,2,80,True,1,2,2,3375,39,195.25194444444443,Document
C#,655,7879,1879.1444675925925,MERGED,3,114,6,2,5,98,False,1,1,1,2235,117,148.29333333333332,Document
TypeScript,12,11,1038.2835763888888,MERGED,131,924,8,0,16,174,False,0,0,0,5508,1055,4.266944444444444,Feature
Erlang,2054,12122,3846.8607870370374,MERGED,16,24,7,0,3,489,False,0,0,0,1191,40,1.1183333333333334,Document
Erlang,2054,12122,3846.7335416666665,MERGED,2,31,5,0,2,386,True,0,0,0,1130,33,6.878888888888889,Document
TypeScript,3393,2334,1016.937835648148,MERGED,34,19,3,1,13,6,False,0,1,1,1316,53,187.735,Feature
Erlang,2054,12122,3846.438553240741,MERGED,4,89,4,0,1,400,False,0,0,0,1326,93,19.56,Document
Starlark,440,286,546.7952199074074,MERGED,3,15,1,1,1,3,False,0,1,1,1795,18,120.02055555555556,Feature
Kotlin,164,4297,454.5307060185185,MERGED,3,3,2,0,1,60,False,0,0,0,1163,6,4.936944444444444,Bug
Erlang,2054,12122,3846.3520717592596,MERGED,2,26,2,1,1,399,False,1,0,0,1451,28,21.63888888888889,Document
Erlang,2054,12122,3846.702951388889,MERGED,0,4,2,0,2,424,True,0,0,0,1139,4,0.9005555555555556,Document
Erlang,2054,12122,3846.2479050925926,MERGED,55,236,3,0,2,398,False,0,0,0,1447,291,24.143333333333334,Document
C#,80,125,875.6663425925926,MERGED,4902,33789,29,0,19,186,True,0,0,0,1717,38691,305.5127777777778,Document
TypeScript,261,3765,727.7479976851852,MERGED,10,268,19,0,2,199,False,0,0,0,5465,278,0.7933333333333333,Document
TypeScript,41369,87416,2992.0225462962967,MERGED,3,27,6,1,3,487,True,0,1,1,4833,30,11.235,Document
Python,2408,12186,296.3930208333333,CLOSED,3,3,1,3,1,9,False,0,3,2,2098,6,149.84277777777777,Document
Python,137,75,735.4106134259259,CLOSED,1,5,2,1,2,1,False,1,0,0,1527,6,0.99,Document
TypeScript,261,3765,727.4865393518518,MERGED,327,177,12,0,3,985,True,0,0,0,4636,504,1.8847222222222222,Document
Python,137,75,735.2265162037037,CLOSED,1,1,1,0,1,0,False,0,0,0,1156,2,0.10833333333333334,Bug
C#,80,125,871.874201388889,MERGED,0,2,1,0,1,9,False,0,0,0,1000,2,64.53555555555556,Document
V,2097,34362,1601.8392129629628,MERGED,61,80,4,5,9,1,False,3,2,1,3476,141,140.6302777777778,Document
Java,450,746,4123.964085648148,MERGED,17,104,2,1,1,380,False,0,1,1,1825,121,73.72583333333333,Document
TypeScript,261,3765,726.7442361111111,MERGED,49,159,13,0,3,238,False,0,0,0,6208,208,23.629444444444445,Document
TypeScript,1297,21107,468.0823726851852,MERGED,299,482,116,1,8,1113,True,0,1,1,3809,781,10.681111111111111,Document
C#,655,7879,1878.7950115740741,MERGED,13,11,2,1,3,7,False,0,1,1,2176,24,120.06333333333333,Document
TypeScript,41369,87416,2991.632465277778,MERGED,35,40,8,0,5,484,True,0,0,0,4303,75,1.8463888888888889,Document
TypeScript,41369,87416,2991.6003009259257,MERGED,1,1,1,1,1,1,False,0,1,1,2146,2,1.811388888888889,Document
TypeScript,4,33,814.2661111111111,MERGED,0,9,2,2,2,255,True,1,1,1,1460,9,0.08,Feature
C#,80,125,876.8136458333333,MERGED,584,4925,77,1,37,185,False,1,0,0,1967,5509,189.43805555555556,Document
JavaScript,5139,7050,1259.6377893518518,MERGED,13,195,12,2,7,0,False,0,2,2,3599,208,22.089444444444446,Bug
Erlang,2054,12122,3845.760960648148,MERGED,3,21,3,0,1,385,True,0,0,0,1199,24,3.003888888888889,Document
Erlang,2054,12122,3845.7192361111115,MERGED,0,2,2,0,2,384,True,0,0,0,1145,2,4.641111111111111,Document
Starlark,440,286,544.9012962962963,MERGED,0,263,2,1,5,4,False,0,1,1,1919,263,164.54694444444445,Feature
Starlark,440,286,540.0482407407408,MERGED,11,11,2,1,3,1,False,0,1,1,1320,22,0.32305555555555554,Feature
TypeScript,261,3765,726.7116435185185,MERGED,70,129,6,0,1,983,True,0,0,0,5013,199,0.5572222222222222,Document
Starlark,440,286,544.2616203703703,MERGED,4,3,3,0,3,2,False,0,0,0,1871,7,179.8361111111111,Document
Go,789,5551,1096.0873958333334,CLOSED,0,151,2,5,3,23,False,3,2,1,2196,151,41.91833333333334,Document
Starlark,440,286,538.9972685185186,MERGED,0,127,2,1,2,15,False,0,1,1,1580,127,23.150277777777777,Document
TypeScript,1297,21107,466.79917824074073,MERGED,380,5726,20,1,6,1111,True,0,1,1,3778,6106,29.439722222222223,Document
C++,363,552,587.8752083333333,MERGED,774,784,19,0,8,261,False,0,0,0,1722,1558,5.02,Document
Java,1,10,282.88350694444443,MERGED,15,25,88,0,14,33,True,0,0,0,4955,40,3.432777777777778,Document
TypeScript,2147,14724,1528.9397800925926,MERGED,857,817,110,0,9,181,False,0,0,0,9507,1674,116.31972222222223,Feature
TypeScript,41369,87416,2989.9932291666664,MERGED,2,21,6,1,1,481,True,0,1,1,3979,23,34.99777777777778,Document
Go,1835,11245,1784.6087731481482,MERGED,16,9,4,0,1,573,False,0,0,0,2111,25,301.735,Document
TypeScript,3393,2334,1018.1222685185185,MERGED,9,0,1,1,1,148,False,0,1,1,1722,9,0.14694444444444443,Feature
TypeScript,3393,2334,1018.1100694444444,MERGED,1,1,1,1,1,147,False,0,1,1,1442,2,0.17166666666666666,Feature
TypeScript,41369,87416,2988.695266203704,CLOSED,2,6,2,5,1,5,False,3,2,2,3369,8,94.85944444444445,Document
TypeScript,1073,11366,1144.921388888889,MERGED,0,3,1,1,1,765,True,0,1,1,1523,3,21.685,Feature
Go,1835,11245,1782.6234375000001,MERGED,0,10,2,0,1,105,False,0,0,0,1315,10,0.11916666666666667,Feature
Starlark,440,286,542.3457407407408,MERGED,5,5,2,1,4,2,False,0,1,1,1861,10,225.74666666666667,Document
TypeScript,41369,87416,2989.068263888889,MERGED,9,29,6,0,1,480,True,0,0,0,4839,38,57.17027777777778,Document
Python,2408,12186,296.8099652777778,MERGED,2,2,1,0,2,364,True,0,0,0,1761,4,3.1463888888888887,Document
TypeScript,3393,2334,1017.3838888888889,MERGED,0,7,1,1,1,359,False,0,1,1,1272,7,0.51,Feature
C#,80,125,869.8459722222223,MERGED,12,87,4,0,9,12,False,0,0,0,1362,99,26.053055555555556,Document
TypeScript,3393,2334,1016.9653587962963,MERGED,0,10,1,1,1,143,False,0,1,1,1309,10,2.026388888888889,Bug
TypeScript,4,33,812.0881365740742,MERGED,1,9,2,2,2,252,True,1,1,1,1138,10,0.10027777777777777,Document
TypeScript,3393,2334,1024.3893402777778,MERGED,2,39,4,2,2,493,False,0,2,1,2165,41,11.322777777777778,Feature
TypeScript,2147,14724,1529.2197685185185,MERGED,1045,176,22,0,9,60,False,0,0,0,10847,1221,13.32638888888889,Document
Python,2408,12186,295.77270833333336,MERGED,1,1,1,0,1,360,True,0,0,0,1665,2,0.08444444444444445,Document
Starlark,440,286,540.020150462963,MERGED,16,50,1,1,2,2,False,0,1,1,2069,66,281.2605555555556,Feature
TypeScript,41369,87416,2988.8479861111114,MERGED,821,1291,4,0,4,1943,True,0,0,0,2867,2112,5.530555555555556,Document
C#,655,7879,1878.3359027777778,MERGED,0,10,1,0,1,1519,True,0,0,0,2012,10,1.3672222222222221,Document
Python,2408,12186,295.2151736111111,MERGED,1,1,1,0,3,358,True,0,0,0,1905,2,24.341944444444444,Document
V,2097,34362,1601.6307986111112,MERGED,4,4,1,0,1,41,True,0,0,0,2916,8,9.741944444444444,Document
TypeScript,41369,87416,2988.6176504629634,MERGED,1,21,6,0,1,478,True,0,0,0,4087,22,2.877222222222222,Document
TypeScript,3393,2334,1024.1418171296298,MERGED,8,8,1,1,1,160,False,0,1,1,1703,16,0.18222222222222223,Feature
TypeScript,3393,2334,1022.4308912037037,MERGED,12,40,2,2,1,0,False,0,2,1,1935,52,17.40111111111111,Bug
Java,450,746,4121.214872685186,MERGED,22,120,10,1,4,384,True,0,1,1,1201,142,18.728055555555557,Feature
C#,655,7879,1877.5103124999998,MERGED,2,16,2,1,2,101,False,0,1,1,1938,18,16.908055555555556,Document
TypeScript,307,2556,588.4397685185185,MERGED,11,40,5,0,1,22,False,0,0,0,3558,51,3.828888888888889,Bug
TypeScript,41369,87416,2988.0599305555556,MERGED,60,82,6,0,1,477,True,0,0,0,4071,142,10.4325,Document
JavaScript,34,25,253.74782407407406,MERGED,0,209,4,1,2,85,False,1,0,0,2091,209,30.384722222222223,Bug
JavaScript,5139,7050,1255.7698611111111,MERGED,32,45,21,1,2,133,False,0,1,1,5901,77,0.34194444444444444,Bug
Go,2083,11769,1570.2795023148149,MERGED,8,8,1,2,1,0,False,0,2,2,1209,16,0.7955555555555556,Document
TypeScript,1073,11366,1150.8355439814816,MERGED,0,1,1,0,1,218,False,0,0,0,2020,1,0.20583333333333334,Bug
C#,655,7879,1878.9617592592592,MERGED,45,188,12,8,7,12,False,4,4,2,2559,233,435.11277777777775,Document
C#,655,7879,1885.26875,MERGED,25,265,7,0,10,642,True,0,0,0,2465,290,114.22777777777777,Document
TypeScript,307,2556,587.4662152777778,CLOSED,3,4,1,5,1,1,False,1,4,3,762,7,2.8566666666666665,Bug
C#,655,7879,1883.341076388889,CLOSED,164,102,5,5,1,0,False,3,2,1,2739,266,210.79083333333332,Document
TypeScript,41369,87416,2987.778958333334,MERGED,14,14,2,2,1,1,False,1,1,1,4170,28,0.5483333333333333,Document
TypeScript,15,34,539.3607986111111,MERGED,275,431,18,0,7,354,False,0,0,0,1850,706,0.43694444444444447,Bug
Python,2408,12186,293.6100925925926,MERGED,1,1,1,1,1,1,False,0,1,1,1714,2,28.768333333333334,Document
C++,363,552,590.8544675925926,MERGED,54,133,10,0,6,262,False,0,0,0,2501,187,58.458888888888886,Document
TypeScript,1073,11366,1149.617361111111,MERGED,1,1,1,1,1,15,True,0,1,1,1910,2,0.7880555555555555,Bug
TypeScript,1073,11366,1149.6377314814815,MERGED,1,9,2,1,1,146,True,0,1,1,2471,10,0.44972222222222225,Bug
C++,2234,23696,2413.7066898148146,MERGED,22,107,9,1,5,301,False,0,1,1,6443,129,340.42083333333335,Bug
Python,2408,12186,291.02979166666665,MERGED,8,9,6,5,8,356,True,2,3,2,1725,17,93.19277777777778,Document
Erlang,2054,12122,3847.275416666667,MERGED,2,52,4,0,1,402,False,0,0,0,1522,54,68.90527777777778,Document
TypeScript,3393,2334,1022.2662268518519,MERGED,2,8,1,1,1,737,False,0,1,1,1771,10,0.135,Feature
C#,655,7879,1881.1265624999999,MERGED,1,168,12,1,6,4,False,1,0,0,2780,169,238.64777777777778,Document
Starlark,440,286,543.0261342592593,CLOSED,0,265,3,1,1,1,False,0,1,1,1566,265,0.36027777777777775,Document
TypeScript,3393,2334,1021.8812731481481,MERGED,0,24,3,2,2,488,False,0,2,1,1815,24,4.756388888888889,Feature
C#,655,7879,1880.0670949074074,MERGED,0,17,1,0,7,13,False,0,0,0,2628,17,270.8747222222222,Document
Go,1835,11245,1777.7691666666667,MERGED,1,1,1,0,1,99,False,0,0,0,1179,2,0.01888888888888889,Bug
JavaScript,34,25,252.51784722222223,MERGED,14,55,3,0,2,1,False,0,0,0,2420,69,488.81694444444446,Bug
Python,2408,12186,291.68679398148146,CLOSED,0,282,2,0,9,1,False,0,0,0,1901,282,0.10555555555555556,Document
Go,1835,11245,1784.8483680555555,MERGED,1,8,2,0,1,32,True,0,0,0,1788,9,0.3269444444444444,Document
Python,14533,41191,1137.2481944444444,MERGED,1,1,1,1,2,0,False,0,1,1,2076,2,97.95083333333334,Document
TypeScript,4803,40785,3810.795150462963,MERGED,6,16,2,1,3,153,True,0,1,1,2119,22,16.204166666666666,Bug
Java,450,746,4124.044953703704,MERGED,7,45,3,1,9,60,False,0,1,1,2130,52,71.70555555555555,Feature
Python,137,75,735.4144560185185,MERGED,0,5,2,0,2,2,False,0,0,0,1767,5,7.114722222222222,Bug
Python,4516,54991,977.3387731481481,CLOSED,231,261,1,0,1,0,False,0,0,0,2297,492,0.013888888888888888,Document
TypeScript,3393,2334,1019.8034606481482,MERGED,0,17,4,1,2,153,False,0,1,1,2124,17,0.3397222222222222,Feature
Python,2408,12186,289.999375,CLOSED,3,4,1,9,1,1,False,4,5,1,1875,7,37.195,Document
Starlark,440,286,540.0111226851851,MERGED,0,527,2,4,2,0,False,3,1,1,1578,527,18.63861111111111,Document
Go,1835,11245,1783.8436342592593,MERGED,5,5,5,0,1,8,False,0,0,0,2111,10,0.21555555555555556,Document
Go,1835,11245,1783.7948379629631,MERGED,2,4,4,0,3,106,False,0,0,0,2272,6,0.03138888888888889,Document
Vue,10806,21163,1073.3502083333333,MERGED,2,13,2,2,1,0,False,0,2,2,2762,15,66.24805555555555,Bug
TypeScript,3393,2334,1019.0379861111111,MERGED,2,16,3,1,1,150,False,0,1,1,1925,18,0.14555555555555555,Feature
TypeScript,4,33,813.1960879629629,MERGED,34,204,6,2,16,254,True,1,1,1,1914,238,22.58416666666667,Bug
Python,2408,12186,289.79709490740737,MERGED,1,1,1,0,1,355,True,0,0,0,1886,2,0.40055555555555555,Document
Starlark,440,286,539.0041898148148,MERGED,0,186,4,3,4,0,False,2,1,1,2447,186,24.548333333333332,Document
Starlark,440,286,538.9768402777778,MERGED,24,19,1,1,1,4,False,0,1,1,2244,43,20.816111111111113,Feature
Java,450,746,4122.9608217592595,MERGED,7,35,3,1,5,58,False,0,1,1,2285,42,23.462222222222223,Feature
TypeScript,3393,2334,1018.3155555555555,MERGED,1,432,14,1,6,149,False,0,1,1,1897,433,1.9247222222222222,Feature
Python,2408,12186,289.0900115740741,MERGED,2,2,1,2,2,0,False,1,1,1,1816,4,0.2011111111111111,Document
TypeScript,3393,2334,1017.9314814814815,MERGED,10,11,2,1,1,145,False,0,1,1,2102,21,0.3372222222222222,Bug
TypeScript,1073,11366,1144.7273032407409,MERGED,0,3,1,1,1,207,False,0,1,1,2053,3,0.1527777777777778,Bug
TypeScript,1073,11366,1144.5761111111112,MERGED,15,6,2,3,3,205,False,1,2,2,2002,21,0.40194444444444444,Document
TypeScript,1073,11366,1144.5686574074073,MERGED,1,1,1,1,1,10,True,0,1,1,1917,2,0.2925,Bug
TypeScript,3393,2334,1017.3884953703704,MERGED,1,6,1,1,2,360,False,0,1,1,1852,7,10.126111111111111,Feature
TypeScript,4,33,811.6900578703703,MERGED,76,367,21,1,10,234,False,0,1,1,2063,443,24.488055555555555,Document
TypeScript,7,6,700.2058912037037,CLOSED,48,1335,31,1,48,36,True,1,0,0,5777,1383,70.01333333333334,Feature
TypeScript,3393,2334,1017.375324074074,MERGED,4,11,2,1,1,358,False,0,1,1,2133,15,0.08583333333333333,Document
Starlark,440,286,544.345324074074,MERGED,0,521,4,5,23,0,False,3,2,2,2277,521,253.90027777777777,Document
TypeScript,261,3765,727.650787037037,MERGED,69,114,16,0,5,223,True,0,0,0,8048,183,2.8872222222222224,Document
TypeScript,3393,2334,1017.0555324074074,MERGED,3,3,3,1,1,144,False,0,1,1,1885,6,0.12083333333333333,Feature
TypeScript,4,33,811.4934606481482,MERGED,244,319,37,2,1,652,True,1,1,1,1896,563,3.450277777777778,Feature
C++,2234,23696,2407.608078703704,CLOSED,173,361,12,1,11,18,False,0,1,1,6558,534,344.63916666666665,Bug
TypeScript,1073,11366,1143.783923611111,MERGED,0,13,1,0,1,203,False,0,0,0,1940,13,0.028055555555555556,Bug
TypeScript,1073,11366,1143.6785532407407,MERGED,10,36,3,1,4,201,False,0,1,1,2095,46,3.8141666666666665,Document
TypeScript,307,2556,594.4705324074074,MERGED,4,225,8,9,6,202,True,5,4,2,4788,229,200.67333333333335,Feature
JavaScript,2,1,376.32383101851855,MERGED,70,301,5,0,2,32,False,0,0,0,2467,371,0.024166666666666666,Document
JavaScript,22,26,973.7352893518519,MERGED,9,36,8,0,3,20,True,0,0,0,2792,45,7.684166666666667,Feature
Python,4516,54991,982.6568402777779,MERGED,2,4,1,3,2,0,False,0,3,2,3003,6,113.11722222222222,Document
Java,1,10,282.07612268518517,MERGED,47,195,11,1,6,27,True,1,0,0,10004,242,0.4469444444444444,Document
Go,1835,11245,1779.954861111111,MERGED,34,35,18,1,1,0,False,0,1,1,1937,69,2.1483333333333334,Document
TypeScript,261,3765,725.9274305555556,MERGED,1674,1599,184,1,25,638,True,0,1,1,9031,3273,1.3869444444444445,Document
Go,1835,11245,1779.6571875,MERGED,1,1,2,0,2,7,False,0,0,0,1876,2,0.2225,Document
TypeScript,2070,16640,1297.9989699074074,MERGED,55,35,17,0,2,2,False,0,0,0,8603,90,631.0491666666667,Document
Python,2408,12186,296.9605902777778,MERGED,5,5,1,0,5,365,True,0,0,0,2530,10,0.7077777777777777,Document
Python,2408,12186,296.96870370370374,MERGED,1,1,1,0,1,366,True,0,0,0,2120,2,0.006388888888888889,Document
Starlark,440,286,542.249375,MERGED,19,21,2,1,2,83,False,0,1,1,2514,40,228.05027777777778,Document
Starlark,440,286,542.0994212962963,MERGED,0,251,2,2,5,2,False,0,2,2,2651,251,231.62916666666666,Feature
TypeScript,41369,87416,2992.791122685185,MERGED,14,432,13,10,8,23,True,3,7,4,6468,446,193.0988888888889,Document
Go,1835,11245,1778.7856597222224,MERGED,0,28,2,0,9,4,False,0,0,0,1883,28,19.551666666666666,Document
Python,2408,12186,296.5855787037037,MERGED,0,1,1,1,2,10,False,0,1,1,2127,1,9.243055555555555,Document
C#,655,7879,1877.6807175925926,MERGED,1366,87,88,0,3,635,True,0,0,0,2538,1453,21.308055555555555,Document
Go,1835,11245,1778.8600810185187,MERGED,0,15,1,0,1,2,False,0,0,0,1850,15,0.22111111111111112,Document
Go,1835,11245,1777.9586689814814,MERGED,6,74,3,0,1,572,False,0,0,0,2032,80,42.34722222222222,Document
Python,137,75,740.3335648148148,MERGED,10,26,7,0,1,100,False,0,0,0,3517,36,0.38805555555555554,Document
Python,14533,41191,1143.3953587962963,MERGED,10,20,2,1,6,4,False,0,1,1,2997,30,26.86638888888889,Document
TypeScript,4803,40785,3815.774675925926,MERGED,62,101,2,1,1,156,True,0,1,1,2982,163,15.056666666666667,Feature
Go,1835,11245,1777.8771527777778,MERGED,16,19,3,0,1,100,False,0,0,0,1929,35,17.864166666666666,Bug
Python,2408,12186,295.25708333333336,MERGED,155,227,8,6,23,359,True,4,2,1,2777,382,23.67222222222222,Document
Starlark,440,286,545.1226041666666,CLOSED,2,32,2,1,2,84,False,0,1,1,2422,34,11.293611111111112,Bug
Python,2408,12186,295.08930555555554,MERGED,4,4,2,0,2,357,True,0,0,0,2157,8,13.33361111111111,Document
TypeScript,3393,2334,1022.4473842592593,MERGED,8,4,4,2,1,0,False,0,2,1,2368,12,7.679722222222222,Feature
C#,80,125,875.909050925926,MERGED,19,622,15,0,13,200,False,0,0,0,2248,641,66.68166666666667,Document
Python,14533,41191,1142.7869560185184,MERGED,41,46,14,0,6,1430,True,0,0,0,2330,87,0.07583333333333334,Document
Go,789,5551,1092.0435185185186,MERGED,2,2,1,3,1,0,False,2,1,1,2421,4,96.39972222222222,Document
TypeScript,4,33,813.2129050925927,MERGED,335,356,27,1,16,394,True,0,1,1,3149,691,271.6838888888889,Bug
TypeScript,1073,11366,1150.8690509259259,MERGED,0,199,1,1,1,220,False,0,1,1,2511,199,12.909722222222221,Document
TypeScript,1073,11366,1150.8296527777777,MERGED,3,3,2,0,1,18,True,0,0,0,2174,6,0.37555555555555553,Document
TypeScript,41369,87416,2993.8627314814817,MERGED,2,49,6,1,1,65,False,0,1,1,4660,51,13.38888888888889,Document
Go,1835,11245,1783.9137962962961,MERGED,41,44,8,0,8,107,False,0,0,0,3315,85,0.04138888888888889,Document
TypeScript,1073,11366,1150.5900925925926,MERGED,1,1,1,1,1,217,False,0,1,1,2610,2,0.21472222222222223,Bug
TypeScript,3393,2334,1023.1762962962963,MERGED,23,39,4,1,1,158,False,0,1,1,2798,62,0.20444444444444446,Feature
TypeScript,41369,87416,2993.797002314815,MERGED,3,52,6,1,1,62,False,0,1,1,5023,55,1.0577777777777777,Document
TypeScript,41369,87416,2993.5136805555558,MERGED,18,19,7,3,3,492,True,1,2,2,5326,37,4.9494444444444445,Document
Python,137,75,734.835798611111,MERGED,32,4,19,0,3,91,False,0,0,0,4238,36,30.62527777777778,Bug
TypeScript,1073,11366,1149.8348263888888,MERGED,9,10,2,1,2,216,False,0,1,1,2268,19,15.700833333333334,Bug
TypeScript,307,2556,593.5183449074074,MERGED,1,77,8,0,2,201,True,0,0,0,6854,78,7.0425,Feature
TypeScript,4,33,817.3683333333333,MERGED,30,175,12,1,4,394,False,0,1,1,2745,205,0.14722222222222223,Bug
Starlark,440,286,543.1956944444445,CLOSED,0,59,3,2,1,1,False,1,1,1,2664,59,0.195,Feature
Starlark,440,286,543.0429976851852,CLOSED,0,266,3,1,8,2,False,0,1,1,2251,266,4.652222222222222,Document
TypeScript,1073,11366,1149.8343055555556,MERGED,1,1,1,1,1,17,True,0,1,1,2099,2,0.06333333333333334,Bug
TypeScript,1073,11366,1149.707314814815,MERGED,1,1,1,1,1,16,True,0,1,1,2464,2,1.0847222222222221,Bug
TypeScript,1073,11366,1149.5998148148149,MERGED,1,1,1,1,1,14,True,0,1,1,2125,2,0.2658333333333333,Bug
TypeScript,1073,11366,1149.597847222222,MERGED,4,47,2,1,5,291,True,0,1,1,2644,51,1.3233333333333333,Bug
TypeScript,1073,11366,1148.693148148148,MERGED,0,6,3,2,3,289,True,0,2,2,2816,6,44.15611111111111,Bug
TypeScript,1073,11366,1149.4280902777778,MERGED,6,51,2,1,3,290,True,0,1,1,3138,57,2.8044444444444445,Bug
Python,2408,12186,291.58506944444446,MERGED,4,10,1,11,3,0,False,6,5,2,2475,14,79.64277777777778,Document
TypeScript,41369,87416,2991.8915393518514,MERGED,79,1006,43,2,4,611,True,0,2,2,6562,1085,44.812777777777775,Document
TypeScript,3393,2334,1018.4863773148148,MERGED,18,45,2,2,1,0,False,0,2,1,2909,63,87.69444444444444,Feature
Starlark,440,286,543.2398842592593,CLOSED,0,374,6,1,9,3,False,0,1,1,3200,374,745.755,Document
Python,2408,12186,290.82070601851854,MERGED,2,2,2,2,2,0,False,1,1,1,2920,4,98.135,Document
TypeScript,178,1359,377.221099537037,MERGED,446,226,14,1,1,33,True,0,1,1,11022,672,18.57,Bug
V,2097,34362,1604.5241203703702,MERGED,35,119,8,0,3,30,True,0,0,0,4874,154,19.740555555555556,Document
TypeScript,41369,87416,2991.8319560185187,MERGED,31,68,7,1,2,486,True,0,1,1,6634,99,1.0472222222222223,Document
TypeScript,41369,87416,2991.736435185185,MERGED,24,52,7,1,5,485,True,0,1,1,5159,76,3.3219444444444446,Document
TypeScript,41369,87416,2991.4618287037033,MERGED,20,44,6,1,1,483,True,0,1,1,4942,64,2.9369444444444444,Document
TypeScript,1073,11366,1146.4878703703705,MERGED,3,36,1,2,1,768,True,0,2,2,3000,39,0.43416666666666665,Bug
V,2097,34362,1603.72625,MERGED,200,405,9,3,4,29,True,2,1,1,6437,605,12.279444444444444,Document
TypeScript,1073,11366,1147.6663194444443,MERGED,0,4,1,1,1,13,True,0,1,1,2429,4,2.8136111111111113,Bug
TypeScript,1073,11366,1146.6611805555556,MERGED,1,1,1,1,1,288,True,0,1,1,2377,2,18.406388888888888,Bug
TypeScript,4803,40785,3810.640069444444,MERGED,1,83,5,1,2,152,True,0,1,1,3101,84,0.18916666666666668,Bug
TypeScript,41369,87416,2988.5011574074074,MERGED,9,10,2,3,1,1618,True,0,3,3,5006,19,2.0747222222222224,Document
Python,2408,12186,289.4908217592593,CLOSED,4,4,2,0,2,1,False,0,0,0,3006,8,10.526666666666667,Document
V,2097,34362,1601.6120717592594,MERGED,154,225,6,0,3,28,True,0,0,0,5426,379,24.872222222222224,Document
TypeScript,41369,87416,2988.7525578703703,MERGED,2,24,6,0,2,479,True,0,0,0,5038,26,3.027222222222222,Document
Java,450,746,4122.266354166667,CLOSED,43,111,2,2,1,379,False,1,1,1,3420,154,40.7325,Document
Java,450,746,4122.189861111111,MERGED,15,42,5,1,5,57,False,0,1,1,2431,57,41.9725,Feature
TypeScript,1073,11366,1144.6494791666667,MERGED,0,3,1,1,1,12,True,0,1,1,2491,3,2.1991666666666667,Bug
TypeScript,1073,11366,1144.5949537037038,MERGED,24,15,5,1,9,11,True,0,1,1,2298,39,1.013611111111111,Document
TypeScript,1073,11366,1144.5689351851852,MERGED,12,12,1,1,1,204,False,0,1,1,2944,24,0.2386111111111111,Bug
TypeScript,3393,2334,1017.2051504629629,MERGED,38,42,2,2,1,0,False,0,2,1,2738,80,0.2263888888888889,Bug
TypeScript,41369,87416,2987.7575347222223,MERGED,3,26,6,0,1,476,True,0,0,0,4771,29,1.7052777777777777,Document
Python,4516,54991,976.1316435185186,CLOSED,3,9,2,5,2,147,False,2,3,2,3521,12,711.1466666666666,Document
Java,1,10,286.0131828703704,MERGED,235,378,14,0,22,35,True,0,0,0,13110,613,0.07916666666666666,Document
TypeScript,1073,11366,1143.7658333333334,MERGED,1,1,1,0,1,202,False,0,0,0,2373,2,0.19361111111111112,Bug
TypeScript,41369,87416,2986.647060185185,MERGED,10,67,4,0,7,475,True,0,0,0,4899,77,19.529444444444444,Document
TypeScript,1073,11366,1143.5964467592592,MERGED,4,3,1,1,1,37,True,0,1,1,2824,7,0.06805555555555555,Bug
TypeScript,1073,11366,1143.0365393518518,MERGED,20,117,4,1,3,287,True,0,1,1,3043,137,18.279444444444444,Bug
TypeScript,41369,87416,2986.5588657407407,MERGED,3,40,6,0,1,49,False,0,0,0,4814,43,0.8205555555555556,Document
Go,1835,11245,1779.0795833333334,MERGED,11,11,65,0,6,5,False,0,0,0,3212,22,12.918888888888889,Document
Go,1835,11245,1778.9501620370372,CLOSED,10,25,66,0,4,4,False,0,0,0,2557,35,2.2375,Document
Go,1835,11245,1778.937199074074,MERGED,39,180,5,0,3,101,False,0,0,0,3142,219,0.2513888888888889,Document
Python,4516,54991,975.5163773148148,CLOSED,0,2,1,1,1,0,False,1,0,0,3932,2,619.7563888888889,Document
Starlark,440,286,545.9874884259259,MERGED,66,137,4,2,16,6,False,0,2,2,3333,203,139.39111111111112,Document
Starlark,440,286,545.6046180555555,MERGED,7,50,4,1,11,85,False,0,1,1,3432,57,147.9286111111111,Bug
TypeScript,41369,87416,2993.7618171296294,MERGED,98,1034,51,1,3,493,True,0,1,1,7665,1132,0.36083333333333334,Document
Go,789,5551,1096.148611111111,MERGED,19,26,1,0,1,24,False,0,0,0,3575,45,16.0375,Document
Go,789,5551,1095.9078472222222,MERGED,211,6,6,0,1,417,False,0,0,0,3954,217,2.0975,Document
Starlark,440,286,542.0228587962963,MERGED,7,9,1,2,1,1,False,1,1,1,3259,16,233.2436111111111,Bug
TypeScript,4803,40785,3815.6903125000003,MERGED,20,177,12,1,5,154,True,0,1,1,4652,197,17.07777777777778,Bug
Go,789,5551,1094.8900231481482,MERGED,13,94,5,0,3,196,True,0,0,0,3895,107,24.675555555555555,Document
Starlark,440,286,539.2626620370371,MERGED,1,1,1,4,4,1,False,2,2,2,4235,2,299.42583333333334,Document
Go,1835,11245,1778.8160532407408,MERGED,12,71,3,0,1,14,False,0,0,0,4388,83,0.15666666666666668,Document
Rust,413,5118,517.5252430555555,MERGED,40,84,8,1,7,19,False,0,1,1,3155,124,19.814166666666665,Document
Python,2408,12186,292.7829513888889,CLOSED,1,8,3,4,2,0,False,1,3,1,3012,9,0.16666666666666666,Document
TypeScript,1073,11366,1150.5211111111112,MERGED,0,63,2,1,1,292,True,0,1,1,3748,63,2.7691666666666666,Bug
TypeScript,3393,2334,1021.1669328703703,MERGED,68,79,4,3,8,9,False,0,3,2,3879,147,119.02111111111111,Document
TypeScript,4,33,817.0796180555554,MERGED,365,215,15,2,40,256,True,1,1,1,3727,580,47.198055555555555,Bug
TypeScript,1073,11366,1148.8007523148149,MERGED,9,89,2,1,2,214,False,0,1,1,3060,98,66.88,Bug
TypeScript,1073,11366,1148.7734837962964,MERGED,15,89,8,1,2,213,False,0,1,1,4253,104,67.52722222222222,Bug
JavaScript,2,1,371.98396990740736,MERGED,32,194,10,0,3,29,False,0,0,0,4394,226,2.656111111111111,Document
TypeScript,202,107,1193.5941782407408,MERGED,293,86,27,3,6,283,True,0,3,3,9456,379,48.31916666666667,Document
Python,4516,54991,976.1360648148147,MERGED,43,1,2,1,3,148,False,0,1,1,3804,44,173.8975,Document
JavaScript,2,1,371.11525462962965,MERGED,63,186,9,0,2,28,False,0,0,0,3623,249,0.04888888888888889,Document
Python,4516,54991,977.7589814814814,MERGED,7,15,1,0,3,149,False,0,0,0,3687,22,60.18861111111111,Document
Python,14533,41191,1137.429861111111,CLOSED,22,31,8,2,9,6,True,0,2,2,4443,53,126.71583333333334,Document
JavaScript,2,1,370.156412037037,MERGED,26,116,9,0,7,27,False,0,0,0,3590,142,0.09222222222222222,Document
TypeScript,1073,11366,1144.6916319444445,MERGED,47,2389,25,1,11,206,False,0,1,1,4709,2436,92.57972222222222,Bug
Python,4516,54991,978.5772453703704,MERGED,3,48,3,22,37,1,False,13,9,3,5939,51,1013.7463888888889,Document
TypeScript,3393,2334,1019.0839467592592,MERGED,16,43,5,1,1,151,False,0,1,1,4478,59,0.11083333333333334,Feature
Python,4516,54991,974.7387152777778,CLOSED,1,7,1,3,3,0,False,2,1,1,3824,8,59.441944444444445,Document
TypeScript,1073,11366,1144.9713541666667,MERGED,9,64,3,1,2,766,True,0,1,1,3780,73,20.621666666666666,Bug
TypeScript,2147,14724,1528.9586458333333,MERGED,850,138,29,0,4,759,False,0,0,0,16562,988,1.298888888888889,Feature
TypeScript,307,2556,588.7384375,MERGED,94,72,78,0,1,24,False,0,0,0,3765,166,2.1169444444444445,Bug
TypeScript,3393,2334,1017.0447222222223,MERGED,35,55,7,1,3,356,False,0,1,1,4562,90,1.0763888888888888,Feature
TypeScript,1073,11366,1143.6104976851852,MERGED,665,332,7,0,14,38,True,0,0,0,4398,997,0.1661111111111111,Document
TypeScript,85,724,370.1313425925926,MERGED,5,296,15,0,1,38,False,0,0,0,18027,301,19.975833333333334,Document
Java,1,10,288.9798842592592,MERGED,486,405,15,1,21,11,False,1,0,0,17692,891,0.13666666666666666,Document
Go,1835,11245,1779.6250925925926,MERGED,12,12,65,0,7,6,False,0,0,0,3934,24,0.20472222222222222,Document
Go,30,295,397.9536805555556,MERGED,109,334,14,1,2,43,True,0,1,1,13843,443,3.4394444444444443,Feature
Java,450,746,4124.224768518518,MERGED,2378,2905,196,8,171,61,False,1,7,3,6620,5283,769.1636111111111,Feature
TypeScript,261,3765,727.6814930555556,MERGED,201,349,28,0,1,986,True,0,0,0,16453,550,0.1725,Document
Java,1,10,282.11391203703704,MERGED,491,521,20,0,7,31,True,0,0,0,16309,1012,0.5455555555555556,Document
TypeScript,41369,87416,2992.5039814814813,MERGED,1041,1772,51,3,38,488,True,1,2,2,12691,2813,28.9,Document
Python,137,75,739.9870138888888,MERGED,12,111,19,3,12,26,False,0,3,1,5074,123,340.735,Bug
Java,450,746,4123.191631944444,MERGED,699,495,37,3,3,85,True,1,2,1,11661,1194,92.21972222222222,Bug
Python,4516,54991,981.8808564814814,MERGED,14,24,1,0,4,111,True,0,0,0,4606,38,1.5755555555555556,Document
Python,2408,12186,296.0269675925926,MERGED,56,99,12,12,43,361,True,10,2,2,7527,155,67.98416666666667,Document
Python,4516,54991,982.5677546296297,MERGED,67,124,1,5,1,112,True,1,4,2,6361,191,25.656388888888888,Document
JavaScript,2,1,374.2749768518518,MERGED,33,156,5,0,2,30,False,0,0,0,5833,189,0.12611111111111112,Document
JavaScript,22,26,969.8464814814815,MERGED,140,388,13,0,10,19,True,0,0,0,7595,528,92.68055555555556,Bug
Go,1835,11246,1779.804699074074,MERGED,187,299,17,0,1,15,False,0,0,0,6060,486,95.7675,Document
TypeScript,4,33,817.6817013888889,MERGED,0,774,15,3,13,235,False,1,2,2,6884,774,53.58166666666666,Document
Python,137,75,739.4337037037036,MERGED,43,116,35,0,4,218,False,0,0,0,6407,159,0.3713888888888889,Document
TypeScript,1073,11366,1145.820601851852,MERGED,1671,2056,35,1,15,211,False,0,1,1,7808,3727,164.76388888888889,Document
TypeScript,3393,2334,1023.0251967592593,CLOSED,23,64,5,2,1,490,False,0,2,1,5297,87,23.624166666666667,Bug
Go,1835,11246,1777.6333796296296,MERGED,259,379,14,0,1,13,False,0,0,0,6063,638,0.12638888888888888,Document
TypeScript,3393,2334,1022.9665624999999,MERGED,73,63,15,1,2,739,False,0,1,1,5581,136,2.8475,Feature
TypeScript,1073,11366,1148.6466898148149,MERGED,63,700,5,1,9,212,False,0,1,1,5598,763,70.53222222222222,Bug
Python,4516,54992,977.7827199074073,MERGED,113,70,2,12,10,110,True,5,7,3,5760,183,113.29277777777777,Document
TypeScript,1073,11366,1148.885,MERGED,105,300,5,1,5,215,False,0,1,1,6781,405,18.920277777777777,Bug
Java,450,746,4123.220497685185,MERGED,97,103,11,1,27,59,False,0,1,1,7579,200,187.41027777777776,Bug
TypeScript,184,377,1960.1444675925925,MERGED,4,5,3,2,5,44,False,2,0,0,4877,9,46.593333333333334,Document
TypeScript,4803,40787,3810.536365740741,MERGED,68,68,34,1,1,151,True,0,1,1,6270,136,0.5480555555555555,Bug
TypeScript,1073,11366,1145.608425925926,MERGED,1,73,7,1,2,767,True,0,1,1,5590,74,5.253611111111111,Bug
TypeScript,3393,2334,1018.1060532407408,MERGED,57,155,23,3,8,146,False,1,2,2,6792,212,6.579444444444444,Bug
TypeScript,4,33,812.2401851851852,MERGED,16,154,8,2,26,253,True,1,1,1,7112,170,24.350555555555555,Bug
TypeScript,4,33,812.2766319444445,MERGED,54,99,7,2,1,653,True,1,1,1,6895,153,0.9886111111111111,Document
Java,450,746,4121.22181712963,MERGED,28,198,17,1,17,56,False,0,1,1,5718,226,65.32916666666667,Bug
TypeScript,4,33,818.4202430555556,MERGED,984,1712,57,2,21,654,True,1,1,1,8552,2696,334.215,Document
Python,2409,12192,291.8099074074074,MERGED,841,1472,32,10,131,0,False,2,8,2,9677,2313,312.33194444444445,Document
TypeScript,3393,2334,1024.0092708333334,MERGED,113,366,16,2,10,492,False,0,2,1,9581,479,121.47361111111111,Feature
Python,547,7161,2289.666886574074,MERGED,171,116,14,0,27,35,False,0,0,0,9894,287,266.6327777777778,Document
Go,1835,11246,1784.802314814815,MERGED,114,189,16,0,3,44,False,0,0,0,9081,303,18.575277777777778,Document
Go,1835,11246,1783.9161458333335,MERGED,78,350,13,0,2,31,True,0,0,0,8191,428,17.135277777777777,Document
Go,1835,11246,1782.6739930555557,MERGED,78,602,23,0,2,16,False,0,0,0,11174,680,33.5475,Document
JavaScript,34,25,246.8140625,MERGED,127,17180,18,3,6,12,False,3,0,0,13033,17307,196.94194444444443,Bug
TypeScript,4803,40787,3810.465821759259,MERGED,1448,1173,88,1,4,150,True,0,1,1,12802,2621,1.5572222222222223,Bug
TypeScript,3393,2334,1020.9985069444446,MERGED,1580,531,58,1,18,8,False,0,1,1,16387,2111,189.8461111111111,Bug
Go,1835,11246,1779.8900694444444,MERGED,60,392,18,0,2,43,False,0,0,0,31413,452,71.87444444444445,Document
Go,30,295,409.91180555555553,MERGED,3,3,2,4,1,107,True,0,4,3,868,6,315.0802777777778,Bug
Vue,10808,21163,1081.010497685185,CLOSED,1,1,1,6,1,5,False,3,3,2,1183,2,961.8983333333333,Bug
TypeScript,2147,14724,1534.2822453703702,MERGED,6,12,1,0,1,4,False,0,0,0,1240,18,712.3336111111112,Feature
TypeScript,12,11,1052.4830324074073,MERGED,1155,3852,89,0,15,68,False,0,0,0,1674,5007,503.2680555555556,Bug
Python,547,7161,2301.701215277778,CLOSED,0,45,1,0,2,240,False,0,0,0,750,45,543.91,Document
PHP,1334,2960,4271.181851851852,MERGED,3,6,1,2,4,881,False,0,2,2,752,9,192.17083333333332,Feature
TypeScript,2147,14724,1536.0633796296297,MERGED,10,10,1,0,1,117,False,0,0,0,672,20,0.6066666666666667,Bug
PHP,1334,2960,4270.959583333333,MERGED,1,6,1,2,2,211,False,0,2,2,775,7,174.00555555555556,Feature
TypeScript,2147,14724,1535.1029513888889,MERGED,0,12,2,0,2,92,False,0,0,0,585,12,20.008333333333333,Bug
TypeScript,15,34,551.6209143518519,CLOSED,198,111,3,0,2,1044,False,0,0,0,334,309,194.65833333333333,Bug
TypeScript,85,724,379.2347222222222,MERGED,73,278,8,0,32,9,False,0,0,0,1917,351,309.8227777777778,Document
TypeScript,2147,14724,1536.1922685185184,MERGED,1,1,1,0,1,774,False,0,0,0,891,2,23.450555555555557,Feature
TypeScript,2147,14724,1533.3116203703703,MERGED,1,1,1,0,1,2,False,0,0,0,688,2,13.415277777777778,Feature
TypeScript,85,724,379.1729050925926,MERGED,1,1,1,0,1,194,False,0,0,0,1098,2,0.05472222222222222,Document
TypeScript,85,724,378.0552430555556,MERGED,1,0,1,0,1,43,False,0,0,0,1099,1,0.23277777777777778,Document
TypeScript,2147,14724,1530.2317824074073,MERGED,0,2,1,0,1,767,False,0,0,0,425,2,13.8175,Bug
TypeScript,2147,14724,1533.0971296296295,CLOSED,1,11,1,1,3,1,False,0,1,1,1109,12,89.11638888888889,Feature
TypeScript,85,724,377.15494212962966,MERGED,0,139,1,0,1,42,False,0,0,0,1193,139,19.212222222222223,Document
TypeScript,2147,14724,1532.8152314814815,MERGED,3,6,1,0,3,0,False,0,0,0,1135,9,93.89611111111111,Feature
TypeScript,2147,14724,1533.8516087962962,MERGED,3,3,1,0,3,3,False,0,0,0,1053,6,23.3175,Feature
TypeScript,12,11,1052.249513888889,MERGED,6,8,3,0,1,389,False,0,0,0,1801,14,119.21027777777778,Bug
TypeScript,2147,14724,1534.1403125,MERGED,0,16,1,0,1,5,False,0,0,0,823,16,0.6158333333333333,Document
V,2097,34362,1615.5122222222224,MERGED,5,5,1,1,1,47,True,0,1,1,763,10,7.473055555555556,Document
TypeScript,7,6,706.971863425926,MERGED,1,2,1,1,1,288,False,0,1,1,537,3,0.10805555555555556,Bug
TypeScript,2147,14724,1533.7794560185184,MERGED,7,2,1,0,1,686,False,0,0,0,1137,9,0.4091666666666667,Feature
TypeScript,2147,14724,1530.938912037037,MERGED,0,15,1,0,1,113,False,0,0,0,611,15,1.2358333333333333,Feature
TypeScript,58,78,878.3381481481482,MERGED,23,64,5,1,3,132,False,0,1,1,1167,87,120.34361111111112,Feature
Go,395,660,1327.019699074074,CLOSED,3,9,1,0,4,20,False,0,0,0,163,12,671.3894444444444,Feature
TypeScript,178,1359,380.55100694444445,CLOSED,2,6,1,2,1,22,True,0,2,2,951,8,54.260555555555555,Feature
TypeScript,2147,14724,1529.9955555555555,CLOSED,0,5,1,0,1,4,False,0,0,0,649,5,18.1775,Feature
TypeScript,58,78,884.2160069444444,MERGED,5,22,2,1,1,133,False,0,1,1,1615,27,20.01361111111111,Feature
PHP,1334,2960,4271.180914351852,MERGED,4,5,1,1,6,171,False,0,1,1,755,9,21.2375,Bug
TypeScript,2147,14724,1529.8305324074074,MERGED,0,1,1,0,1,762,False,0,0,0,660,1,8.677222222222222,Feature
JavaScript,5139,7051,1266.6418402777779,MERGED,1,1,1,1,1,111,False,0,1,1,653,2,0.4716666666666667,Document
C++,2234,23696,2418.849097222222,MERGED,1,22,2,3,9,61,False,1,2,2,588,23,28.198888888888888,Bug
TypeScript,2147,14724,1536.7415740740742,MERGED,6,6,3,0,1,202,False,0,0,0,1521,12,0.7169444444444445,Document
TypeScript,2147,14724,1536.2242592592593,MERGED,3,1,1,0,1,0,False,0,0,0,1387,4,59.80444444444444,Bug
Python,547,7161,2296.4355555555553,MERGED,3,5,1,1,2,239,False,1,0,0,643,8,74.23916666666666,Bug
Go,421,1654,1572.9780902777777,MERGED,13,1,1,0,1,250,False,0,0,0,1003,14,6.182777777777778,Bug
TypeScript,2147,14724,1531.0826041666667,MERGED,1,61,2,0,1,770,False,0,0,0,970,62,64.8488888888889,Feature
TypeScript,2147,14724,1531.038298611111,MERGED,6,17,2,1,1,115,False,0,1,1,1115,23,65.40083333333334,Feature
TypeScript,2147,14724,1530.9562268518519,MERGED,1,1,1,0,3,3,False,0,0,0,975,2,68.50333333333333,Document
Vue,10808,21163,1080.925798611111,MERGED,1,70,3,4,5,4,False,2,2,2,1679,71,945.9713888888889,Bug
TypeScript,261,3765,739.9157175925926,MERGED,5,13,2,0,1,226,True,0,0,0,1606,18,0.7755555555555556,Document
TypeScript,261,3765,739.8817476851851,MERGED,0,8,2,0,3,251,False,0,0,0,1522,8,0.3461111111111111,Document
TypeScript,261,3765,739.5297685185186,MERGED,1,1,1,0,1,281,True,0,0,0,1200,2,0.4086111111111111,Document
TypeScript,85,724,379.24442129629625,MERGED,1,1,1,0,2,44,False,0,0,0,1347,2,0.12083333333333333,Document
V,2097,34362,1614.4171412037037,MERGED,2,47,4,0,8,261,True,0,0,0,479,49,43.97361111111111,Bug
TypeScript,12,11,1051.5527893518517,MERGED,11,7,3,0,2,388,False,0,0,0,1704,18,0.49333333333333335,Bug
Vue,10808,21163,1081.123298611111,CLOSED,2,2,1,1,2,0,False,0,1,1,1564,4,895.0586111111111,Document
TypeScript,261,3765,738.8030671296297,MERGED,0,2,1,0,3,125,False,0,0,0,1071,2,16.0375,Document
TypeScript,2147,14724,1531.039722222222,MERGED,6,2,2,0,1,7,False,0,0,0,987,8,0.82,Document
TypeScript,7,6,706.9745138888889,MERGED,91,1174,13,1,39,239,False,1,0,0,1732,1265,514.1786111111111,Feature
TypeScript,2147,14724,1530.8226504629629,MERGED,2,4,2,0,1,182,False,0,0,0,827,6,4.342222222222222,Feature
TypeScript,85,724,372.8823611111111,MERGED,0,6,1,1,10,6,False,1,0,0,1061,6,35.16027777777778,Document
TypeScript,7046,76149,2691.581134259259,MERGED,1,22,4,3,1,109,False,0,3,2,540,23,0.8272222222222222,Bug
TypeScript,261,3765,738.4819907407408,MERGED,1,2,1,0,1,649,True,0,0,0,1183,3,0.23916666666666667,Document
Vue,10808,21163,1080.017361111111,MERGED,2,2,1,3,2,1,False,0,3,3,1242,4,907.1130555555555,Bug
TypeScript,2147,14724,1535.1855555555555,MERGED,31,39,2,0,1,57,False,0,0,0,1539,70,0.03361111111111111,Document
TypeScript,178,1359,381.23130787037036,MERGED,1,13,1,1,2,14,False,0,1,1,1157,14,114.66,Feature
TypeScript,85,724,373.0696643518518,MERGED,0,36,2,0,2,40,False,0,0,0,1325,36,3.783333333333333,Document
TypeScript,2147,14724,1530.1757407407406,MERGED,6,2,2,0,1,6,False,0,0,0,1033,8,0.4147222222222222,Document
TypeScript,2147,14724,1529.9838194444444,MERGED,3,9,1,0,2,56,False,0,0,0,958,12,5.016111111111111,Bug
TypeScript,2070,16643,1306.0757060185185,MERGED,2,18,1,0,3,0,False,0,0,0,2535,20,1063.615,Bug
TypeScript,261,3765,737.6769328703704,MERGED,15,27,2,0,3,648,True,0,0,0,1096,42,0.685,Document
TypeScript,7,6,709.0839236111111,CLOSED,2,0,1,0,1,241,False,0,0,0,855,2,0.1111111111111111,Feature
Vue,293,495,892.9903240740741,MERGED,2,6,1,2,1,415,False,0,2,2,760,8,0.12666666666666668,Bug
TypeScript,2147,14724,1529.8569097222223,MERGED,6,12,1,0,1,764,False,0,0,0,1011,18,7.994166666666667,Feature
TypeScript,261,3765,737.5172222222222,MERGED,3,28,2,0,1,1006,True,0,0,0,1508,31,0.7991666666666667,Document
Python,547,7161,2300.6785416666667,MERGED,0,1,1,0,1,310,True,0,0,0,677,1,0.009444444444444445,Bug
TypeScript,261,3765,739.8819907407407,CLOSED,93,10,3,1,1,50,False,0,1,1,1270,103,0.9347222222222222,Document
TypeScript,12,11,1052.593101851852,MERGED,2,14,4,0,8,13,False,0,0,0,1843,16,16.053055555555556,Feature
F#,153,337,2982.31931712963,MERGED,1,3,1,0,1,34,False,0,0,0,1062,4,45.85444444444445,Bug
V,2097,34362,1611.4455439814817,MERGED,3,3,3,1,3,259,True,0,1,1,463,6,42.04055555555556,Bug
JavaScript,8844,63474,4136.706423611111,CLOSED,0,5,1,1,1,0,False,0,1,1,1083,5,236.99305555555554,Feature
Vue,10808,21163,1084.8584027777777,MERGED,5,24,2,2,8,18,False,1,1,1,12444,29,577.8675,Bug
TypeScript,7,6,707.1643055555555,CLOSED,23602,13967,2,1,2,289,False,1,0,0,998,37569,42.689166666666665,Document
TypeScript,7046,76149,2691.519108796296,MERGED,2,2,2,3,1,108,False,0,3,2,835,4,5.982777777777778,Feature
Python,547,7161,2300.455601851852,MERGED,9,381,3,2,17,2,False,1,1,1,932,390,168.52305555555554,Bug
TypeScript,85,724,374.4216550925926,MERGED,0,25,2,0,3,7,False,0,0,0,1367,25,60.624722222222225,Document
TypeScript,261,3765,739.9009027777778,MERGED,5,10,2,0,2,126,False,0,0,0,1805,15,14.019722222222223,Document
JavaScript,5139,7051,1267.5821643518518,MERGED,3,101,4,2,9,273,False,1,1,1,1610,104,123.95722222222223,Feature
TypeScript,261,3765,739.7513657407408,MERGED,12,33,6,0,2,205,False,0,0,0,2082,45,0.6605555555555556,Document
TypeScript,261,3765,738.8579282407408,MERGED,52,86,6,0,10,204,False,0,0,0,1821,138,44.71361111111111,Document
TypeScript,12,11,1051.4108333333334,MERGED,8,8,2,0,3,66,False,0,0,0,1900,16,1.0066666666666666,Feature
TypeScript,85,724,379.2615393518518,MERGED,10,26,4,0,1,17,False,0,0,0,2432,36,0.5366666666666666,Document
TypeScript,202,107,1203.7101273148148,MERGED,1,1,1,3,2,275,True,0,3,3,691,2,93.69972222222222,Bug
PHP,1334,2960,4269.936342592592,MERGED,5,8,1,1,4,170,False,0,1,1,1226,13,53.606944444444444,Bug
TypeScript,2147,14724,1531.1337962962962,MERGED,8,5,1,0,1,316,False,0,0,0,1411,13,65.69833333333334,Feature
TypeScript,2147,14724,1530.8369907407407,MERGED,2,13,2,0,2,0,False,0,0,0,1422,15,70.81083333333333,Feature
TypeScript,202,107,1202.6812152777777,MERGED,1,3,1,3,1,274,True,0,3,3,684,4,118.40333333333334,Bug
TypeScript,261,3765,738.7625347222223,MERGED,15,37,12,0,2,280,True,0,0,0,1747,52,3.6869444444444444,Document
TypeScript,85,724,378.2899537037037,MERGED,4,6,1,0,3,8,False,0,0,0,1915,10,16.381666666666668,Document
Go,421,1654,1571.2297916666666,MERGED,31,27,1,0,1,71,False,0,0,0,1600,58,41.125,Bug
TypeScript,261,3765,738.7216782407407,MERGED,560,0,9,0,1,1013,True,0,0,0,2237,560,0.55,Document
TypeScript,261,3765,738.6537615740741,MERGED,6,4,5,0,4,248,False,0,0,0,1955,10,0.32222222222222224,Document
Python,19251,70266,2523.769513888889,CLOSED,74,75,30,5,2,1641,False,2,3,1,390,149,66.70222222222222,Feature
PHP,1334,2960,4269.192696759259,MERGED,7,8,2,1,4,169,False,0,1,1,1216,15,48.79833333333333,Document
TypeScript,85,724,378.2304513888889,MERGED,12,146,6,0,3,117,False,0,0,0,2308,158,0.42083333333333334,Document
TypeScript,85,724,377.9969675925926,MERGED,11,136,5,0,4,114,False,0,0,0,2501,147,0.9527777777777777,Document
TypeScript,261,3765,733.9494907407408,MERGED,5,11,3,0,2,276,True,0,0,0,1293,16,0.33611111111111114,Document
Go,752,2399,790.7296412037036,MERGED,0,55,1,0,2,154,False,0,0,0,1161,55,23.449444444444445,Bug
TypeScript,261,3765,733.8441782407408,MERGED,6,6,1,0,1,646,True,0,0,0,1233,12,0.2972222222222222,Document
TypeScript,261,3765,733.8437962962963,MERGED,2,66,2,0,1,1001,True,0,0,0,1616,68,0.1325,Document
TypeScript,261,3765,737.8721643518519,MERGED,1,8,2,0,1,1012,True,0,0,0,2007,9,11.386666666666667,Document
TypeScript,261,3765,733.629988425926,MERGED,1,2,1,0,1,645,True,0,0,0,1213,3,0.3413888888888889,Document
TypeScript,261,3765,733.6067361111112,MERGED,1,4,1,0,1,644,True,0,0,0,1469,5,0.16166666666666665,Document
TypeScript,261,3765,733.5138425925926,MERGED,2,2,2,3,2,0,False,1,2,1,1084,4,0.23916666666666667,Document
TypeScript,261,3765,737.5066898148148,MERGED,1,9,3,0,1,1005,True,0,0,0,1596,10,0.3,Document
TypeScript,261,3765,737.4554513888888,MERGED,2,7,3,0,3,0,False,0,0,0,1724,9,0.6925,Document
TypeScript,2147,14724,1529.9977546296295,MERGED,5,9,1,0,1,198,False,0,0,0,1632,14,1.6288888888888888,Feature
Python,547,7161,2301.76599537037,MERGED,96,33,14,0,1,311,True,0,0,0,1028,129,0.09166666666666666,Bug
Python,547,7161,2296.5726967592595,MERGED,11,10,3,0,6,245,False,0,0,0,717,21,1.5438888888888889,Bug
Python,547,7161,2296.356446759259,MERGED,59,9,1,0,3,243,False,0,0,0,608,68,2.5058333333333334,Bug
JavaScript,5139,7051,1266.6451851851853,MERGED,9,5,3,1,2,136,False,0,1,1,1355,14,1.9691666666666667,Feature
TypeScript,2147,14724,1533.9378587962963,MERGED,14,9,2,0,1,116,False,0,0,0,2126,23,0.8652777777777778,Feature
F#,153,337,2980.4808796296297,MERGED,2,3,2,0,2,40,False,0,0,0,1227,5,4.567222222222222,Feature
Vue,10808,21163,1085.139849537037,CLOSED,1,4,2,2,1,11,False,1,1,1,1343,5,13.633055555555556,Bug
TypeScript,202,107,1205.825011574074,MERGED,14,9,2,3,2,278,True,0,3,3,1174,23,42.89416666666666,Bug
Vue,10808,21163,1084.9976736111112,MERGED,2,0,1,0,1,407,False,0,0,0,1151,2,0.19111111111111112,Bug
JavaScript,5139,7051,1265.671689814815,MERGED,2,15,3,2,2,329,False,1,1,1,1731,17,22.4525,Bug
TypeScript,12,11,1047.2314583333334,MERGED,15,113,12,0,12,386,False,0,0,0,1791,128,76.65305555555555,Bug
JavaScript,5139,7051,1265.5233101851852,MERGED,3,3,2,3,1,272,False,1,2,2,1258,6,28.252777777777776,Bug
Vue,293,495,887.6768518518519,MERGED,291,0,5,3,3,180,True,0,3,2,538,291,0.8466666666666667,Bug
Java,1,10,291.11251157407406,MERGED,0,4,1,1,1,0,False,0,1,1,1497,4,0.008611111111111111,Document
Python,547,7161,2295.6321875,MERGED,19,19,1,0,1,308,True,0,0,0,717,38,0.019166666666666665,Bug
Vue,293,495,890.7567592592592,MERGED,4,13,2,5,3,413,False,1,4,3,1032,17,29.471944444444443,Bug
JavaScript,5139,7051,1267.8700925925925,MERGED,23,301,25,1,6,333,False,0,1,1,217,324,113.28444444444445,Document
F#,153,337,2982.890196759259,MERGED,2,275,4,1,1,0,False,0,1,1,2278,277,32.15972222222222,Bug
TypeScript,2147,14724,1531.1665972222224,MERGED,20,367,4,0,1,317,False,0,0,0,1992,387,62.94166666666667,Document
TypeScript,7,6,708.0899768518519,MERGED,1886,2571,76,1,122,301,False,0,1,1,473,4457,217.45527777777778,Feature
Go,395,660,1327.132800925926,CLOSED,17,105,3,1,1,21,False,0,1,1,438,122,329.3616666666667,Feature
PHP,1334,2960,4265.9960879629625,CLOSED,20,53,3,1,4,168,False,0,1,1,1654,73,3.8966666666666665,Bug
TypeScript,261,3765,734.5247800925927,MERGED,0,54,4,0,1,1003,True,0,0,0,1846,54,0.049166666666666664,Document
Java,1,10,293.12221064814815,MERGED,0,1,1,0,1,14,False,0,0,0,1677,1,0.009444444444444445,Document
TypeScript,12,11,1051.466064814815,MERGED,86,356,3,0,2,183,False,0,0,0,2918,442,40.535555555555554,Feature
Python,547,7161,2295.6682291666666,MERGED,4,14,5,0,3,39,False,0,0,0,1621,18,1.3875,Document
Go,421,1654,1566.922025462963,MERGED,31,31,2,0,1,482,True,0,0,0,1794,62,31.005,Bug
TypeScript,261,3765,733.8022453703703,MERGED,3,13,4,0,1,1000,True,0,0,0,2138,16,3.9341666666666666,Document
TypeScript,2147,14724,1535.7779398148148,MERGED,18,39,3,0,1,772,False,0,0,0,3666,57,33.403055555555554,Document
TypeScript,261,3765,739.8606828703704,MERGED,80,87,8,0,1,283,True,0,0,0,2758,167,0.48388888888888887,Document
TypeScript,261,3765,733.6882754629629,MERGED,9,12,4,0,1,117,True,0,0,0,1914,21,0.41888888888888887,Document
PHP,1334,2960,4265.097627314814,MERGED,12,3,1,1,3,167,False,0,1,1,1588,15,1.6366666666666667,Feature
TypeScript,261,3765,739.6692708333334,MERGED,61,87,9,0,1,282,True,0,0,0,2850,148,1.803611111111111,Document
TypeScript,2147,14724,1530.2234606481481,MERGED,11,82,2,0,1,313,False,0,0,0,2206,93,12.729444444444445,Feature
TypeScript,2147,14724,1536.1461458333333,MERGED,53,82,4,0,1,773,False,0,0,0,3075,135,0.8630555555555556,Document
Vue,10808,21163,1082.0041319444445,MERGED,2,2,2,0,2,150,True,0,0,0,1087,4,0.2602777777777778,Bug
Python,547,7161,2296.4274189814814,CLOSED,1,1,1,0,2,244,False,0,0,0,849,2,0.11555555555555555,Bug
V,2097,34362,1610.604675925926,MERGED,6,60,2,4,1,256,True,1,3,2,1077,66,10.659444444444444,Bug
TypeScript,2147,14724,1530.0665046296297,MERGED,8,152,5,0,1,766,False,0,0,0,2199,160,2.948888888888889,Feature
Java,1,10,291.8383101851852,MERGED,0,1,1,0,1,3,False,0,0,0,1601,1,0.03611111111111111,Document
Java,1,10,291.8333333333333,MERGED,0,2,1,0,1,1,False,0,0,0,1936,2,0.025277777777777777,Document
JavaScript,5139,7051,1266.729722222222,MERGED,21,104,21,2,4,332,False,1,1,1,159,125,21.16,Document
Rust,433,2229,298.04309027777776,MERGED,5,9,2,0,1,1079,False,0,0,0,225,14,1.3205555555555555,Bug
TypeScript,2147,14724,1529.8424305555554,MERGED,2,11,2,0,1,763,False,0,0,0,1791,13,8.358611111111111,Feature
TypeScript,2147,14724,1530.9989699074074,MERGED,12,40,3,9,1,114,False,2,7,1,2865,52,0.7561111111111111,Feature
TypeScript,261,3765,738.8106481481482,MERGED,64,97,5,0,8,250,False,0,0,0,2720,161,15.5975,Document
Python,547,7161,2295.8483796296296,MERGED,65,43,6,0,4,242,False,0,0,0,753,108,0.5602777777777778,Document
C++,2234,23696,2418.8549189814817,MERGED,1,16,2,1,2,19,False,0,1,1,1216,17,73.68611111111112,Feature
TypeScript,261,3765,738.5375347222222,MERGED,4,19,4,0,2,119,True,0,0,0,2320,23,26.68166666666667,Document
F#,153,337,2980.0610879629626,MERGED,6,6,2,0,1,32,False,0,0,0,2466,12,0.5344444444444445,Bug
Vue,293,495,887.5247106481482,MERGED,0,4,1,5,1,73,False,1,4,4,1055,4,6.9875,Bug
Go,54,354,791.2186805555556,MERGED,10,2,1,0,1,77,True,0,0,0,658,12,0.3138888888888889,Feature
TypeScript,85,724,378.22767361111113,MERGED,45,52,4,0,2,116,False,0,0,0,3085,97,0.185,Document
Rust,433,2229,297.5790856481481,MERGED,6,6,3,1,1,1076,False,1,0,0,233,12,1.3566666666666667,Bug
TypeScript,261,3765,738.7943171296297,MERGED,18,16,3,0,1,1014,True,0,0,0,2747,34,0.5161111111111111,Document
TypeScript,261,3765,738.6640277777778,MERGED,10,12,2,0,2,120,True,0,0,0,2390,22,0.07972222222222222,Document
Go,752,2399,785.5140972222222,MERGED,0,3,1,0,1,152,False,0,0,0,907,3,0.8211111111111111,Bug
F#,153,337,2979.8051504629634,MERGED,98,0,2,0,1,31,False,0,0,0,1795,98,0.6341666666666667,Bug
Go,752,2399,785.488900462963,MERGED,0,3,1,0,1,150,False,0,0,0,862,3,0.07444444444444444,Bug
F#,153,337,2979.6953819444443,MERGED,4,77,3,1,3,2,False,0,1,1,1827,81,1.5616666666666668,Document
F#,153,337,2979.5945601851854,MERGED,0,152,4,1,1,39,False,0,1,1,2081,152,1.0791666666666666,Document
Go,30,295,407.26800925925926,MERGED,1,1,1,7,1,0,False,0,7,2,1129,2,44.0725,Document
V,2097,34362,1610.3060532407408,CLOSED,42,0,2,2,5,0,False,0,2,2,1703,42,320.8938888888889,Feature
JavaScript,5139,7051,1265.8543055555556,MERGED,1,107,3,3,5,331,False,1,2,2,164,108,20.81888888888889,Feature
JavaScript,22,26,976.0652199074075,MERGED,2,7,1,0,1,22,True,0,0,0,215,9,0.10222222222222223,Feature
JavaScript,5139,7051,1261.507627314815,MERGED,5,37,6,2,2,271,False,0,2,2,1822,42,10.160277777777777,Feature
TypeScript,7,6,706.0672106481483,MERGED,67,237,10,0,23,237,False,0,0,0,2099,304,261.63166666666666,Feature
JavaScript,5139,7051,1261.6461574074074,MERGED,4,51,1,1,2,110,False,0,1,1,1582,55,0.12916666666666668,Document
PHP,1334,2960,4264.956724537037,MERGED,47,99,5,1,18,166,False,0,1,1,2043,146,126.85388888888889,Document
JavaScript,9664,43890,3721.457696759259,CLOSED,15,18,3,0,10,13,False,0,0,0,326,33,0.09361111111111112,Feature
TypeScript,202,107,1207.6606597222224,CLOSED,57,64,1,2,4,16,True,0,2,2,1729,121,21.176666666666666,Document
Python,19251,70266,2518.7669791666667,CLOSED,6,21,1,5,4,154,False,5,0,0,273,27,93.17944444444444,Bug
JavaScript,9664,43890,3721.1468402777778,MERGED,1,1,1,0,1,304,True,0,0,0,350,2,0.006944444444444444,Bug
TypeScript,261,3765,737.6653472222223,MERGED,9,17,3,0,1,224,True,0,0,0,3076,26,0.2513888888888889,Document
TypeScript,261,3765,737.6395138888888,MERGED,1,21,7,0,2,1008,True,0,0,0,2350,22,0.4652777777777778,Document
TypeScript,261,3765,737.5311921296296,MERGED,6,16,3,0,1,1007,True,0,0,0,2345,22,1.33,Document
TypeScript,261,3765,737.5464699074074,MERGED,17,38,3,0,3,246,False,0,0,0,3015,55,0.3447222222222222,Document
TypeScript,261,3765,737.5162152777779,MERGED,2,24,5,0,2,647,True,0,0,0,2367,26,0.48,Document
Vue,10808,21163,1085.8461342592593,MERGED,3,4,3,2,1,3,False,1,1,1,1667,7,23.43888888888889,Bug
TypeScript,7,6,703.8517476851852,MERGED,8,16,1,0,2,31,False,0,0,0,1814,24,64.95694444444445,Feature
Go,395,660,1327.9425925925925,MERGED,203,178,3,0,6,35,False,0,0,0,413,381,147.74972222222223,Bug
TypeScript,15,34,551.474699074074,MERGED,8,9,3,0,1,188,False,0,0,0,263,17,0.6197222222222222,Bug
TypeScript,15,34,551.4534143518518,MERGED,2,2,1,0,1,366,False,0,0,0,216,4,1.1169444444444445,Feature
TypeScript,15,34,551.3064467592593,MERGED,13,14,1,0,1,365,False,0,0,0,258,27,0.4683333333333333,Feature
TypeScript,7,6,703.1756597222221,CLOSED,86,89,1,1,8,287,False,1,0,0,1721,175,73.265,Bug
TypeScript,3393,2334,1026.075625,MERGED,424,113,1,1,1,165,False,0,1,1,226,537,0.2513888888888889,Feature
TypeScript,2147,14724,1531.0473032407408,MERGED,60,6543,14,1,2,199,False,0,1,1,3358,6603,74.79611111111112,Document
Python,547,7161,2296.4122337962963,MERGED,509,850,19,6,56,11,False,2,4,1,2177,1359,846.3269444444444,Bug
TypeScript,2147,14724,1530.012337962963,MERGED,102,135,4,2,2,765,False,1,1,1,3044,237,94.54333333333334,Document
TypeScript,7,6,702.1275115740741,CLOSED,2,92,2,0,3,286,False,0,0,0,1718,94,115.70555555555555,Feature
Java,450,746,4135.180115740741,MERGED,28,81,1,0,2,161,False,0,0,0,1754,109,26.149444444444445,Bug
TypeScript,2147,14725,1530.8086226851854,MERGED,27,39,2,0,1,314,False,0,0,0,2683,66,118.15416666666667,Feature
Go,421,1654,1573.1714467592592,MERGED,9,9,5,0,1,486,True,0,0,0,2367,18,0.5875,Document
V,2097,34361,1614.360486111111,MERGED,1,1,1,0,1,10,False,0,0,0,1349,2,0.32555555555555554,Document
C++,363,552,600.091099537037,MERGED,44,46,5,0,1,275,False,0,0,0,1680,90,52.67805555555555,Document
TypeScript,307,2556,600.6332291666666,MERGED,2,1,1,2,1,22,True,1,1,1,1261,3,48.37888888888889,Bug
C#,655,7879,1892.2690393518517,MERGED,0,5,1,1,1,1523,True,0,1,1,667,5,7.608055555555556,Bug
Java,450,746,4134.125451388889,MERGED,12,39,4,1,3,88,True,0,1,1,1325,51,47.00222222222222,Document
PHP,1334,2960,4265.113923611111,MERGED,1,1,1,1,1,90,False,0,1,1,1603,2,0.27166666666666667,Document
TypeScript,15,34,553.4178819444445,MERGED,8,39,2,0,1,370,False,0,0,0,375,47,0.4363888888888889,Bug
TypeScript,2147,14725,1531.0470833333331,MERGED,3,324,3,0,1,769,False,0,0,0,2248,327,65.71,Bug
C#,655,7879,1892.1570601851852,MERGED,1,1,1,4,1,230,True,0,4,2,619,2,1.4619444444444445,Document
TypeScript,41369,87416,3000.49369212963,MERGED,1,1,1,4,3,0,False,1,3,3,1330,2,2.1863888888888887,Document
TypeScript,307,2556,599.857800925926,MERGED,1,5,1,0,1,203,True,0,0,0,1246,6,67.61111111111111,Bug
TypeScript,7,6,703.2805092592592,MERGED,1611,2122,7,0,5,300,False,0,0,0,343,3733,14.84388888888889,Feature
JavaScript,9664,43890,3719.0811805555554,CLOSED,1,1,1,0,1,292,True,0,0,0,365,2,0.021111111111111112,Bug
Go,395,660,1327.9217476851852,MERGED,88,63,2,1,3,79,False,1,0,0,285,151,51.060833333333335,Feature
Python,19251,70266,2518.770520833333,CLOSED,52,2,5,2,3,155,False,2,0,0,309,54,136.22666666666666,Document
TypeScript,202,107,1203.7235648148148,MERGED,14,12,1,3,2,276,True,0,3,3,1487,26,93.36805555555556,Bug
JavaScript,9664,43890,3721.1524652777775,MERGED,10,13,2,0,9,12,False,0,0,0,463,23,6.137222222222222,Feature
TypeScript,307,2556,599.6599768518519,MERGED,1,1,1,1,1,26,False,0,1,1,890,2,48.21361111111111,Bug
TypeScript,15,34,552.665,MERGED,1,5,1,0,1,369,False,0,0,0,306,6,1.1977777777777778,Bug
JavaScript,9664,43890,3721.023541666667,MERGED,1370,227,11,0,1,302,True,0,0,0,469,1597,2.7422222222222223,Feature
Java,1,10,293.0670138888889,MERGED,7,6,1,0,1,5,False,0,0,0,2379,13,0.035,Document
TypeScript,15,34,552.472511574074,MERGED,2,2,2,0,1,517,True,0,0,0,315,4,0.8319444444444445,Bug
TypeScript,140,827,811.1641782407409,MERGED,2,27,5,3,4,129,False,1,2,2,398,29,47.93944444444445,Document
TypeScript,261,3765,734.7187268518519,MERGED,9,11,2,0,2,203,False,0,0,0,3136,20,1.4805555555555556,Document
JavaScript,5139,7051,1267.720787037037,CLOSED,676,4110,146,1,36,0,False,0,1,1,1634,4786,0.2980555555555556,Feature
Go,395,660,1326.9307060185185,CLOSED,34,132,5,0,4,19,False,0,0,0,397,166,192.1497222222222,Feature
TypeScript,15,34,551.6896875,MERGED,1,38,2,0,1,368,False,0,0,0,317,39,16.55666666666667,Feature
C++,2234,23696,2419.4518981481483,MERGED,85,211,4,1,23,9,False,0,1,1,2168,296,71.64916666666667,Feature
TypeScript,307,2556,599.6573958333333,CLOSED,1,1,1,0,1,25,False,0,0,0,989,2,0.013333333333333334,Bug
JavaScript,5139,7051,1265.9913078703705,MERGED,20,651,13,3,7,91,False,2,1,1,3172,671,85.83305555555556,Feature
JavaScript,9664,43890,3720.186944444444,MERGED,1,0,1,0,1,300,True,0,0,0,406,1,0.1836111111111111,Feature
TypeScript,85,724,373.1849652777778,MERGED,0,6,1,0,1,190,False,0,0,0,1809,6,0.23194444444444445,Document
JavaScript,9664,43890,3720.129641203704,MERGED,44,26,26,0,1,299,True,0,0,0,469,70,0.8561111111111112,Feature
TypeScript,261,3765,733.6669097222222,MERGED,3,86,6,0,5,244,False,0,0,0,2526,89,19.718333333333334,Document
JavaScript,9664,43890,3720.115636574074,MERGED,34,18,19,0,1,298,True,0,0,0,480,52,0.16472222222222221,Feature
Python,137,75,743.2879398148148,MERGED,0,154,7,0,16,0,False,0,0,0,592,154,339.6980555555556,Document
JavaScript,9664,43890,3719.8849884259257,MERGED,2,14,1,0,1,297,True,0,0,0,467,16,0.1425,Bug
JavaScript,9664,43890,3719.8698148148146,MERGED,14,12,3,0,1,296,True,0,0,0,440,26,0.25916666666666666,Bug
TypeScript,41369,87416,3000.940173611111,CLOSED,6,5,5,2,3,30,False,0,2,2,2924,11,1.8575,Document
TypeScript,15,34,553.5679398148148,MERGED,4,91,4,0,1,371,False,0,0,0,448,95,1.0261111111111112,Bug
JavaScript,5139,7051,1265.8402199074073,MERGED,20,1209,12,2,9,101,False,1,1,1,2755,1229,42.5025,Feature
TypeScript,15,34,547.5225462962964,MERGED,8,0,1,0,1,71,False,0,0,0,180,8,0.6702777777777778,Feature
C#,80,125,881.780300925926,MERGED,205,12566,152,0,71,101,False,0,0,0,1443,12771,379.92833333333334,Document
JavaScript,9664,43890,3719.1382870370367,MERGED,5,5,3,0,1,294,True,0,0,0,460,10,0.22055555555555556,Bug
JavaScript,9664,43890,3719.081990740741,MERGED,1,1,1,0,1,293,True,0,0,0,391,2,0.13194444444444445,Bug
JavaScript,9664,43890,3719.0377083333333,MERGED,18,12,1,0,1,290,True,0,0,0,413,30,0.9941666666666666,Bug
Python,19251,70266,2518.5800462962966,CLOSED,1,1,1,1,1,1637,False,1,0,0,366,2,2.8608333333333333,Bug
JavaScript,9664,43890,3718.8757638888887,CLOSED,0,2,1,0,1,286,True,0,0,0,416,2,0.0225,Feature
PHP,883,2338,1895.0019444444445,CLOSED,11,11,2,1,2,17,False,1,0,0,1883,22,1.0825,Document
TypeScript,2070,16643,1300.0785069444444,MERGED,7,9,3,2,1,13,True,1,1,1,3113,16,582.6383333333333,Bug
PHP,883,2338,1894.9119212962962,CLOSED,0,4,1,2,1,0,False,0,2,2,1822,4,0.7958333333333333,Document
Go,2083,11770,1580.0189583333333,MERGED,0,4,4,0,1,936,True,0,0,0,1682,4,0.10472222222222222,Document
Vue,10808,21163,1080.9138541666666,CLOSED,6,11,1,1,1,3,False,0,1,1,1821,17,0.07194444444444445,Bug
F#,153,337,2978.8439583333334,MERGED,26,73,2,1,1,29,False,0,1,1,2780,99,9.494722222222222,Bug
TypeScript,1297,21107,478.6581712962963,CLOSED,1023,1511,4,1,1,1129,True,0,1,1,1833,2534,0.1025,Document
TypeScript,261,3765,739.6072685185185,MERGED,4,10,2,0,2,147,True,0,0,0,1444,14,0.6188888888888889,Document
Go,752,2399,785.5102893518518,CLOSED,1,6,2,0,2,151,False,0,0,0,1315,7,0.02388888888888889,Bug
TypeScript,15,34,548.3922222222222,MERGED,11,15,1,0,1,515,True,0,0,0,295,26,67.85722222222222,Feature
V,2097,34361,1614.6509837962965,MERGED,8,21,7,1,4,226,True,0,1,1,1703,29,13.551111111111112,Document
Vue,10808,21163,1080.3011458333333,MERGED,6,27,1,0,1,406,False,0,0,0,1532,33,4.7252777777777775,Bug
Python,137,75,743.0979398148148,MERGED,0,1062,42,0,24,27,False,0,0,0,1480,1062,1034.6322222222223,Document
TypeScript,15,34,548.8338078703704,MERGED,76,114,9,0,2,364,False,0,0,0,353,190,2.339722222222222,Bug
TypeScript,12,11,1050.4531712962964,MERGED,136,759,6,0,31,182,False,0,0,0,3619,895,68.64805555555556,Bug
TypeScript,1297,21107,477.6473379629629,MERGED,1,1,1,1,2,0,False,0,1,1,1717,2,0.6894444444444444,Document
Go,2083,11770,1578.7925231481483,MERGED,5,5,5,0,1,933,True,0,0,0,1852,10,0.13083333333333333,Document
JavaScript,9664,43890,3721.1382060185188,MERGED,1,16,1,0,1,68,True,0,0,0,560,17,0.24944444444444444,Document
Erlang,2054,12122,3859.306134259259,MERGED,14,235,5,0,3,411,False,0,0,0,1490,249,48.564166666666665,Document
JavaScript,9664,43890,3715.865810185185,MERGED,12,14,1,0,2,282,True,0,0,0,373,26,71.9888888888889,Bug
TypeScript,85,724,379.0586458333333,MERGED,7,16,6,0,2,193,False,0,0,0,3695,23,2.171388888888889,Document
TypeScript,41369,87416,2995.833668981482,MERGED,2,2,1,1,1,21,False,0,1,1,1246,4,2.075833333333333,Document
TypeScript,41369,87416,2995.747627314815,MERGED,4,3,2,3,2,20,False,1,2,2,1512,7,0.9041666666666667,Document
TypeScript,7,6,708.9223842592593,MERGED,46,54,7,0,7,40,True,0,0,0,3515,100,120.28111111111112,Feature
TypeScript,12,11,1050.4350925925926,MERGED,9,581,5,1,1,65,False,1,0,0,3419,590,46.67111111111111,Feature
Java,450,746,4136.3115625,MERGED,13,429,8,0,5,40,False,0,0,0,855,442,22.595277777777778,Document
TypeScript,1297,21107,475.78812500000004,CLOSED,5,3,2,1,4,0,False,0,1,1,1890,8,75.5038888888889,Document
Python,137,75,747.217662037037,CLOSED,0,27,2,1,5,6,False,0,1,1,1205,27,811.1911111111111,Document
TypeScript,15,34,547.5341782407407,MERGED,106,259,9,0,8,362,False,0,0,0,491,365,172.2602777777778,Feature
JavaScript,9664,43890,3720.076400462963,CLOSED,0,0,0,3,0,0,False,2,1,1,531,0,22.84861111111111,Feature
TypeScript,261,3765,739.7282407407407,MERGED,19,87,8,0,3,225,True,0,0,0,3969,106,1.1194444444444445,Document
TypeScript,41369,87416,2994.808912037037,MERGED,2,2,1,5,1,19,False,1,4,3,1289,4,19.966944444444444,Document
JavaScript,9664,43890,3716.1226851851848,MERGED,2,2,2,0,2,284,True,0,0,0,440,4,0.11333333333333333,Bug
JavaScript,9664,43890,3716.096678240741,MERGED,6,1,1,0,1,283,True,0,0,0,475,7,0.03222222222222222,Feature
TypeScript,41369,87416,2994.7337152777777,MERGED,2,2,2,1,1,3,False,0,1,1,1241,4,1.801388888888889,Document
TypeScript,41369,87416,2999.970462962963,MERGED,4,9,1,1,1,78,True,0,1,1,2172,13,0.695,Document
JavaScript,9664,43890,3719.841481481482,MERGED,3,1,1,0,1,295,True,0,0,0,610,4,0.1675,Feature
JavaScript,5140,7051,1267.7348842592594,MERGED,16,27,5,1,2,0,False,0,1,1,2103,43,20.58361111111111,Feature
JavaScript,9664,43890,3715.8645601851854,CLOSED,13,18,1,0,1,281,True,0,0,0,373,31,0.024166666666666666,Bug
TypeScript,15,34,547.2900578703703,MERGED,51,61,2,0,1,513,True,0,0,0,355,112,0.3463888888888889,Feature
TypeScript,41369,87416,2994.4589699074077,MERGED,1,4,1,1,1,17,False,0,1,1,1034,5,0.3819444444444444,Document
Java,450,746,4129.4177314814815,MERGED,18,0,1,1,3,38,False,0,1,1,578,18,110.61333333333333,Feature
TypeScript,261,3765,738.721550925926,MERGED,14,77,9,0,3,124,False,0,0,0,3409,91,0.44583333333333336,Document
JavaScript,9664,43890,3718.8682060185183,MERGED,87,87,1,1,3,0,False,0,1,1,533,174,29.051666666666666,Feature
V,2097,34361,1612.397951388889,MERGED,0,19,4,0,3,225,True,0,0,0,1851,19,4.166944444444445,Document
TypeScript,12,11,1048.2936805555555,MERGED,34,150,6,1,12,387,False,1,0,0,4058,184,77.54861111111111,Bug
JavaScript,9664,43890,3718.896620370371,CLOSED,10,18,1,0,1,287,True,0,0,0,541,28,1.8658333333333332,Feature
Java,450,746,4134.113703703703,MERGED,23,31,2,0,2,18,False,0,0,0,740,54,46.278888888888886,Feature
TypeScript,41369,87416,3000.7933564814816,CLOSED,2,2,1,5,2,1,False,1,4,2,2202,4,308.0283333333333,Document
JavaScript,9664,43890,3719.0515625000003,MERGED,5,24,2,0,1,291,True,0,0,0,573,29,0.3947222222222222,Feature
TypeScript,202,107,1202.6315393518519,MERGED,36,113,4,5,4,73,True,1,4,3,3218,149,475.90222222222224,Document
JavaScript,9664,43890,3718.9921875,MERGED,2,19,4,0,2,67,True,0,0,0,471,21,0.9291666666666667,Feature
TypeScript,41369,87416,2994.8607638888893,MERGED,13,23,2,1,4,33,False,0,1,1,2102,36,21.202222222222222,Document
V,2097,34361,1611.4399305555555,MERGED,1,75,5,0,1,258,True,0,0,0,1763,76,23.18,Bug
JavaScript,5140,7051,1261.0625925925926,MERGED,21,548,9,5,11,104,False,1,4,2,2991,569,40.76166666666666,Feature
Java,450,746,4131.100393518519,MERGED,8,16,4,1,2,160,False,0,1,1,1965,24,70.52416666666667,Bug
JavaScript,9664,43890,3718.7254398148148,MERGED,2,19,2,0,1,325,True,0,0,0,605,21,0.16694444444444445,Bug
TypeScript,261,3765,737.7102083333333,MERGED,0,327,19,0,5,1010,True,0,0,0,3117,327,2.1238888888888887,Document
TypeScript,261,3765,737.6625578703703,MERGED,30,40,13,0,2,1009,True,0,0,0,4593,70,0.6180555555555556,Document
Go,2083,11770,1578.8047337962962,MERGED,0,38,2,0,1,934,True,0,0,0,1960,38,124.6061111111111,Document
TypeScript,15,34,547.283587962963,MERGED,31,88,7,1,4,148,False,0,1,1,475,119,30.485833333333332,Bug
JavaScript,9664,43890,3716.1067708333335,MERGED,1,1,1,1,1,0,False,0,1,1,586,2,88.96861111111112,Bug
TypeScript,3393,2334,1025.8300462962964,MERGED,17,18,1,2,1,494,False,0,2,1,806,35,76.16111111111111,Feature
Java,450,746,4131.274988425926,MERGED,3,35,4,1,2,17,False,0,1,1,656,38,67.08305555555556,Feature
Go,2083,11770,1579.7743171296297,MERGED,1,4,2,0,1,935,True,0,0,0,2136,5,0.2861111111111111,Document
V,2097,34361,1609.3679050925928,CLOSED,2,22,2,1,1,224,True,1,0,0,1679,24,42.216944444444444,Document
Erlang,2054,12122,3853.2429976851854,CLOSED,263,311,11,0,2,87,False,0,0,0,939,574,333.69944444444445,Document
C#,80,125,882.5287615740741,MERGED,26,739,38,0,24,226,False,0,0,0,964,765,189.1063888888889,Document
Python,137,75,744.863287037037,MERGED,19,8,3,0,2,101,False,0,0,0,1394,27,1.6541666666666666,Bug
TypeScript,15,34,547.4489814814815,MERGED,77,779,36,0,29,514,True,0,0,0,470,856,163.12027777777777,Bug
TypeScript,2147,14725,1530.9663078703704,MERGED,31,57,7,0,1,685,False,0,0,0,4521,88,3.2525,Document
TypeScript,15,34,547.632824074074,MERGED,2,24671,3,0,3,187,False,0,0,0,547,24673,132.5211111111111,Feature
TypeScript,2147,14725,1530.0382291666667,MERGED,18,44,10,0,1,684,False,0,0,0,4599,62,17.19388888888889,Document
TypeScript,41369,87416,2995.4463541666664,MERGED,1,2,1,1,1,496,True,0,1,1,2135,3,3.245277777777778,Document
C#,80,125,878.5313773148149,MERGED,11,2,3,0,2,187,False,0,0,0,689,13,1.5047222222222223,Document
TypeScript,3393,2334,1031.2070949074075,MERGED,0,1,1,1,1,364,False,0,1,1,1033,1,19.43777777777778,Bug
Go,752,2399,785.6382060185184,MERGED,10,0,1,0,2,449,False,0,0,0,635,10,0.9091666666666667,Bug
JavaScript,9664,43890,3721.389537037037,MERGED,117,117,3,1,1,0,False,0,1,1,801,234,11.495,Feature
TypeScript,261,3765,734.5008912037038,MERGED,12,53,4,0,1,1002,True,0,0,0,3560,65,0.10916666666666666,Document
Vue,10808,21163,1080.3426041666667,MERGED,76,125,4,1,2,33,False,0,1,1,3054,201,332.07416666666666,Document
Erlang,2054,12122,3857.453576388889,MERGED,3,3,1,0,1,408,False,0,0,0,959,6,14.956944444444444,Document
TypeScript,3393,2334,1031.2432523148148,MERGED,0,1,1,2,1,498,False,0,2,1,1005,1,0.058611111111111114,Feature
TypeScript,261,3765,733.9826388888888,MERGED,18,39,3,0,2,245,False,0,0,0,3712,57,11.884166666666667,Document
Python,137,75,746.1863194444445,MERGED,0,128,5,0,30,1,False,0,0,0,2093,128,942.8775,Bug
Starlark,440,286,551.8068981481482,MERGED,1,1,1,3,1,76,False,1,2,2,983,2,0.021111111111111112,Document
C#,80,125,882.7585300925925,MERGED,8,8,1,0,1,191,False,0,0,0,868,16,69.42527777777778,Document
Erlang,2054,12122,3857.3659837962964,MERGED,1,1,1,0,2,88,False,0,0,0,754,2,0.16666666666666666,Document
TypeScript,41369,87416,2994.7102546296296,MERGED,0,8,2,1,1,1622,True,0,1,1,2147,8,1.1913888888888888,Document
C#,655,7879,1892.0135069444443,MERGED,3,41,2,6,4,603,True,0,6,3,1639,44,69.46944444444445,Document
JavaScript,9664,43890,3714.831064814815,MERGED,20,28,2,0,2,280,True,0,0,0,592,48,0.31333333333333335,Feature
Go,752,2399,784.918599537037,MERGED,2,2,1,0,1,448,False,0,0,0,503,4,0.008055555555555555,Document
JavaScript,9664,43890,3720.842974537037,MERGED,547,142,6,0,1,301,True,0,0,0,740,689,0.18166666666666667,Feature
JavaScript,9664,43890,3716.143449074074,MERGED,117,612,15,2,6,324,True,2,0,0,704,729,236.1263888888889,Bug
C#,80,125,881.4917939814815,MERGED,5,11,3,0,3,189,False,0,0,0,834,16,99.99027777777778,Document
TypeScript,15,34,547.7043171296297,MERGED,121,520,31,0,13,363,False,0,0,0,580,641,24.275277777777777,Feature
TypeScript,7046,76150,2691.7370717592594,MERGED,24,26,7,3,1,110,False,0,3,2,3560,50,0.37027777777777776,Feature
F#,153,337,2979.2385879629633,MERGED,158,19,9,1,1,30,False,0,1,1,5063,177,0.43194444444444446,Bug
TypeScript,41369,87416,3000.9408564814817,MERGED,1,7,2,1,2,73,False,0,1,1,2209,8,11.5225,Document
Java,450,746,4135.019097222222,MERGED,3,1,1,0,5,65,False,0,0,0,1044,4,3.633611111111111,Bug
Starlark,440,286,554.0040972222222,MERGED,0,306,2,2,7,2,False,1,1,1,1371,306,354.74333333333334,Bug
TypeScript,41369,87416,2999.993657407407,MERGED,2,2,1,3,4,1947,True,1,2,2,2153,4,45.439166666666665,Document
TypeScript,41369,87416,3000.4226157407406,MERGED,14,13,7,1,6,29,False,0,1,1,3100,27,16.016111111111112,Document
JavaScript,22,26,976.551412037037,CLOSED,559,536,2,1,1,15,True,0,1,1,982,1095,0.9222222222222223,Bug
TypeScript,41369,87416,3000.6705439814814,MERGED,4,4,2,2,1,50,False,0,2,2,3057,8,0.2863888888888889,Document
TypeScript,41369,87416,3000.6169444444445,MERGED,2,2,2,1,1,206,False,0,1,1,2353,4,0.4177777777777778,Document
TypeScript,41369,87416,3000.4765972222226,MERGED,1,1,1,1,1,0,False,0,1,1,2174,2,0.9347222222222222,Document
JavaScript,9664,43890,3719.026446759259,MERGED,2,544,4,0,1,326,True,0,0,0,768,546,13.711944444444445,Feature
V,2097,34361,1613.4463541666667,MERGED,6,74,4,0,3,260,True,0,0,0,2988,80,4.739722222222222,Bug
TypeScript,41369,87416,3000.390474537037,MERGED,2,5,3,1,1,34,False,0,1,1,2930,7,0.7361111111111112,Document
JavaScript,34,25,259.36407407407404,MERGED,2,2,1,0,1,87,False,0,0,0,1007,4,0.08,Bug
JavaScript,9664,43890,3718.9718287037035,MERGED,9,21,1,0,1,288,True,0,0,0,799,30,0.8894444444444445,Feature
TypeScript,202,107,1203.7822916666667,MERGED,44,28,6,3,2,277,True,0,3,3,3095,72,91.94333333333333,Bug
TypeScript,3393,2334,1028.3511805555556,MERGED,0,7,1,2,1,495,False,0,2,1,947,7,15.679722222222223,Feature
TypeScript,41369,87416,2999.937048611111,MERGED,5,3,1,1,3,615,True,0,1,1,2333,8,0.4988888888888889,Document
Go,752,2399,788.5031018518517,CLOSED,2,112,5,0,1,32,False,0,0,0,2832,114,0.020833333333333332,Bug
TypeScript,15,34,551.6150231481481,MERGED,169,656,21,0,7,367,False,0,0,0,706,825,40.879444444444445,Bug
TypeScript,41369,87416,2999.4411111111112,MERGED,3,3,2,1,1,26,False,0,1,1,2642,6,0.5286111111111111,Document
TypeScript,41369,87416,2998.9133101851853,MERGED,0,4,1,1,1,1946,True,0,1,1,2748,4,12.56,Document
TypeScript,15,34,551.4577083333334,MERGED,35,4281,82,1,5,516,True,1,0,0,795,4316,23.143333333333334,Feature
TypeScript,41369,87416,2998.4197916666667,MERGED,0,1,1,1,1,613,True,0,1,1,2264,1,0.9116666666666666,Document
Java,450,746,4130.002847222222,MERGED,100,1747,25,2,38,39,False,0,2,1,1034,1847,127.02527777777777,Feature
Vue,10808,21163,1081.9974652777778,CLOSED,1,39,7,1,1,0,False,0,1,1,3252,40,0.5544444444444444,Document
Go,2083,11770,1580.8033564814814,MERGED,9,12,2,0,1,5,False,0,0,0,2855,21,4.223333333333334,Document
Python,137,75,747.3513657407407,MERGED,0,25,2,1,61,1,False,0,1,1,2615,25,1200.9666666666667,Bug
C#,655,7879,1890.0132175925926,MERGED,159,172,109,1,21,647,True,0,1,1,2288,331,460.20166666666665,Document
JavaScript,5140,7051,1261.7142245370371,MERGED,91,42,7,2,5,327,False,0,2,2,4251,133,21.51888888888889,Document
JavaScript,9664,43890,3716.224583333333,MERGED,0,1,1,0,1,285,True,0,0,0,738,1,0.1613888888888889,Bug
TypeScript,85,724,378.0435532407407,MERGED,1199,2712,93,0,19,120,False,0,0,0,5709,3911,168.32222222222222,Document
F#,153,337,2981.2380324074074,MERGED,95,166,9,0,2,33,False,0,0,0,6505,261,421.62944444444446,Bug
V,2097,34361,1609.487013888889,MERGED,8,70,2,0,3,254,True,0,0,0,3144,78,28.421666666666667,Bug
TypeScript,41369,87416,2996.8694907407407,MERGED,5,11,1,1,2,23,False,0,1,1,2425,16,1.3233333333333333,Document
C#,80,125,878.5508680555555,MERGED,0,5,2,0,1,188,False,0,0,0,883,5,1.056111111111111,Document
TypeScript,202,107,1201.7601620370372,MERGED,3,43,3,3,1,272,True,0,3,3,2799,46,21.969166666666666,Bug
TypeScript,41369,87416,2996.8206944444446,MERGED,2,2,1,2,1,22,False,0,2,2,2268,4,0.4786111111111111,Document
TypeScript,41369,87416,2996.7325925925925,MERGED,2,2,1,1,1,1,False,0,1,1,2469,4,0.4608333333333333,Document
C#,655,7879,1891.0656597222223,MERGED,26,138,4,6,4,601,True,0,6,3,2052,164,146.66444444444446,Document
C#,655,7879,1890.0700462962961,MERGED,8,7,1,0,1,16,False,0,0,0,1871,15,1.2247222222222223,Document
TypeScript,3393,2334,1025.1674074074074,MERGED,1,1,1,1,1,163,False,0,1,1,1049,2,0.25972222222222224,Bug
JavaScript,5140,7051,1260.926064814815,MERGED,36,0,18,1,1,15,False,0,1,1,3881,36,0.2425,Document
Erlang,2054,12122,3852.8680208333335,MERGED,38,66,9,8,5,515,True,2,6,2,1306,104,24.571944444444444,Document
TypeScript,2147,14725,1536.2089583333334,MERGED,98,1038,11,0,1,201,False,0,0,0,5707,1136,12.017777777777777,Document
Python,137,75,747.2717361111112,MERGED,0,193,6,0,13,6,False,0,0,0,2286,193,559.0722222222222,Document
TypeScript,261,3765,737.6679050925926,MERGED,34,154,12,0,9,118,True,0,0,0,5613,188,259.6852777777778,Document
TypeScript,41369,87416,2995.699733796296,MERGED,1,1,1,7,1,4,False,3,4,3,2434,2,2.5555555555555554,Document
TypeScript,41369,87416,2995.6974421296295,MERGED,1,5,1,1,2,0,False,0,1,1,2511,6,2.62,Document
JavaScript,22,26,980.8134143518519,MERGED,4,22,1,0,1,24,True,0,0,0,1613,26,49.63638888888889,Bug
Python,1912,12142,129.69226851851852,MERGED,2,21,1,0,7,2,False,0,0,0,1658,23,0.7577777777777778,Bug
TypeScript,41369,87416,2995.0196875,MERGED,0,362,2,1,5,1623,True,0,1,1,2480,362,17.269166666666667,Document
Starlark,440,286,553.8822337962963,MERGED,0,132,2,2,1,0,False,1,1,1,1671,132,25.0475,Document
Python,137,75,748.0099768518518,MERGED,0,46,4,0,4,28,False,0,0,0,1231,46,92.36472222222223,Document
TypeScript,41369,87416,2999.512662037037,MERGED,13,24,7,4,6,81,True,0,4,4,3660,37,367.11083333333335,Document
JavaScript,5140,7051,1261.1121990740742,CLOSED,2571,6026,221,1,11,0,False,0,1,1,3224,8597,18.713055555555556,Document
Python,137,75,742.9404861111111,MERGED,0,335,11,0,37,2,False,0,0,0,978,335,339.57916666666665,Document
Python,1912,12142,129.02699074074073,MERGED,0,83,1,3,1,0,False,0,3,2,1343,83,0.029722222222222223,Feature
TypeScript,7,6,708.0002083333334,MERGED,101,114,101,0,1,240,False,0,0,0,4525,215,20.77722222222222,Feature
Python,137,75,746.762199074074,MERGED,15,152,10,1,21,7,False,1,0,0,2073,167,542.4069444444444,Document
C#,80,125,882.5458449074075,MERGED,932,5826,58,0,10,227,False,0,0,0,1215,6758,217.83416666666668,Feature
TypeScript,41369,87416,2994.5926157407407,MERGED,0,1,1,1,1,1620,True,0,1,1,2039,1,0.6591666666666667,Document
Starlark,440,286,554.18875,MERGED,4,4,2,1,1,5,False,0,1,1,1287,8,16.595833333333335,Document
TypeScript,41369,87416,2994.4604513888885,MERGED,9,14,2,1,3,612,True,0,1,1,2441,23,3.087222222222222,Document
TypeScript,85,724,378.9481597222222,MERGED,359,169,7,0,4,118,False,0,0,0,6697,528,0.45361111111111113,Document
Python,137,75,748.8547453703704,MERGED,4,6,4,0,2,221,False,0,0,0,1805,10,1.0233333333333334,Bug
TypeScript,202,107,1205.9688310185186,MERGED,321,110,7,4,5,279,True,0,4,3,4336,431,251.30638888888888,Bug
TypeScript,3706,54077,1420.693125,MERGED,20,20,1,0,1,176,True,0,0,0,1553,40,121.15416666666667,Feature
Erlang,2054,12122,3859.392372685185,MERGED,0,22,2,0,1,412,False,0,0,0,1146,22,22.605,Document
TypeScript,4,33,825.1352893518518,MERGED,110,809,19,2,37,63,False,0,2,2,1805,919,502.355,Feature
Erlang,2054,12122,3859.4031481481484,MERGED,249,855,94,0,37,413,False,0,0,0,1369,1104,5.2988888888888885,Document
Erlang,2054,12122,3859.1221643518516,MERGED,8,4,2,0,1,410,False,0,0,0,1297,12,24.024722222222223,Document
TypeScript,12,11,1050.2671759259258,MERGED,76,974,9,0,13,64,False,0,0,0,5141,1050,50.79527777777778,Bug
Go,1835,11246,1786.1842708333334,MERGED,1675,1569,72,1,5,574,False,0,1,1,853,3244,20.723055555555554,Document
Erlang,2054,12122,3858.541736111111,MERGED,9,44,3,1,1,409,False,1,0,0,1102,53,38.01972222222222,Document
C#,655,7879,1892.0606828703703,MERGED,959,946,229,1,5,604,True,0,1,1,2213,1905,118.38694444444444,Document
Python,2409,12192,303.81241898148147,MERGED,18,23,1,0,5,383,True,0,0,0,1601,41,0.23916666666666667,Document
TypeScript,261,3765,739.739236111111,MERGED,91,296,50,0,2,1017,True,0,0,0,7695,387,21.783055555555556,Document
Python,2409,12192,303.7900115740741,MERGED,5,5,1,0,1,382,True,0,0,0,1509,10,0.03722222222222222,Document
TypeScript,85,724,373.06714120370367,MERGED,6030,448,107,0,8,189,False,0,0,0,6791,6478,265.1838888888889,Document
Starlark,440,286,552.0927430555556,MERGED,0,346,2,1,9,6,False,0,1,1,1700,346,68.00111111111111,Feature
Starlark,440,286,552.7781712962964,MERGED,2,2,1,1,11,1,False,0,1,1,1190,4,24.939444444444444,Bug
Erlang,2054,12122,3858.2608564814814,MERGED,75,159,43,0,8,180,False,0,0,0,1088,234,21.578055555555554,Document
TypeScript,261,3765,739.687835648148,MERGED,286,85,48,0,1,1016,True,0,0,0,7774,371,0.5902777777777778,Document
Starlark,440,286,552.3682638888889,MERGED,0,157,3,4,3,0,False,2,2,2,1346,157,34.791666666666664,Feature
TypeScript,261,3765,739.4854976851852,MERGED,85,286,48,0,4,1015,True,0,0,0,7438,371,3.4530555555555558,Document
Python,2409,12192,303.14256944444446,MERGED,1,1,1,1,1,1,False,0,1,1,1587,2,0.44277777777777777,Document
Python,137,75,746.9907291666667,MERGED,0,210,9,0,10,239,False,0,0,0,1128,210,5.080555555555556,Document
Erlang,2054,12122,3858.0485763888887,MERGED,1,236,6,1,1,28,False,1,0,0,1331,237,3.4555555555555557,Document
Python,2409,12192,302.3641435185185,MERGED,4,1,1,1,1,5,False,0,1,1,1535,5,12.756944444444445,Document
Erlang,2054,12122,3858.0270138888886,MERGED,1,11,3,0,2,391,True,0,0,0,1222,12,1.3880555555555556,Document
Erlang,2054,12122,3857.0139930555556,MERGED,27,17,13,0,4,86,False,0,0,0,992,44,52.37777777777778,Document
TypeScript,3393,2334,1031.0414930555555,MERGED,5,7,1,2,1,0,False,0,2,1,1315,12,0.1438888888888889,Document
C#,655,7879,1885.701412037037,MERGED,2,3,1,1,2,11,False,0,1,1,1491,5,3.959722222222222,Document
Erlang,2054,12122,3857.6599305555555,MERGED,1,1,1,0,1,27,True,0,0,0,1098,2,4.6175,Document
TypeScript,3393,2334,1031.0603819444443,MERGED,1,3,2,1,2,363,False,0,1,1,1697,4,22.965833333333332,Feature
TypeScript,261,3765,738.6732291666667,MERGED,13,38,6,0,6,249,False,0,0,0,4938,51,0.7705555555555555,Document
Starlark,440,286,551.8447453703703,MERGED,40,56,1,4,12,2,False,2,2,2,1015,96,5.402222222222222,Document
Java,450,746,4136.0962384259265,MERGED,3,3,1,0,4,67,False,0,0,0,1159,6,4.144444444444445,Bug
C#,80,125,883.7911805555556,MERGED,5,22,3,0,2,205,True,0,0,0,1154,27,2.9994444444444444,Document
TypeScript,41369,87416,3001.124895833333,MERGED,6,166,9,2,8,0,False,0,2,2,4143,172,104.88083333333333,Document
Erlang,2054,12122,3856.8423611111107,MERGED,9,51,3,0,3,517,True,0,0,0,1456,60,29.16583333333333,Document
TypeScript,3393,2334,1030.1841898148148,MERGED,5,7,4,2,17,497,False,0,2,1,1380,12,42.87027777777778,Bug
TypeScript,261,3765,737.8369097222222,MERGED,14,825,36,0,2,247,False,0,0,0,5147,839,19.521944444444443,Document
Go,752,2399,785.6854976851852,MERGED,22,1497,23,0,44,153,False,0,0,0,3895,1519,287.0052777777778,Bug
Starlark,440,286,551.0803703703704,MERGED,2,2,1,1,1,8,False,0,1,1,1346,4,17.238333333333333,Bug
TypeScript,1297,21107,479.1380208333333,MERGED,382,569,14,1,4,1136,True,0,1,1,4352,951,11.064166666666667,Document
Erlang,2054,12122,3856.936157407408,MERGED,10,8,4,0,3,431,True,0,0,0,1472,18,1.6319444444444444,Document
TypeScript,4,33,825.2362731481481,MERGED,81,76,3,2,2,260,True,1,1,1,1593,157,0.10194444444444445,Bug
TypeScript,261,3765,737.8474189814815,MERGED,56,181,12,0,1,1011,True,0,0,0,5758,237,0.11361111111111111,Document
Erlang,2054,12122,3856.708483796296,MERGED,14,26,6,0,2,430,True,0,0,0,1205,40,2.16,Document
TypeScript,3393,2334,1031.189201388889,MERGED,4,14,2,1,1,750,False,0,1,1,1964,18,381.0830555555556,Feature
TypeScript,3393,2334,1029.610023148148,MERGED,2,7,2,2,1,496,False,0,2,1,1598,9,23.259166666666665,Feature
TypeScript,2147,14725,1531.1014236111112,MERGED,26,465,4,0,1,315,False,0,0,0,5747,491,64.29861111111111,Document
C#,80,125,881.7234606481483,MERGED,4,19,4,0,1,190,False,0,0,0,1436,23,43.911944444444444,Document
Python,2409,12192,301.8408796296296,MERGED,12,358,11,18,86,377,True,12,6,3,2113,370,365.22,Document
TypeScript,4,33,824.3672685185185,MERGED,4,6,3,0,3,397,False,0,0,0,1692,10,0.14194444444444446,Bug
TypeScript,4,33,824.3210879629629,MERGED,1,1,1,1,2,396,False,0,1,1,1116,2,0.26166666666666666,Bug
TypeScript,178,1359,379.585775462963,MERGED,332,638,12,5,3,47,True,3,2,2,7254,970,29.955,Feature
TypeScript,307,2556,600.7209259259259,MERGED,5,3,2,5,1,206,True,3,2,1,1075,8,23.295555555555556,Bug
Erlang,2054,12122,3853.98337962963,MERGED,16,72,3,0,2,255,True,0,0,0,1183,88,77.33722222222222,Document
TypeScript,2147,14725,1529.8166435185185,MERGED,226,117,39,0,1,761,False,0,0,0,6680,343,8.993055555555555,Feature
Erlang,2054,12122,3853.2653472222223,CLOSED,74,149,44,1,3,57,False,0,1,1,990,223,119.90583333333333,Document
TypeScript,1297,21107,477.77699074074076,MERGED,158,213,9,1,2,1127,True,0,1,1,3706,371,0.20555555555555555,Document
TypeScript,3393,2334,1029.1905208333333,MERGED,2,2,1,1,1,746,False,0,1,1,1279,4,0.18444444444444444,Feature
JavaScript,22,26,975.9806018518519,MERGED,3,19,5,1,2,14,True,1,0,0,2128,22,424.0911111111111,Document
TypeScript,3393,2334,1029.1152893518517,MERGED,11,15,1,1,4,744,False,0,1,1,1213,26,2.595,Bug
Java,1,10,293.0527314814815,MERGED,118,163,10,0,7,4,False,0,0,0,4939,281,0.02666666666666667,Document
Erlang,2054,12122,3854.096493055555,MERGED,20,20,9,1,4,429,True,1,0,0,1472,40,68.81222222222222,Document
JavaScript,22,26,976.0568055555556,MERGED,210,255,3,0,1,21,True,0,0,0,1232,465,0.36027777777777775,Feature
Erlang,2054,12122,3853.918657407407,MERGED,1,3,1,0,1,389,True,0,0,0,1186,4,65.46972222222222,Document
Erlang,2054,12122,3853.197708333333,MERGED,49,173,14,1,6,87,True,0,1,1,1113,222,95.55166666666666,Document
JavaScript,22,26,975.6235069444446,MERGED,1,1,1,0,1,13,True,0,0,0,1162,2,1.198611111111111,Document
JavaScript,34,25,257.4089814814815,MERGED,0,1,1,0,2,6,False,0,0,0,1288,1,57.07972222222222,Bug
JavaScript,2,1,377.19528935185184,MERGED,3,6,3,0,2,33,False,0,0,0,1762,9,0.016666666666666666,Document
Erlang,2054,12122,3854.2893402777777,CLOSED,1,10,2,0,1,405,False,0,0,0,1066,11,0.15444444444444444,Document
TypeScript,41369,87416,2999.606701388889,MERGED,10,108,3,2,3,82,True,0,2,2,4206,118,21.261111111111113,Document
Erlang,2054,12122,3854.2699305555557,MERGED,3,96,5,0,1,404,False,0,0,0,1051,99,3.006111111111111,Document
TypeScript,85,724,373.15510416666666,MERGED,34,86,4,0,1,41,False,0,0,0,5866,120,1.513611111111111,Document
Erlang,2054,12122,3859.349537037037,MERGED,10,1694,23,0,1,21,False,0,0,0,1589,1704,145.29194444444445,Document
C++,363,552,594.0012037037037,MERGED,117,43,6,0,2,268,False,0,0,0,1765,160,145.7447222222222,Document
TypeScript,3393,2334,1031.1410416666665,CLOSED,12,26,4,2,1,749,False,0,2,2,2999,38,125.19888888888889,Feature
Erlang,2054,12122,3853.991631944444,MERGED,11,45,6,0,1,428,True,0,0,0,1233,56,3.536111111111111,Document
C#,655,7879,1888.1526851851852,MERGED,4,4,2,0,6,646,True,0,0,0,2224,8,53.67916666666667,Document
Erlang,2054,12122,3854.0002662037036,MERGED,2,19,3,0,2,390,True,0,0,0,1197,21,2.5166666666666666,Document
TypeScript,41369,87416,2999.6173726851853,MERGED,4,4,3,1,1,28,False,0,1,1,2959,8,0.5108333333333334,Document
Erlang,2054,12122,3853.867314814815,MERGED,1,2,1,0,1,254,True,0,0,0,1078,3,1.708888888888889,Document
TypeScript,41369,87416,2999.4493402777775,MERGED,46,51,5,1,1,27,False,0,1,1,3861,97,0.9291666666666667,Document
TypeScript,261,3765,734.7473032407407,MERGED,72,157,14,0,2,1004,True,0,0,0,6889,229,0.9522222222222222,Document
Erlang,2054,12122,3853.0061458333334,MERGED,4,19,5,0,2,86,True,0,0,0,1063,23,23.6525,Document
Erlang,2054,12122,3853.2428935185185,MERGED,38,49,6,0,3,427,True,0,0,0,1298,87,15.176944444444445,Document
Erlang,2054,12122,3852.9214930555554,MERGED,7,14,5,0,3,516,True,0,0,0,1124,21,23.302777777777777,Document
Python,2409,12192,298.01591435185185,CLOSED,0,7,2,0,2,0,False,0,0,0,1496,7,0.006944444444444444,Document
Erlang,2054,12122,3852.8785532407405,MERGED,9,15,10,0,3,388,True,0,0,0,1202,24,21.155555555555555,Document
TypeScript,3393,2334,1026.3870601851852,MERGED,1,1,1,2,1,283,False,0,2,1,1684,2,35.11833333333333,Bug
Go,421,1654,1568.2153587962964,MERGED,740,187,22,0,1,483,True,0,0,0,6090,927,69.78027777777778,Bug
Python,2409,12192,297.8597222222222,MERGED,1,2,1,3,2,0,False,2,1,1,1201,3,1.0363888888888888,Feature
Erlang,2054,12122,3852.726168981482,MERGED,4,58,3,0,2,514,True,0,0,0,1321,62,22.217777777777776,Document
Erlang,2054,12122,3852.834837962963,MERGED,3,2,3,0,3,479,True,0,0,0,1184,5,4.610833333333333,Document
TypeScript,41369,87416,2998.5229282407404,MERGED,12,12,9,1,2,614,True,0,1,1,4321,24,2.245277777777778,Document
C++,363,552,595.1747916666667,CLOSED,1,2,1,1,1,270,False,1,0,0,1413,3,0.22583333333333333,Document
Go,752,2399,784.7196180555555,MERGED,13,335,4,0,2,69,False,0,0,0,5034,348,99.04333333333334,Bug
C#,655,7879,1885.8119328703704,MERGED,9,369,3,1,2,13,False,0,1,1,2287,378,90.19972222222222,Document
TypeScript,4,33,820.6024884259259,MERGED,329,291,21,1,8,236,False,0,1,1,1561,620,3.0819444444444444,Bug
TypeScript,41369,87416,2997.668958333333,MERGED,216,194,5,1,1,25,False,0,1,1,4488,410,1.113611111111111,Document
C++,363,552,594.2704398148148,MERGED,3,21,1,0,1,269,False,0,0,0,1335,24,17.66861111111111,Document
TypeScript,41369,87416,2997.4763194444445,MERGED,33,38,3,2,2,24,False,1,1,1,3197,71,2.5280555555555555,Document
Python,137,75,747.5454166666667,MERGED,101,9,6,0,2,26,False,0,0,0,2133,110,29.895,Document
TypeScript,41369,87416,2996.5793518518517,MERGED,18,16,8,1,4,498,True,0,1,1,4148,34,44.61333333333334,Document
Python,2409,12192,303.96465277777776,MERGED,7,7,1,4,3,2,False,1,3,1,1684,14,2.988888888888889,Feature
Starlark,440,286,553.8066898148148,MERGED,10,2,1,3,1,77,False,1,2,2,2043,12,0.015833333333333335,Feature
Python,2409,12192,303.8713310185185,MERGED,0,2,1,1,3,22,False,0,1,1,2169,2,3.5105555555555554,Document
Python,2409,12192,303.381412037037,MERGED,0,2,1,3,2,6,False,1,2,1,1594,2,9.244166666666667,Document
C++,363,552,593.8843287037038,MERGED,483,4,8,0,2,265,False,0,0,0,1428,487,0.07388888888888889,Document
Python,2409,12192,303.7710648148148,MERGED,2,2,1,1,3,7,False,0,1,1,1583,4,0.21444444444444444,Document
JavaScript,5140,7051,1262.6226041666666,MERGED,341,372,23,5,9,90,False,2,3,2,6648,713,95.76583333333333,Bug
TypeScript,41369,87416,2996.7794097222218,MERGED,0,1,1,1,1,0,False,0,1,1,3318,1,0.595,Document
TypeScript,41369,87416,2996.649861111111,MERGED,9,8,3,1,2,0,False,0,1,1,3272,17,0.5377777777777778,Document
TypeScript,3393,2334,1029.5274189814816,MERGED,5,5,5,2,1,0,False,0,2,1,2456,10,3.13,Feature
C#,655,7879,1885.8605787037038,MERGED,1,1,1,1,1,643,True,0,1,1,2269,2,2.9466666666666668,Document
C#,655,7879,1889.0601041666666,MERGED,28,40,1,7,6,18,False,1,6,3,2494,68,362.7677777777778,Document
Starlark,440,286,552.1959606481481,MERGED,5,16,2,1,2,88,False,0,1,1,2000,21,38.94777777777778,Bug
Python,2409,12192,303.0448611111111,MERGED,0,39,3,0,3,379,True,0,0,0,2178,39,0.03194444444444444,Document
Erlang,2054,12122,3857.740648148148,MERGED,23,150,11,0,6,432,True,0,0,0,1547,173,30.66888888888889,Document
Python,2409,12192,302.7964699074074,MERGED,1,1,1,0,2,378,True,0,0,0,1613,2,2.3891666666666667,Document
Erlang,2054,12122,3857.1856944444444,MERGED,125,238,27,1,2,406,False,1,0,0,1577,363,47.147777777777776,Document
TypeScript,3393,2334,1031.2171875000001,MERGED,1,34,3,1,3,752,False,0,1,1,2097,35,15.381388888888889,Feature
TypeScript,85,724,379.0283217592593,MERGED,249,792,29,0,6,192,False,0,0,0,10213,1041,3.7025,Document
TypeScript,85,724,378.94374999999997,MERGED,45,302,10,0,9,16,False,0,0,0,8813,347,1.8755555555555556,Document
Erlang,2054,12122,3857.3110185185183,MERGED,1,65,3,0,2,407,False,0,0,0,1845,66,1.3430555555555554,Document
TypeScript,41369,87416,2994.7997337962966,MERGED,1,47,6,1,1,70,False,0,1,1,4400,48,14.69361111111111,Document
TypeScript,41369,87416,2994.756342592593,MERGED,20,20,10,2,5,18,False,0,2,2,4188,40,6.125555555555556,Document
TypeScript,4,33,823.0641550925926,MERGED,10,1025,26,2,36,395,True,0,2,2,1648,1035,50.26916666666666,Document
TypeScript,41369,87416,2994.652824074074,MERGED,12,85,6,1,3,1621,True,0,1,1,3884,97,0.9452777777777778,Document
TypeScript,41369,87416,2996.9771875,MERGED,25,43,2,4,2,72,False,1,3,3,4859,68,783.0280555555555,Document
TypeScript,4,33,825.0751157407408,MERGED,461,506,38,2,33,259,True,1,1,1,2098,967,1.355,Bug
C#,655,7879,1887.1970949074075,MERGED,11,176,7,2,9,6,False,2,0,0,2483,187,140.37777777777777,Document
TypeScript,41369,87416,2994.356226851852,MERGED,6,47,6,1,1,68,False,0,1,1,4650,53,2.5308333333333333,Document
TypeScript,4,33,824.916875,MERGED,9,9,7,1,1,78,False,0,1,1,2286,18,0.014444444444444444,Bug
TypeScript,2147,14725,1534.2458796296296,MERGED,16,731,20,0,1,200,False,0,0,0,9061,747,14.274444444444445,Feature
JavaScript,2,1,379.25608796296297,MERGED,20,58,3,0,2,36,False,0,0,0,2250,78,0.017777777777777778,Document
TypeScript,85,724,376.96506944444445,MERGED,102,479,14,0,10,191,False,0,0,0,8789,581,49.37111111111111,Document
Java,450,746,4134.041134259259,MERGED,4,20,2,0,16,63,False,0,0,0,2070,24,53.528055555555554,Feature
TypeScript,41369,87416,2998.910474537037,MERGED,20,147,9,1,5,1624,True,0,1,1,7763,167,12.499166666666667,Document
TypeScript,3393,2334,1029.9219444444445,MERGED,2,7,1,1,1,167,False,0,1,1,1787,9,0.12583333333333332,Document
Java,450,746,4134.241724537037,MERGED,2,8,2,0,11,64,False,0,0,0,1615,10,22.310555555555556,Document
TypeScript,140,827,807.2529861111111,MERGED,3,89,3,2,4,126,False,0,2,2,1893,92,67.06916666666666,Document
Java,450,746,4134.174618055556,MERGED,4,31,3,0,1,386,True,0,0,0,2303,35,0.9813888888888889,Feature
C++,363,552,597.2170023148147,MERGED,84,176,11,0,3,271,False,0,0,0,2448,260,42.91,Document
TypeScript,3393,2334,1029.055162037037,MERGED,4,8,3,1,2,361,False,0,1,1,2213,12,1.7527777777777778,Document
C#,655,7879,1887.850335648148,MERGED,283,194,113,1,10,644,True,1,0,0,2510,477,250.78333333333333,Document
Python,2409,12192,300.0216087962963,MERGED,8,4,2,0,4,372,True,0,0,0,1844,12,0.6277777777777778,Document
Python,2409,12192,298.8575,MERGED,0,0,0,3,4,0,False,1,2,1,2061,0,27.837777777777777,Document
TypeScript,17,33,782.1041435185185,MERGED,113,751,21,1,4,36,True,0,1,1,1597,864,46.234722222222224,Feature
Go,1835,11246,1791.1456828703704,MERGED,122,22,4,0,4,577,False,0,0,0,1950,144,40.89861111111111,Document
Go,1835,11246,1791.8565740740742,MERGED,1294,0,23,1,1,112,False,0,1,1,1747,1294,0.017777777777777778,Document
Python,2409,12192,298.4164930555556,MERGED,2,2,1,1,1,86,True,0,1,1,1604,4,9.4,Bug
Python,2409,12192,297.8127777777778,MERGED,2,2,1,3,3,368,True,2,1,1,2102,4,3.6622222222222223,Document
Python,2409,12192,297.62244212962963,MERGED,1,1,1,2,2,0,False,1,1,1,1707,2,4.797777777777778,Document
Go,1835,11246,1790.6541550925924,MERGED,0,2,1,0,1,576,False,0,0,0,2036,2,7.0075,Document
JavaScript,0,0,0.23719907407407406,CLOSED,0,46,1,0,1,0,True,0,0,0,1879,46,0.04861111111111111,Document
TypeScript,3393,2334,1026.097939814815,MERGED,3,3,2,1,1,166,False,0,1,1,1884,6,0.145,Bug
C#,655,7879,1888.0436805555555,MERGED,49,57,25,0,1,645,True,0,0,0,2883,106,77.755,Document
TypeScript,4,33,820.2678009259258,MERGED,9,9,7,1,1,77,False,0,1,1,2086,18,0.04861111111111111,Document
TypeScript,7,6,702.1487962962964,CLOSED,264,3151,71,1,317,38,True,1,0,0,8595,3415,363.0541666666667,Feature
TypeScript,1073,11366,1151.7827199074075,MERGED,2,2,2,0,1,225,False,0,0,0,2099,4,0.33944444444444444,Document
Go,1835,11246,1785.5902893518517,MERGED,4,16,6,0,2,109,False,0,0,0,2214,20,0.3225,Bug
JavaScript,34,25,254.55797453703704,CLOSED,249,294,3,3,3,0,False,1,2,1,2051,543,1.1766666666666667,Feature
C#,655,7879,1885.8280439814814,MERGED,80,105,6,1,5,14,False,0,1,1,2640,185,96.35333333333334,Document
Java,1,10,289.9863310185185,MERGED,102,153,12,0,5,12,False,0,0,0,9490,255,0.18333333333333332,Document
TypeScript,41369,87416,3001.0088310185183,MERGED,41,112,16,3,8,51,False,0,3,3,7664,153,164.6172222222222,Document
Python,2409,12192,304.2818634259259,CLOSED,0,29,2,0,2,0,False,0,0,0,2413,29,0.026944444444444444,Document
TypeScript,3393,2334,1030.7265972222222,MERGED,7,45,4,2,1,0,False,0,2,1,2763,52,3.5905555555555555,Document
Starlark,440,286,553.5932407407407,MERGED,6,12,1,1,1,89,False,0,1,1,2241,18,5.056111111111111,Document
Go,789,5551,1102.8175347222223,MERGED,1,11,2,0,1,418,False,0,0,0,2759,12,7.549444444444444,Document
Python,2409,12192,303.77475694444445,MERGED,10,12,4,0,2,381,True,0,0,0,2195,22,0.07111111111111111,Document
Starlark,440,286,553.0379976851851,MERGED,0,85,3,3,2,0,False,1,2,2,2667,85,18.48138888888889,Document
TypeScript,3393,2334,1029.5317592592594,MERGED,18,30,4,2,1,0,False,0,2,1,2892,48,3.0080555555555555,Feature
Starlark,440,286,553.0097685185185,MERGED,0,212,4,4,1,4,False,1,3,2,2260,212,19.336388888888887,Document
Python,4517,54993,987.9033564814814,MERGED,29,54,1,6,8,0,False,0,6,3,3138,83,114.99416666666667,Document
Go,1835,11246,1785.6317939814815,MERGED,2,17,2,0,1,15,False,0,0,0,1847,19,0.058055555555555555,Document
Python,4517,54993,989.2538310185186,MERGED,48,0,2,2,1,10,False,0,2,2,3079,48,27.810833333333335,Document
TypeScript,1073,11366,1155.018263888889,MERGED,1,1,1,2,4,0,False,0,2,2,2150,2,207.68305555555557,Bug
TypeScript,41369,87416,2999.6699074074077,MERGED,578,1468,20,2,8,25,True,0,2,2,6624,2046,143.1,Document
TypeScript,1297,21107,478.9357523148148,CLOSED,1034,1522,19,1,1,1130,True,0,1,1,6151,2556,0.11916666666666667,Document
TypeScript,4,33,825.1636689814815,MERGED,201,676,17,2,21,398,False,0,2,2,2449,877,45.591944444444444,Bug
Python,4517,54993,985.7561574074074,MERGED,3,35,1,0,2,114,True,0,0,0,2919,38,166.64027777777778,Document
Erlang,2054,12122,3857.192858796296,MERGED,1,7,2,1,1,27,False,0,1,1,2026,8,2.5425,Document
Go,789,5551,1098.8715162037038,MERGED,0,307,3,2,5,25,False,2,0,0,2396,307,103.5963888888889,Document
Python,2409,12192,301.39582175925926,MERGED,31,41,9,8,6,4,False,3,5,1,3135,72,12.1675,Document
TypeScript,1073,11366,1157.5910069444444,MERGED,16,17,1,1,2,298,True,0,1,1,2390,33,0.44166666666666665,Bug
Java,450,746,4135.171180555556,MERGED,16,44,5,0,6,66,False,0,0,0,3191,60,26.379166666666666,Bug
Python,2409,12192,301.03609953703705,MERGED,12,39,9,2,10,376,True,1,1,1,2402,51,21.301944444444445,Document
Starlark,440,286,549.2645717592592,MERGED,4,48,1,2,4,0,False,1,1,1,2874,52,109.34333333333333,Document
TypeScript,1297,21107,477.8116550925926,CLOSED,813,1295,18,1,1,1128,True,0,1,1,7371,2108,0.10305555555555555,Document
Python,2409,12192,300.9953703703704,MERGED,1,5,2,0,1,375,True,0,0,0,2367,6,20.331944444444446,Document
Python,2409,12192,300.94497685185183,MERGED,2,2,1,0,1,374,True,0,0,0,2269,4,0.1661111111111111,Document
TypeScript,1073,11366,1156.6657175925927,MERGED,3,3,2,1,1,19,True,0,1,1,2117,6,0.15305555555555556,Bug
TypeScript,1073,11366,1156.6551041666667,MERGED,0,1,1,1,1,770,True,0,1,1,2527,1,0.17694444444444443,Bug
TypeScript,1073,11366,1156.6426388888888,CLOSED,0,1,1,2,1,769,True,0,2,2,2219,1,0.2841666666666667,Document
Starlark,440,286,549.2776041666667,MERGED,32,87,1,1,1,87,False,0,1,1,2227,119,60.49777777777778,Document
Python,137,75,748.8595949074074,MERGED,0,2085,99,0,76,102,False,0,0,0,5046,2085,170.64027777777778,Bug
TypeScript,41369,87416,2999.5824421296297,MERGED,321,300,7,1,2,500,True,0,1,1,6253,621,9.419722222222223,Document
Starlark,440,286,548.3620138888889,MERGED,35,85,1,1,26,5,False,0,1,1,2404,120,82.45861111111111,Bug
Go,1835,11246,1789.9023842592594,MERGED,14,19,2,0,1,34,True,0,0,0,2356,33,0.023055555555555555,Document
TypeScript,1297,21107,478.95991898148145,CLOSED,448,1439,21,2,33,3,False,0,2,2,8625,1887,506.4505555555556,Bug
JavaScript,34,25,257.38148148148144,MERGED,2,3,1,0,1,5,False,0,0,0,2087,5,69.3525,Bug
TypeScript,2147,14725,1535.0217708333332,MERGED,5893,1653,38,0,3,771,False,0,0,0,10391,7546,26.43722222222222,Bug
Python,4517,54993,983.818900462963,CLOSED,0,11,1,0,2,0,False,0,0,0,4132,11,858.4166666666666,Document
Python,2409,12192,300.01591435185185,MERGED,20,29,1,0,3,371,True,0,0,0,3896,49,0.17805555555555555,Document
TypeScript,4,33,819.6112731481481,MERGED,26,195,13,1,4,4,False,0,1,1,2564,221,113.57888888888888,Bug
Java,450,746,4130.100127314815,MERGED,5,15,5,1,7,62,False,0,1,1,3259,20,95.29527777777778,Bug
TypeScript,3393,2334,1025.2735069444445,MERGED,32,36,3,2,1,0,False,0,2,1,3120,68,13.993055555555555,Bug
TypeScript,1073,11366,1151.6262847222222,MERGED,34,34,2,1,1,223,False,0,1,1,2599,68,1.5377777777777777,Bug
TypeScript,41369,87416,2994.8964814814813,MERGED,1,82,6,1,1,71,False,0,1,1,6780,83,21.90972222222222,Document
JavaScript,5140,7051,1261.8915625,MERGED,47,783,14,2,6,0,False,0,2,2,6936,830,88.54527777777778,Feature
TypeScript,2147,14725,1530.9366898148148,MERGED,125,701,12,0,1,768,False,0,0,0,12010,826,68.97472222222223,Bug
TypeScript,41369,87416,2994.7535069444443,MERGED,2,44,6,1,1,69,False,0,1,1,4595,46,4.2075,Document
TypeScript,7,6,705.9155671296297,CLOSED,0,0,0,0,20,39,True,0,0,0,9659,0,196.7397222222222,Feature
Go,752,2399,785.6154861111112,MERGED,1179,6542,61,0,73,72,False,0,0,0,10902,7721,463.49555555555554,Document
Python,4517,54993,985.7577083333334,MERGED,0,62,2,0,3,1,False,0,0,0,4245,62,476.3019444444444,Document
PHP,883,2338,1896.1050694444446,CLOSED,10,260,20,0,23,5,False,0,0,0,7700,270,23.36277777777778,Document
TypeScript,1297,21107,479.90405092592596,MERGED,0,290,7,1,6,1138,True,0,1,1,8582,290,1.5902777777777777,Document
Python,137,75,748.6044907407407,MERGED,30,99,14,0,3,27,False,0,0,0,4246,129,45.32555555555555,Document
Python,1912,12142,129.18016203703704,MERGED,2,32,2,1,3,1,False,0,1,1,1780,34,11.359166666666667,Feature
Starlark,440,286,554.1311805555555,MERGED,29,123,1,1,2,1,False,0,1,1,3757,152,18.00777777777778,Feature
Starlark,440,286,554.0760300925925,MERGED,24,50,3,1,29,7,False,0,1,1,3335,74,19.344722222222224,Feature
TypeScript,41369,87416,3000.4321064814812,MERGED,401,1057,37,2,13,205,False,0,2,2,8964,1458,0.8105555555555556,Document
TypeScript,4,33,826.6184953703704,MERGED,313,954,27,1,20,398,True,0,1,1,4825,1267,17.460833333333333,Feature
Python,547,7161,2301.639236111111,MERGED,4,13,2,0,5,40,False,0,0,0,3080,17,22.26222222222222,Bug
TypeScript,41369,87416,2997.785613425926,MERGED,227,220,15,2,9,499,True,0,2,2,9712,447,0.8347222222222223,Document
Python,4517,54993,986.1233333333333,MERGED,3,9,2,1,3,1,False,1,0,0,4020,12,41.66888888888889,Document
TypeScript,3393,2334,1029.1408796296296,MERGED,35,61,10,1,1,745,False,0,1,1,4151,96,0.2313888888888889,Feature
TypeScript,41369,87416,2995.996076388889,MERGED,36,419,21,1,10,497,True,0,1,1,7843,455,0.5894444444444444,Document
Python,2409,12192,299.02032407407404,MERGED,23,24,11,1,14,370,True,1,0,0,3425,47,6.9255555555555555,Document
Python,4517,54993,985.6735300925926,CLOSED,3,2,1,0,1,0,False,0,0,0,4080,5,0.1736111111111111,Document
Python,137,75,743.0875,MERGED,0,124,35,0,1,220,False,0,0,0,4454,124,0.115,Document
TypeScript,1073,11366,1153.6907291666666,MERGED,750,1118,17,1,21,295,True,0,1,1,3511,1868,46.23361111111111,Bug
TypeScript,41369,87416,2994.9716319444447,MERGED,30,159,21,2,11,495,True,0,2,2,7683,189,0.49666666666666665,Document
Python,4517,54993,984.8768634259259,CLOSED,8,12,1,0,3,0,False,0,0,0,3283,20,0.01138888888888889,Document
Go,1835,11246,1791.6503125,MERGED,0,41,5,0,1,35,True,0,0,0,3821,41,2.999722222222222,Document
TypeScript,3393,2334,1025.9282638888888,CLOSED,450,509,4,4,2,164,False,1,3,2,4029,959,3.513333333333333,Feature
Go,1835,11246,1789.9001967592592,MERGED,22,62,6,0,4,111,False,0,0,0,3681,84,0.13805555555555554,Document
TypeScript,1073,11366,1151.5932060185185,MERGED,25,155,3,1,4,222,False,0,1,1,4059,180,1.173888888888889,Bug
TypeScript,1073,11366,1151.562222222222,MERGED,34,351,3,1,6,221,False,0,1,1,3952,385,1.5669444444444445,Feature
Go,1835,11246,1786.829849537037,MERGED,106,125,5,0,1,70,False,0,0,0,4288,231,65.70222222222222,Document
Go,421,1654,1570.993287037037,MERGED,52,1242,24,0,22,120,False,0,0,0,12098,1294,196.44305555555556,Document
TypeScript,202,107,1201.8133564814814,MERGED,5352,10165,272,8,13,273,True,2,6,4,8038,15517,455.94666666666666,Bug
Python,1912,12142,129.0415162037037,CLOSED,3,14,5,1,2,13,False,1,0,0,2687,17,1.1630555555555555,Bug
TypeScript,41369,87416,2998.5807291666665,MERGED,5036,15015,189,4,103,76,True,1,3,3,11912,20051,3.26,Document
JavaScript,22,26,980.7540277777779,MERGED,11,114,9,1,1,23,True,1,0,0,7082,125,28.92361111111111,Document
Python,1912,12142,127.9845023148148,CLOSED,12,1439,9,0,1,0,False,0,0,0,3510,1451,0.010833333333333334,Document
Python,2409,12192,303.2301388888889,MERGED,23,77,19,0,3,380,True,0,0,0,5171,100,0.03888888888888889,Document
TypeScript,1073,11366,1157.9485648148147,MERGED,3,63,15,0,6,22,True,0,0,0,6118,66,0.46,Bug
TypeScript,4,33,825.0640625,MERGED,14322,11860,38,2,2,258,True,1,1,1,7978,26182,0.23055555555555557,Bug
TypeScript,1073,11366,1156.8904282407407,CLOSED,8,61,14,2,3,21,True,1,1,1,5746,69,25.406944444444445,Bug
TypeScript,3393,2334,1025.1615277777778,MERGED,25,19,10,4,3,0,False,1,3,2,5557,44,90.03027777777778,Bug
Starlark,440,286,549.2072106481481,MERGED,61,132,1,1,1,86,False,0,1,1,6085,193,62.17861111111111,Feature
JavaScript,2,1,378.3096296296296,MERGED,184,204,10,0,1,34,False,0,0,0,6606,388,0.19666666666666666,Document
Starlark,440,286,547.373425925926,MERGED,31,166,2,1,9,1,False,0,1,1,5272,197,106.15638888888888,Document
TypeScript,1073,11366,1153.9153819444443,MERGED,69,193,4,1,5,297,True,0,1,1,6009,262,37.579166666666666,Document
TypeScript,1073,11366,1153.6919444444445,MERGED,91,217,16,1,9,296,True,0,1,1,6422,308,43.049166666666665,Bug
Python,2409,12192,297.25412037037034,MERGED,72,90,7,6,12,367,True,4,2,2,6058,162,0.43222222222222223,Document
Go,1835,11246,1785.6344328703706,MERGED,61,84,13,0,1,17,False,0,0,0,6284,145,6.229722222222223,Document
Go,1835,11246,1791.6078935185185,MERGED,395,1366,7,1,1,46,False,0,1,1,5627,1761,5.841388888888889,Document
TypeScript,1073,11366,1152.538136574074,MERGED,49,105,5,1,4,227,False,0,1,1,6332,154,1.3102777777777779,Bug
Go,1835,11246,1789.7906018518518,MERGED,55,73,17,0,2,110,False,0,0,0,6366,128,0.2475,Document
TypeScript,1073,11366,1151.7048148148149,MERGED,35,79,4,1,3,294,True,0,1,1,6060,114,0.5286111111111111,Bug
TypeScript,7,6,702.9180092592593,MERGED,909,275,35,3,23,230,False,1,2,2,16494,1184,337.99916666666667,Document
TypeScript,1073,11366,1156.6083333333333,MERGED,72,494,29,1,23,147,True,0,1,1,10263,566,456.9844444444444,Feature
TypeScript,4803,40786,3822.688078703704,MERGED,21,248,21,1,1,157,True,0,1,1,8216,269,169.0077777777778,Bug
Python,2409,12192,304.03494212962966,MERGED,68,140,17,0,26,384,True,0,0,0,9536,208,6.179444444444444,Document
TypeScript,4,33,826.1545023148147,MERGED,729,1178,44,1,8,397,True,0,1,1,9165,1907,4.461944444444445,Document
Python,4517,54993,985.4440625000001,CLOSED,41,130,7,2,26,113,True,1,1,1,9334,171,173.67833333333334,Document
TypeScript,4,33,825.3889236111112,MERGED,101,282,11,1,13,399,False,0,1,1,8471,383,0.2725,Bug
TypeScript,3393,2334,1030.182673611111,MERGED,105,239,35,1,9,747,False,0,1,1,11062,344,16.70138888888889,Feature
Go,1835,11246,1789.6396875,MERGED,90,87,59,0,1,575,False,0,0,0,7566,177,0.24444444444444444,Document
TypeScript,4,33,825.6273958333333,MERGED,26,994,36,1,9,396,True,0,1,1,9627,1020,10.960555555555555,Document
C++,2234,23696,2420.0085532407406,CLOSED,267,517,24,1,21,20,False,0,1,1,24696,784,47.7725,Bug
TypeScript,17,33,780.8817013888888,MERGED,290,892,29,5,4,61,False,2,3,2,13507,1182,96.39472222222223,Bug
Go,1835,11246,1790.529085648148,MERGED,122,691,21,0,2,45,False,0,0,0,12639,813,1.7041666666666666,Document
TypeScript,4,33,821.7191087962964,MERGED,401,763,27,1,16,237,False,0,1,1,19800,1164,95.29694444444445,Bug
JavaScript,5140,7051,1273.89,MERGED,9,9,6,10,4,0,False,2,8,4,1042,18,596.6247222222222,Bug
TypeScript,12,11,1059.1749305555556,MERGED,1,1,1,0,1,0,False,0,0,0,1105,2,0.4286111111111111,Feature
TypeScript,261,3765,745.7469560185185,MERGED,3,16,2,0,1,277,True,0,0,0,1866,19,530.26,Document
TypeScript,2147,14725,1542.7927083333334,MERGED,2,2,1,0,1,185,False,0,0,0,783,4,0.5877777777777777,Bug
JavaScript,5140,7051,1274.2744560185185,CLOSED,1,1,1,1,1,0,False,0,1,1,539,2,0.6283333333333333,Bug
TypeScript,2147,14725,1541.9425578703704,MERGED,21,42,1,0,1,211,False,0,0,0,1090,63,0.5155555555555555,Feature
TypeScript,85,724,384.18375,MERGED,0,6,1,0,1,122,False,0,0,0,1144,6,0.09277777777777778,Document
TypeScript,85,724,384.01689814814813,MERGED,12,22,1,0,1,48,False,0,0,0,1122,34,4.194166666666667,Document
JavaScript,5140,7051,1274.0345023148147,MERGED,23,17,2,1,6,113,False,0,1,1,626,40,62.225833333333334,Document
TypeScript,85,724,384.0090740740741,MERGED,0,5,1,0,1,47,False,0,0,0,1165,5,0.2311111111111111,Document
TypeScript,2147,14725,1537.8046064814814,MERGED,0,1,1,0,2,687,False,0,0,0,720,1,21.865555555555556,Bug
TypeScript,2147,14725,1537.7588194444445,MERGED,1,1,1,0,1,204,False,0,0,0,620,2,1.2030555555555555,Bug
TypeScript,2147,14725,1538.0948379629629,MERGED,1,1,1,0,1,207,False,0,0,0,745,2,14.885833333333334,Bug
JavaScript,5140,7051,1273.7361574074073,MERGED,2,1,1,1,1,18,False,0,1,1,498,3,0.15416666666666667,Feature
JavaScript,5140,7051,1273.7283564814813,CLOSED,19074,10303,3,2,3,17,False,1,1,1,504,29377,0.2338888888888889,Feature
JavaScript,5140,7051,1273.6631828703705,MERGED,0,73,1,1,1,112,False,0,1,1,675,73,2.0819444444444444,Document
V,2097,34361,1621.2409027777778,MERGED,13,7,1,0,1,52,True,0,0,0,485,20,5.640555555555555,Feature
Python,547,7161,2307.4695023148147,CLOSED,4,6,2,0,2,242,False,0,0,0,960,10,405.4769444444444,Bug
Go,421,1654,1574.9559953703704,CLOSED,0,1,1,0,1,251,False,0,0,0,860,1,0.7505555555555555,Bug
Go,421,1654,1579.1922800925925,MERGED,1,1,1,0,1,74,False,0,0,0,913,2,0.7988888888888889,Bug
Go,421,1654,1579.2019212962962,MERGED,1,5,1,0,1,492,True,0,0,0,909,6,19.692222222222224,Bug
Python,547,7161,2307.7446180555557,MERGED,1,1,1,1,4,243,False,1,0,0,705,2,22.400277777777777,Bug
TypeScript,261,3765,746.5027546296296,MERGED,0,44,3,0,1,207,False,0,0,0,1535,44,0.44583333333333336,Document
Go,421,1654,1578.989074074074,MERGED,1,14,1,2,1,252,False,1,1,1,915,15,6.877222222222223,Bug
Python,547,7161,2306.7126504629628,CLOSED,4,19,4,1,1,315,True,1,0,0,881,23,357.37333333333333,Bug
TypeScript,261,3765,745.8219328703703,MERGED,2,13,2,0,3,151,True,0,0,0,1494,15,0.2827777777777778,Document
TypeScript,12,11,1053.2797685185185,MERGED,14,14,1,0,1,228,False,0,0,0,1292,28,5.102222222222222,Feature
PHP,1334,2960,4272.029398148148,CLOSED,4,4,1,8,1,0,False,1,7,4,1756,8,505.6872222222222,Feature
TypeScript,261,3765,745.7126504629629,MERGED,4,12,2,0,2,254,False,0,0,0,1384,16,0.37416666666666665,Document
Python,19250,70266,2530.475775462963,CLOSED,50,24,3,1,4,1647,False,1,0,0,152,74,21.58222222222222,Feature
JavaScript,5140,7051,1274.271736111111,CLOSED,1,1,1,1,1,0,False,0,1,1,741,2,0.6933333333333334,Document
TypeScript,85,724,380.35627314814815,MERGED,1,1,1,0,2,11,False,0,0,0,1151,2,15.165,Document
TypeScript,261,3765,744.8465972222222,MERGED,0,10,2,0,4,150,True,0,0,0,1286,10,16.801111111111112,Document
TypeScript,85,724,385.2235185185186,MERGED,2,3,3,0,1,49,False,0,0,0,1609,5,0.034444444444444444,Document
TypeScript,12,11,1056.132974537037,MERGED,15,16,3,0,1,230,False,0,0,0,1705,31,76.56611111111111,Feature
TypeScript,261,3765,744.8342361111112,MERGED,2,2,2,0,1,286,True,0,0,0,1571,4,0.08333333333333333,Document
TypeScript,85,724,380.17043981481487,MERGED,1,1,1,0,2,10,False,0,0,0,1179,2,0.4652777777777778,Document
TypeScript,261,3765,744.7963773148149,CLOSED,7,7,2,0,2,149,True,0,0,0,1364,14,0.5672222222222222,Document
TypeScript,85,724,380.0145370370371,MERGED,0,1,1,0,1,119,False,0,0,0,1072,1,0.12472222222222222,Document
TypeScript,2147,14725,1541.8178240740742,MERGED,15,18,2,0,1,184,False,0,0,0,1372,33,1.4436111111111112,Bug
TypeScript,85,724,379.9434375,MERGED,0,1,1,0,2,196,False,0,0,0,1084,1,0.11722222222222223,Document
TypeScript,261,3765,744.5141666666667,MERGED,5,16,2,0,1,651,True,0,0,0,1399,21,1.1455555555555557,Document
Go,421,1654,1574.2356944444446,MERGED,0,5,1,0,1,72,False,0,0,0,734,5,17.43111111111111,Bug
TypeScript,2147,14725,1541.0511458333333,MERGED,7,7,2,0,1,210,False,0,0,0,1061,14,0.3894444444444444,Feature
Vue,10808,21163,1093.0105787037037,MERGED,14,4,3,0,2,193,False,0,0,0,2163,18,557.7505555555556,Document
TypeScript,7046,76150,2699.3137384259257,MERGED,2,2,2,3,1,116,False,0,3,2,615,4,0.18472222222222223,Document
TypeScript,261,3765,745.7479166666667,MERGED,12,23,2,0,1,287,True,0,0,0,2048,35,137.49777777777777,Document
TypeScript,85,724,384.1160995370371,MERGED,1,8,1,0,1,121,False,0,0,0,1768,9,1.2763888888888888,Document
TypeScript,2147,14725,1540.9768981481482,MERGED,3,75,1,0,1,209,False,0,0,0,1514,78,0.7866666666666666,Bug
TypeScript,2147,14725,1540.9578587962963,MERGED,2,7,1,0,1,183,False,0,0,0,1610,9,1.01,Feature
Go,752,2399,796.7625462962964,CLOSED,0,4,1,0,1,157,False,0,0,0,822,4,236.79055555555556,Bug
TypeScript,2147,14725,1540.7987962962964,CLOSED,9,136,2,0,2,58,False,0,0,0,1242,145,0.31333333333333335,Feature
V,2097,34361,1620.7862847222223,MERGED,2,41,3,0,4,262,True,0,0,0,681,43,49.67722222222222,Bug
Python,547,7161,2306.7088194444445,MERGED,15,1,2,0,2,314,True,0,0,0,669,16,0.44416666666666665,Bug
TypeScript,7,6,713.0243518518519,MERGED,298,227,16,0,9,242,False,0,0,0,1195,525,75.1463888888889,Feature
Go,752,2399,796.4483449074074,MERGED,1,1,1,0,1,156,False,0,0,0,732,2,0.32916666666666666,Bug
Go,752,2399,792.7201736111111,MERGED,0,3,1,0,1,155,False,0,0,0,798,3,0.16527777777777777,Bug
TypeScript,7046,76150,2698.0521180555556,MERGED,13,13,1,3,1,114,False,0,3,2,747,26,0.0077777777777777776,Feature
Python,547,7161,2307.3795601851853,MERGED,26,53,5,0,2,27,True,0,0,0,1043,79,1.5997222222222223,Bug
TypeScript,7046,76150,2698.0236226851853,MERGED,0,1,1,3,1,113,False,0,3,2,620,1,0.3844444444444444,Bug
TypeScript,12,11,1054.3487152777777,MERGED,31,25,5,0,3,392,False,0,0,0,1528,56,0.4361111111111111,Bug
Go,395,660,1333.8666550925925,MERGED,13,13,1,1,2,52,False,0,1,1,237,26,505.3591666666667,Feature
Python,547,7161,2306.7442824074074,MERGED,37,178,5,3,10,26,True,2,1,1,1173,215,43.670833333333334,Bug
TypeScript,178,1359,391.77402777777775,MERGED,27,62,4,2,1,49,True,0,2,2,1869,89,0.10694444444444444,Feature
PHP,1334,2960,4277.067280092592,MERGED,6,10,2,1,3,883,False,0,1,1,1373,16,47.92027777777778,Bug
TypeScript,261,3765,740.519050925926,MERGED,0,138,2,0,5,1018,True,0,0,0,1636,138,320.0513888888889,Document
V,2097,34361,1621.2300925925927,MERGED,16,4,2,0,3,51,True,0,0,0,1574,20,6.003888888888889,Bug
TypeScript,261,3765,745.7237268518519,MERGED,18,32,2,0,3,228,True,0,0,0,1676,50,20.619722222222222,Document
Python,547,7161,2303.4735300925927,MERGED,0,13,1,0,4,3,False,0,0,0,645,13,96.43777777777778,Document
TypeScript,261,3765,745.851712962963,MERGED,7,16,2,0,3,255,False,0,0,0,2100,23,0.23333333333333334,Document
V,2097,34361,1617.2902199074076,MERGED,2,2,1,0,1,23,True,0,0,0,463,4,4.444444444444445,Feature
TypeScript,58,78,886.2270601851851,MERGED,3,6,2,1,3,134,False,0,1,1,2205,9,118.79166666666667,Feature
TypeScript,261,3765,745.6995949074075,MERGED,29,22,3,1,2,1026,True,1,0,0,2202,51,1.415,Document
TypeScript,2147,14725,1542.2629282407406,MERGED,2,272,4,0,1,46,False,0,0,0,2101,274,16.92,Feature
TypeScript,2070,16643,1312.5215856481482,MERGED,2,2,1,0,1,1,False,0,0,0,1639,4,282.05805555555554,Bug
Go,421,1654,1573.9652662037035,MERGED,3,6,1,0,1,488,True,0,0,0,1016,9,4.021944444444444,Document
TypeScript,7,6,715.0887731481481,CLOSED,1095,398,50,0,51,1,False,0,0,0,1932,1493,220.61694444444444,Feature
Vue,293,495,899.8890277777778,MERGED,4,11,4,6,2,417,False,0,6,5,1037,15,26.703055555555554,Bug
Vue,10809,21163,1092.1081018518519,MERGED,1,1,1,2,1,0,False,0,2,2,1373,2,89.49444444444444,Bug
TypeScript,85,724,384.2364583333333,MERGED,0,3,1,0,1,19,False,0,0,0,2103,3,43.33722222222222,Document
TypeScript,2147,14725,1538.0935185185183,CLOSED,2,2,2,0,1,206,False,0,0,0,1199,4,0.021388888888888888,Bug
JavaScript,5140,7051,1269.7033680555555,MERGED,0,10,2,1,2,16,False,0,1,1,987,10,0.23805555555555555,Document
TypeScript,261,3765,740.7456712962962,MERGED,4,4,2,0,1,253,False,0,0,0,1339,8,0.02861111111111111,Document
Go,421,1654,1580.0193055555555,MERGED,85,97,6,0,3,494,True,0,0,0,2149,182,119.54277777777777,Bug
TypeScript,261,3765,740.5402430555555,MERGED,2,3,3,3,1,1019,True,1,2,1,1655,5,0.1125,Document
TypeScript,85,724,380.34540509259256,MERGED,707,714,143,1,4,197,False,0,1,1,1932,1421,18.259444444444444,Document
TypeScript,261,3765,744.7057870370371,MERGED,4,82,5,0,1,1022,True,0,0,0,1939,86,0.07416666666666667,Document
Vue,10809,21163,1088.3845833333332,CLOSED,1,1,1,2,1,0,False,1,1,1,1212,2,260.89222222222224,Bug
TypeScript,61,71,1742.1062731481481,MERGED,1,3,1,0,1,15,True,0,0,0,818,4,0.06944444444444445,Feature
PHP,1334,2960,4275.952696759259,MERGED,1,10,1,1,1,91,False,0,1,1,1515,11,1.741111111111111,Document
JavaScript,5140,7051,1273.7042013888888,MERGED,6,11,1,3,1,66,False,0,3,2,1620,17,22.975833333333334,Bug
Go,752,2399,796.6706712962963,MERGED,124,91,7,0,13,454,False,0,0,0,777,215,53.234722222222224,Bug
TypeScript,7046,76150,2699.3025810185186,MERGED,89,0,2,3,1,115,False,0,3,2,1173,89,0.25055555555555553,Feature
V,2097,34361,1621.537164351852,MERGED,1,63,2,0,2,263,True,0,0,0,739,64,31.7175,Bug
Go,752,2399,797.4130439814816,CLOSED,2,3,2,0,14,1,False,0,0,0,820,5,2.6972222222222224,Document
Python,547,7161,2303.5881828703705,MERGED,1,2,1,0,2,246,False,0,0,0,665,3,0.31722222222222224,Bug
TypeScript,202,107,1213.7300925925927,MERGED,90,54,8,3,6,283,True,1,2,2,1297,144,16.08972222222222,Feature
PHP,1334,2960,4277.782349537037,MERGED,3243,3442,233,4,1,0,False,1,3,3,983,6685,34.480555555555554,Document
TypeScript,85,724,379.9913194444444,MERGED,3,3,1,0,1,18,False,0,0,0,1471,6,1.3002777777777779,Document
TypeScript,85,724,379.9201388888889,MERGED,2,2,2,0,1,195,False,0,0,0,1455,4,0.09638888888888889,Document
C++,2234,23696,2422.0033217592595,MERGED,103,173,21,1,5,23,False,0,1,1,817,276,145.12222222222223,Bug
Vue,10809,21163,1092.0186226851852,MERGED,2,4,2,0,1,191,False,0,0,0,1308,6,2.3205555555555555,Bug
TypeScript,2070,16643,1308.574537037037,MERGED,1,3,1,0,1,2,False,0,0,0,1910,4,378.7811111111111,Bug
Vue,10809,21163,1091.902037037037,CLOSED,2,5,1,2,1,0,False,0,2,2,1278,7,3.8091666666666666,Bug
TypeScript,261,3765,742.6535416666667,MERGED,4,10,2,0,3,148,True,0,0,0,1773,14,45.246944444444445,Document
V,2097,34361,1620.5144097222221,MERGED,4,3,2,0,2,50,True,0,0,0,740,7,7.799722222222222,Bug
TypeScript,15,34,559.4403935185186,MERGED,446,1132,17,0,14,522,True,0,0,0,487,1578,555.0611111111111,Feature
TypeScript,4,33,831.1337847222222,MERGED,4,13,1,1,2,656,True,0,1,1,75,17,0.04472222222222222,Feature
Go,11875,71345,2764.7501388888886,MERGED,3,3,2,0,1,302,True,0,0,0,210,6,0.0425,Bug
PHP,1334,2960,4277.178078703703,CLOSED,1,1,1,2,1,4,False,1,1,1,1826,2,0.1388888888888889,Document
TypeScript,15,34,559.6941782407407,MERGED,6,13,1,0,1,192,False,0,0,0,231,19,182.10305555555556,Feature
PHP,1334,2960,4277.01162037037,MERGED,2,2,2,1,1,93,False,0,1,1,1955,4,22.808888888888887,Document
Go,2083,11770,1588.7972800925927,MERGED,4,6,2,0,2,941,True,0,0,0,1149,10,0.26555555555555554,Document
TypeScript,7,6,715.116388888889,CLOSED,38,57,1,0,1,291,False,0,0,0,2327,95,314.1069444444444,Bug
TypeScript,7,6,715.1446875,MERGED,10,163,3,0,7,244,False,0,0,0,1640,173,24.455833333333334,Bug
TypeScript,202,107,1208.7204166666668,MERGED,442,0,3,2,2,15,True,0,2,2,1472,442,500.4191666666667,Document
Python,547,7161,2302.4959722222225,MERGED,6,12,1,0,4,625,True,0,0,0,769,18,118.42611111111111,Document
C++,2234,23696,2421.8028819444444,MERGED,13,50,1,1,10,64,False,0,1,1,945,63,29.733333333333334,Document
TypeScript,261,3765,740.7815509259259,MERGED,11,20,2,0,1,128,False,0,0,0,2027,31,38.95611111111111,Document
JavaScript,5140,7051,1269.769050925926,CLOSED,28,166,28,1,19,103,False,0,1,1,1185,194,73.15583333333333,Feature
TypeScript,7,6,713.886724537037,MERGED,322,347,5,0,5,302,False,0,0,0,2239,669,0.7766666666666666,Bug
TypeScript,7,6,715.001412037037,MERGED,2,4,2,1,2,236,False,0,1,1,1324,6,0.8733333333333333,Feature
TypeScript,7,6,714.9821643518518,MERGED,3,3,2,1,1,235,False,1,0,0,1200,6,0.5241666666666667,Bug
TypeScript,202,107,1213.493449074074,MERGED,4,4,1,3,3,269,True,0,3,3,1255,8,226.03583333333333,Document
Go,395,660,1334.8109259259259,MERGED,2,7,1,0,2,127,False,0,0,0,174,9,145.69027777777777,Bug
PHP,1334,2960,4276.099768518518,MERGED,3,3,1,1,1,92,False,0,1,1,1771,6,28.17111111111111,Document
TypeScript,178,1359,391.79403935185184,MERGED,7,202,4,7,5,50,True,3,4,2,2506,209,2.0919444444444446,Feature
TypeScript,12,11,1058.3251967592594,MERGED,6,349,3,0,3,72,False,0,0,0,2931,355,30.723055555555554,Bug
Go,30,295,414.22836805555556,MERGED,5,61,4,0,1,45,True,0,0,0,3351,66,50.03388888888889,Feature
TypeScript,7,6,714.4087731481482,CLOSED,6,6,6,1,1,231,False,0,1,1,1752,12,0.0811111111111111,Document
TypeScript,261,3765,740.7131828703704,MERGED,1,6,2,0,1,252,False,0,0,0,1950,7,0.42194444444444446,Document
TypeScript,261,3765,746.5413425925926,MERGED,1,48,5,0,1,1031,True,0,0,0,2282,49,0.2511111111111111,Document
TypeScript,261,3765,746.4801157407406,MERGED,2,8,2,1,2,0,False,0,1,1,2694,10,0.2338888888888889,Document
TypeScript,85,724,385.3487615740741,MERGED,186,84,6,1,7,12,False,0,1,1,3388,270,20.923333333333332,Document
TypeScript,12,11,1057.4764814814814,MERGED,5,557,5,0,4,186,False,0,0,0,2747,562,20.669166666666666,Feature
TypeScript,85,724,385.0471643518519,MERGED,444,0,7,0,2,200,False,0,0,0,2730,444,25.80638888888889,Document
TypeScript,2147,14725,1536.8097569444444,MERGED,5,25,2,1,4,775,False,1,0,0,2526,30,4.35,Feature
Python,547,7161,2305.8820486111113,MERGED,5,5,1,0,5,0,False,0,0,0,265,10,205.02277777777778,Bug
TypeScript,261,3765,745.5896064814815,MERGED,9,48,3,0,2,1025,True,0,0,0,2205,57,1.2397222222222222,Document
Go,395,660,1334.9400925925927,MERGED,1,1,1,0,1,129,False,0,0,0,195,2,28.696666666666665,Bug
F#,153,337,2986.505092592593,MERGED,1,13,2,1,1,43,False,0,1,1,1770,14,4.320277777777778,Bug
Python,547,7161,2303.6058680555557,MERGED,2,2,1,0,2,0,False,0,0,0,439,4,260.09694444444443,Document
F#,153,337,2985.802210648148,MERGED,2,2,2,0,1,36,False,0,0,0,1639,4,0.4236111111111111,Bug
V,2097,34361,1619.735486111111,MERGED,3,3,2,0,2,48,True,0,0,0,966,6,11.070833333333333,Document
F#,271,818,2794.395162037037,MERGED,6,10,1,0,1,14,True,0,0,0,1646,16,0.028055555555555556,Document
Go,395,660,1334.9374537037036,MERGED,301,431,16,1,7,36,False,1,0,0,667,732,485.4761111111111,Bug
TypeScript,7046,76150,2699.3249537037036,MERGED,4,4,2,3,1,117,False,0,3,2,1788,8,0.1661111111111111,Feature
TypeScript,15,34,558.5170717592592,MERGED,8,0,1,0,1,1058,False,0,0,0,231,8,3.1327777777777777,Feature
V,2097,34361,1621.6626157407409,MERGED,3,20,1,0,3,17,True,0,0,0,1140,23,28.615277777777777,Document
Vue,10809,21163,1092.7963657407406,MERGED,31,31,1,0,1,192,False,0,0,0,1438,62,8.260277777777778,Document
Java,450,746,4138.15943287037,MERGED,2,81,2,0,4,15,False,0,0,0,235,83,116.06138888888889,Bug
JavaScript,9664,43890,3727.1876157407405,MERGED,3,3,1,0,1,644,False,0,0,0,425,6,167.93916666666667,Feature
PHP,883,2338,1901.001597222222,CLOSED,1,1,1,0,1,11,False,0,0,0,1427,2,2.4791666666666665,Document
TypeScript,7,6,714.0108796296296,MERGED,25,173,35,0,4,303,False,0,0,0,409,198,21.278333333333332,Feature
Vue,10809,21163,1090.7479861111112,CLOSED,10,57,2,3,2,4,False,2,1,1,2054,67,104.41,Bug
Go,395,660,1334.108738425926,MERGED,9,72,1,0,1,126,False,0,0,0,281,81,162.31416666666667,Feature
Python,547,7161,2306.5241666666666,MERGED,20,54,3,0,17,34,False,0,0,0,1375,74,28.119722222222222,Document
TypeScript,12,11,1053.574525462963,MERGED,17,33,7,0,4,391,False,0,0,0,2443,50,87.4025,Bug
JavaScript,9664,43890,3726.976458333333,MERGED,1,1,1,0,1,72,True,0,0,0,350,2,0.03916666666666667,Bug
PHP,1334,2960,4277.192905092593,CLOSED,2,2,2,2,2,5,False,1,1,1,2332,4,65.31777777777778,Document
TypeScript,202,107,1213.5897685185184,MERGED,4,6,3,2,1,282,True,0,2,2,1394,10,0.042222222222222223,Bug
Go,421,1654,1580.0163310185187,MERGED,53,60,4,0,1,493,True,0,0,0,2276,113,0.9272222222222222,Bug
Go,421,1654,1579.9159143518518,CLOSED,35,43,5,1,1,75,False,1,0,0,2800,78,3.6527777777777777,Bug
Python,547,7161,2303.6664467592595,MERGED,18,87,5,0,14,33,False,0,0,0,1552,105,145.4936111111111,Document
Go,752,2399,796.5490046296296,MERGED,15,19,1,0,1,453,False,0,0,0,1448,34,1.013611111111111,Bug
TypeScript,7,6,714.9756944444445,MERGED,33,21,3,0,10,256,False,0,0,0,2168,54,51.485277777777775,Bug
Rust,433,2229,305.00824074074075,MERGED,3,3,2,0,1,194,False,0,0,0,274,6,1.7158333333333333,Feature
TypeScript,202,107,1212.472025462963,MERGED,0,387,5,3,3,281,True,0,3,3,1765,387,33.42,Feature
C++,2234,23696,2422.0007060185185,MERGED,79,220,23,1,5,21,False,0,1,1,1437,299,95.63916666666667,Feature
C#,80,125,889.7783449074074,MERGED,16,16,5,0,4,7,True,0,0,0,345,32,1.291388888888889,Bug
TypeScript,2147,14725,1538.0040277777778,MERGED,39,24,2,0,5,6,False,0,0,0,3043,63,65.78722222222223,Bug
TypeScript,7,6,715.0813194444445,MERGED,1,22,2,0,3,243,False,0,0,0,2411,23,21.435555555555556,Bug
TypeScript,15,34,559.8193981481481,MERGED,2,20,2,0,3,1063,False,0,0,0,302,22,1.5330555555555556,Feature
JavaScript,5140,7051,1272.561736111111,MERGED,58,1066,16,6,15,106,False,5,1,1,2571,1124,170.57361111111112,Feature
TypeScript,15,34,556.583888888889,MERGED,2,0,1,0,1,1054,False,0,0,0,201,2,0.5088888888888888,Feature
Go,395,660,1334.9140625,MERGED,69,61,11,0,1,128,False,0,0,0,342,130,25.8875,Feature
Rust,433,2229,300.79431712962963,MERGED,2,2,1,0,1,188,False,0,0,0,255,4,1.2844444444444445,Bug
TypeScript,15,34,559.4812384259259,MERGED,17,17,1,0,1,150,False,0,0,0,396,34,0.9147222222222222,Feature
Python,547,7161,2303.584965277778,CLOSED,14,54,5,1,12,97,False,1,0,0,1256,68,91.40944444444445,Bug
TypeScript,15,34,559.1728703703703,MERGED,2,2,1,0,1,191,False,0,0,0,416,4,0.5791666666666667,Bug
TypeScript,2147,14725,1542.1513773148147,MERGED,8,142,2,0,1,60,False,0,0,0,1850,150,43.331944444444446,Bug
TypeScript,7,6,712.9450347222222,MERGED,9,90,6,6,16,42,True,0,6,1,2455,99,70.10777777777778,Feature
TypeScript,15,34,558.7114467592593,MERGED,3,5,2,0,1,1061,False,0,0,0,295,8,3.9227777777777777,Feature
TypeScript,15,34,558.691550925926,MERGED,3,5,3,0,1,1060,False,0,0,0,382,8,0.23305555555555554,Feature
TypeScript,15,34,558.6848379629629,MERGED,15,16,1,0,1,1059,False,0,0,0,263,31,0.20777777777777778,Feature
JavaScript,9664,43890,3727.043310185185,MERGED,2,5,1,0,1,318,True,0,0,0,437,7,0.4013888888888889,Feature
JavaScript,9664,43890,3727.0288888888886,MERGED,24,214,9,0,2,330,True,0,0,0,432,238,0.4683333333333333,Feature
JavaScript,9664,43890,3726.917523148148,MERGED,4,15,1,0,2,71,True,0,0,0,505,19,0.09194444444444444,Feature
Go,395,660,1330.8761921296298,MERGED,0,0,1,0,1,80,False,0,0,0,195,0,0.09055555555555556,Feature
TypeScript,261,3765,740.777199074074,MERGED,25,60,7,0,3,206,False,0,0,0,2760,85,0.795,Document
TypeScript,15,34,558.1827546296296,MERGED,3,5,3,0,1,189,False,0,0,0,347,8,0.5227777777777778,Feature
TypeScript,15,34,558.0450925925926,MERGED,91,54,4,0,2,1057,False,0,0,0,368,145,5.026944444444444,Feature
PHP,883,2338,1897.216875,CLOSED,15,0,1,2,1,71,False,0,2,2,1779,15,14.795,Document
TypeScript,15,34,557.5263310185186,MERGED,65,145,4,0,4,1056,False,0,0,0,408,210,12.748333333333333,Feature
TypeScript,15,34,554.3863078703704,MERGED,23,21,2,0,1,519,True,0,0,0,244,44,0.6388888888888888,Feature
JavaScript,9664,43890,3726.0930787037037,MERGED,14,2,1,0,1,315,True,0,0,0,453,16,0.1361111111111111,Feature
Java,450,746,4141.097268518518,MERGED,2,23,2,1,2,22,False,1,0,0,498,25,46.83305555555555,Feature
JavaScript,9664,43890,3725.977835648148,MERGED,1,4,1,0,1,69,True,0,0,0,454,5,0.13305555555555557,Bug
TypeScript,2147,14725,1540.9236458333335,MERGED,8,142,2,0,2,59,False,0,0,0,2174,150,21.390833333333333,Feature
TypeScript,15,34,559.7446180555555,MERGED,40,22,22,1,3,1062,False,0,1,1,415,62,17.11888888888889,Feature
TypeScript,41369,87416,3002.6077662037037,CLOSED,0,0,0,2,2,1625,True,0,2,2,2000,0,392.6438888888889,Document
TypeScript,202,107,1213.987361111111,MERGED,150,249,2,3,8,284,True,0,3,3,2208,399,58.83361111111111,Bug
TypeScript,42,46,838.8119097222221,MERGED,0,21,1,1,1,174,False,0,1,1,459,21,7.284166666666667,Feature
TypeScript,15,34,556.605462962963,MERGED,17,8,3,0,3,1055,False,0,0,0,248,25,0.8044444444444444,Bug
Rust,433,2229,300.48873842592593,MERGED,14,84,6,1,2,1089,False,1,0,0,317,98,5.278888888888889,Document
Go,752,2399,795.4492476851851,MERGED,11,45,2,0,2,306,False,0,0,0,2311,56,96.36083333333333,Bug
Python,72,25,1700.7492708333332,MERGED,4,44,4,2,1,39,False,1,1,1,1776,48,160.87305555555557,Feature
TypeScript,15,34,555.5310532407408,MERGED,170,12,5,0,2,1050,False,0,0,0,319,182,22.281388888888888,Feature
TypeScript,15,34,558.5072222222223,MERGED,9,45,5,0,1,520,True,0,0,0,500,54,0.37916666666666665,Bug
V,2097,34361,1618.3624189814816,MERGED,1,1,1,1,1,0,False,0,1,1,1835,2,74.78055555555555,Document
V,2097,34361,1621.2116203703702,MERGED,2,14,3,0,1,228,True,0,0,0,1787,16,6.484444444444445,Document
TypeScript,15,34,555.7309837962963,CLOSED,268,1,6,0,1,1053,False,0,0,0,352,269,0.07833333333333334,Feature
TypeScript,12,11,1057.6666203703703,MERGED,14,628,7,0,3,71,False,0,0,0,3775,642,46.68555555555555,Feature
F#,153,337,2984.2861689814818,MERGED,12,1,2,0,1,35,False,0,0,0,3021,13,36.04805555555556,Document
TypeScript,12,11,1057.446238425926,MERGED,34,1199,12,0,5,70,False,0,0,0,4456,1233,52.094722222222224,Bug
TypeScript,7046,76150,2695.000821759259,MERGED,8032,1946,77,3,4,111,False,0,3,2,3619,9978,1.9230555555555555,Feature
TypeScript,12,11,1056.1037037037038,MERGED,141,117,18,0,8,229,False,0,0,0,5196,258,106.285,Feature
TypeScript,261,3765,746.6116087962963,MERGED,99,3882,53,0,7,229,True,0,0,0,3368,3981,8.617777777777778,Document
TypeScript,202,107,1213.100462962963,MERGED,1,1,1,4,1,10,False,0,4,4,694,2,80.12805555555556,Bug
TypeScript,15,34,554.7088310185185,MERGED,5,71,3,0,7,372,False,0,0,0,382,76,16.176111111111112,Bug
C#,80,125,889.715949074074,MERGED,2,2,1,0,1,196,False,0,0,0,586,4,41.93333333333333,Document
TypeScript,2070,16643,1308.1600810185184,CLOSED,0,63,5,0,1,0,False,0,0,0,2272,63,0.04972222222222222,Document
TypeScript,261,3765,746.492175925926,MERGED,2,70,6,0,2,1030,True,0,0,0,3060,72,0.3680555555555556,Document
TypeScript,15,34,554.3502430555556,MERGED,52,70,2,0,4,518,True,0,0,0,336,122,15.49388888888889,Feature
JavaScript,9664,43890,3727.1947800925923,MERGED,2,9,1,0,1,73,True,0,0,0,680,11,0.14027777777777778,Bug
TypeScript,261,3765,745.8728935185185,MERGED,3,66,6,0,2,130,False,0,0,0,3885,69,18.713055555555556,Document
JavaScript,9664,43890,3727.0599074074075,MERGED,0,24,1,0,1,319,True,0,0,0,509,24,0.29083333333333333,Document
JavaScript,9664,43890,3726.9046064814816,MERGED,5,57,4,0,3,329,True,0,0,0,525,62,1.7494444444444444,Feature
TypeScript,12,11,1053.5459837962962,MERGED,37,1763,18,0,2,69,False,0,0,0,4584,1800,145.96194444444444,Feature
JavaScript,9664,43890,3723.044155092593,MERGED,2,8,1,0,1,311,True,0,0,0,379,10,0.2738888888888889,Feature
Go,2083,11770,1584.1014351851852,MERGED,97,69,3,0,1,940,True,0,0,0,1393,166,0.6336111111111111,Document
TypeScript,2070,16643,1307.8013773148148,MERGED,4,4,2,0,2,0,False,0,0,0,2736,8,395.5777777777778,Document
TypeScript,202,107,1211.5766435185185,MERGED,5,5,2,3,1,0,False,0,3,3,844,10,116.7063888888889,Bug
TypeScript,261,3765,745.8500347222222,MERGED,15,28,6,0,1,1029,True,0,0,0,3673,43,0.17166666666666666,Document
JavaScript,9664,43890,3722.897662037037,MERGED,1,14,1,0,2,308,True,0,0,0,385,15,0.1411111111111111,Feature
TypeScript,2147,14725,1540.7187037037038,MERGED,24,221,8,0,1,208,False,0,0,0,3926,245,3.2919444444444443,Feature
TypeScript,261,3765,745.8001273148147,MERGED,73,151,12,0,1,1028,True,0,0,0,3619,224,0.5858333333333333,Document
Vue,10809,21163,1092.0635879629629,MERGED,1,1,1,1,1,0,False,0,1,1,977,2,3.843888888888889,Bug
TypeScript,261,3765,745.6495486111112,MERGED,9,35,2,0,1,227,True,0,0,0,3549,44,0.3844444444444444,Document
TypeScript,261,3765,745.6353356481482,MERGED,7,78,7,0,2,129,False,0,0,0,4111,85,0.24194444444444443,Document
JavaScript,5140,7051,1268.8566203703704,MERGED,49,410,10,1,2,334,False,0,1,1,312,459,17.968055555555555,Document
TypeScript,2070,16643,1307.030972222222,MERGED,4,37,2,0,3,0,False,0,0,0,2827,41,414.22805555555556,Bug
Python,547,7161,2303.712928240741,MERGED,2,81,3,1,9,313,True,1,0,0,2055,83,476.745,Bug
TypeScript,2147,14725,1540.181597222222,MERGED,0,43,15,0,1,0,False,0,0,0,3345,43,39.22,Feature
TypeScript,307,2556,606.4636574074074,MERGED,11,19,2,0,1,205,True,0,0,0,1831,30,5.148888888888889,Bug
JavaScript,5140,7051,1268.790300925926,MERGED,20,442,10,2,3,102,False,1,1,1,2973,462,23.496111111111112,Bug
JavaScript,9664,43890,3726.173900462963,MERGED,2,23,4,0,3,317,True,0,0,0,609,25,0.37194444444444447,Bug
JavaScript,9664,43890,3726.1611689814818,MERGED,13,0,1,0,1,316,True,0,0,0,509,13,0.1613888888888889,Feature
JavaScript,9664,43890,3726.0256944444445,MERGED,2,2,1,0,1,314,True,0,0,0,520,4,0.28555555555555556,Bug
JavaScript,9664,43890,3726.0191319444443,MERGED,76,78,1,0,1,328,True,0,0,0,644,154,0.43555555555555553,Bug
TypeScript,15,34,559.2820254629629,MERGED,432,391,22,0,10,521,True,0,0,0,566,823,29.811666666666667,Feature
JavaScript,9664,43890,3722.0274074074073,MERGED,2,2,2,0,2,307,True,0,0,0,418,4,0.2727777777777778,Bug
JavaScript,9664,43890,3725.9040972222224,MERGED,5,4,2,0,1,313,True,0,0,0,522,9,0.11,Feature
Vue,10809,21163,1091.1050694444446,CLOSED,0,4,1,1,1,2,False,0,1,1,975,4,15.428055555555556,Bug
TypeScript,15,34,555.6064583333333,MERGED,9,6,4,0,1,1051,False,0,0,0,473,15,2.743611111111111,Bug
JavaScript,5140,7051,1269.872835648148,MERGED,9602,10210,10,1,4,335,False,0,1,1,458,19812,65.45388888888888,Feature
TypeScript,7,6,714.9536458333333,MERGED,16,101,2,1,8,234,False,0,1,1,2754,117,2.214722222222222,Bug
TypeScript,85,724,380.27612268518516,MERGED,907,1175,26,0,10,46,False,0,0,0,5327,2082,114.45083333333334,Document
TypeScript,15,34,558.4609143518518,MERGED,86,257,16,0,5,190,False,0,0,0,576,343,20.305555555555557,Bug
TypeScript,7,6,712.903298611111,MERGED,510,1500,52,0,126,41,True,0,0,0,3152,2010,96.28333333333333,Bug
TypeScript,12,11,1053.3219328703703,MERGED,56,1144,8,0,4,184,False,0,0,0,3371,1200,99.73916666666666,Bug
TypeScript,178,1359,387.85938657407405,MERGED,27,77,5,2,1,48,True,0,2,2,3654,104,0.9511111111111111,Bug
Go,421,1654,1579.935324074074,MERGED,3,7,2,2,1,3,False,1,1,1,3261,10,0.5447222222222222,Bug
Python,547,7161,2305.5598842592594,MERGED,105,310,16,0,29,241,False,0,0,0,2966,415,525.7277777777778,Document
C#,80,125,885.9417824074075,MERGED,1782,6938,175,0,17,187,False,0,0,0,661,8720,88.44972222222222,Document
TypeScript,12,11,1058.3414236111112,MERGED,607,5815,39,0,11,187,False,0,0,0,7236,6422,580.1205555555556,Feature
JavaScript,5140,7051,1273.8432175925925,MERGED,94,304,29,2,8,337,False,1,1,1,3531,398,139.79861111111111,Bug
TypeScript,1073,11366,1159.547060185185,MERGED,73,391,35,2,11,771,True,0,2,2,694,464,99.1463888888889,Feature
JavaScript,5140,7051,1269.5898148148149,MERGED,55,103,5,2,5,0,False,1,1,1,2044,158,144.95472222222222,Bug
TypeScript,261,3765,742.437824074074,MERGED,60,71,16,0,4,1021,True,0,0,0,3509,131,49.11472222222222,Document
TypeScript,12,11,1054.4040162037038,MERGED,39,18,4,0,1,185,False,0,0,0,3906,57,0.18583333333333332,Bug
Go,421,1654,1579.2005092592592,MERGED,18,13,8,0,2,491,True,0,0,0,4501,31,3.0205555555555557,Bug
TypeScript,307,2556,602.7452199074074,MERGED,9,14,1,0,1,583,True,0,0,0,1457,23,88.88027777777778,Feature
Erlang,2054,12122,3864.176770833333,MERGED,79,33,6,0,2,436,True,0,0,0,1251,112,565.6038888888888,Document
Go,54,355,802.7720138888889,MERGED,1,22,2,0,1,29,False,0,0,0,922,23,140.7461111111111,Bug
Java,450,746,4137.293993055556,MERGED,17,63,6,0,3,21,False,0,0,0,669,80,92.79083333333334,Feature
F#,271,818,2795.7058564814815,MERGED,808,616,8,3,9,0,False,1,2,2,6965,1424,850.8052777777777,Feature
V,2097,34362,1616.273738425926,MERGED,4,24,4,0,2,227,True,0,0,0,1705,28,4.396944444444444,Document
JavaScript,9664,43890,3723.1348958333333,MERGED,1,11,1,0,1,312,True,0,0,0,488,12,0.10888888888888888,Feature
Go,421,1654,1575.1341087962962,CLOSED,142,310,9,3,6,73,False,2,1,1,4123,452,117.34722222222223,Bug
JavaScript,9664,43890,3722.9649884259256,MERGED,0,1,1,0,1,310,True,0,0,0,460,1,0.14694444444444443,Feature
JavaScript,9664,43890,3722.9186921296296,MERGED,19,0,2,0,1,309,True,0,0,0,504,19,0.20305555555555554,Feature
JavaScript,9664,43890,3722.792361111111,MERGED,46,4,3,0,2,327,True,0,0,0,584,50,0.17333333333333334,Bug
TypeScript,41369,87416,3002.5300925925926,MERGED,1,1,1,1,1,0,False,0,1,1,2046,2,0.7383333333333333,Document
Erlang,2054,12122,3865.0305439814815,MERGED,3,4,4,0,2,89,False,0,0,0,817,7,3.0794444444444444,Document
Java,450,746,4137.176388888889,MERGED,11,5,4,0,5,20,False,0,0,0,708,16,21.1575,Feature
JavaScript,9664,43890,3721.8646180555556,CLOSED,9,7,6,0,1,305,True,0,0,0,621,16,25.17111111111111,Feature
JavaScript,9664,43890,3721.9138078703704,MERGED,7,41,7,0,2,306,True,0,0,0,488,48,21.782222222222224,Feature
TypeScript,41369,87416,3001.7982060185186,CLOSED,0,1,1,1,1,2,False,0,1,1,1896,1,15.675277777777778,Document
JavaScript,5140,7051,1272.8238078703705,MERGED,27,169,27,2,3,104,False,1,1,1,4179,196,66.50361111111111,Bug
Starlark,440,286,558.7226273148148,CLOSED,1,1,1,1,1,78,False,0,1,1,985,2,1.8919444444444444,Feature
Go,54,355,803.0105787037037,MERGED,10,350,7,0,4,249,True,0,0,0,3314,360,0.49527777777777776,Feature
Python,2409,12194,308.1546412037037,MERGED,2,2,1,4,3,0,False,2,2,1,998,4,24.173333333333332,Document
TypeScript,261,3765,740.6697106481482,MERGED,59,98,5,0,1,127,False,0,0,0,3162,157,0.775,Document
Erlang,2054,12122,3863.9289930555556,MERGED,1,1,1,0,1,29,True,0,0,0,951,2,1.2058333333333333,Document
Go,395,660,1334.0283912037037,MERGED,60,52,3,0,6,136,False,0,0,0,731,112,164.5388888888889,Feature
TypeScript,1297,21107,484.9914236111111,MERGED,2,65,3,1,1,1149,True,0,1,1,3199,67,0.03305555555555555,Document
TypeScript,41369,87416,3007.5158564814815,MERGED,3,3,3,5,1,2,False,1,4,3,2256,6,53.60527777777778,Document
Python,547,7161,2306.8572916666667,MERGED,37,143,11,0,11,316,True,0,0,0,2411,180,18.863333333333333,Bug
Java,450,746,4142.011215277777,MERGED,8,10,1,0,2,16,False,0,0,0,1243,18,23.65277777777778,Bug
TypeScript,15,34,554.6890509259259,MERGED,8,25,3,0,4,1047,False,0,0,0,533,33,19.37527777777778,Feature
TypeScript,15,34,559.7551388888888,CLOSED,31,70,4,0,9,72,False,0,0,0,752,101,72.6,Feature
TypeScript,3393,2334,1036.7946527777779,MERGED,2,2,1,1,1,169,False,0,1,1,1113,4,2.2041666666666666,Feature
TypeScript,4,33,832.1172337962963,MERGED,5,1,1,1,2,406,False,0,1,1,983,6,0.13944444444444445,Feature
TypeScript,15,34,554.7812731481482,MERGED,438,276,30,0,7,1048,False,0,0,0,498,714,0.7191666666666666,Feature
TypeScript,2070,16643,1308.1608217592593,CLOSED,0,129,9,1,2,1,False,0,1,1,2925,129,50.01027777777778,Document
TypeScript,2070,16643,1308.0411921296297,MERGED,8,19,1,1,2,0,False,0,1,1,2975,27,389.7963888888889,Document
C#,80,125,888.9191782407407,MERGED,24,186,10,0,7,193,False,0,0,0,919,210,41.2625,Document
V,2097,34362,1620.3805555555555,MERGED,22,41,2,1,6,49,True,1,0,0,2542,63,7.329444444444444,Bug
TypeScript,41369,87416,3007.606157407407,MERGED,1,2,1,2,1,620,True,0,2,2,2601,3,0.5733333333333334,Document
TypeScript,41369,87416,3007.495034722222,MERGED,0,158,2,2,1,619,True,0,2,2,2609,158,0.34305555555555556,Document
TypeScript,41369,87416,3007.488298611111,MERGED,1,3,3,2,1,1951,True,0,2,2,2644,4,0.49027777777777776,Document
TypeScript,1297,21107,484.00567129629627,MERGED,0,207,12,1,2,1147,True,0,1,1,2076,207,0.12833333333333333,Document
TypeScript,41369,87416,3007.4283217592597,MERGED,3,2,2,2,1,618,True,0,2,2,2448,5,1.1175,Document
JavaScript,9664,43890,3725.9811458333334,MERGED,0,283,1,0,1,70,True,0,0,0,732,283,0.1288888888888889,Feature
JavaScript,9664,43890,3725.9789467592595,MERGED,2,2,1,0,1,643,False,0,0,0,696,4,0.029444444444444443,Bug
TypeScript,495,2659,1972.5075462962961,MERGED,1,8,2,0,2,1,False,0,0,0,1084,9,20.38083333333333,Document
PHP,883,2338,1897.189872685185,CLOSED,1,10,2,2,1,0,False,0,2,2,2709,11,134.20944444444444,Document
TypeScript,41369,87416,3007.1843402777777,CLOSED,0,1,1,3,1,0,False,1,2,2,2281,1,5.939722222222223,Document
TypeScript,307,2556,607.6453935185185,MERGED,6,27,3,0,1,2,False,0,0,0,2731,33,1.5830555555555557,Bug
TypeScript,41369,87416,3007.03275462963,MERGED,21,21,2,2,2,1950,True,0,2,2,2538,42,0.1338888888888889,Document
Java,450,746,4140.989386574074,MERGED,11,8,6,0,2,162,False,0,0,0,3188,19,4.172777777777778,Bug
TypeScript,41369,87416,3006.8408680555553,MERGED,22,25,1,2,1,1630,True,0,2,2,2926,47,1.4622222222222223,Document
F#,153,337,2983.8841435185186,MERGED,34,767,8,6,9,42,False,2,4,1,3824,801,45.532222222222224,Bug
TypeScript,41369,87416,3006.6063310185186,MERGED,2,3,1,2,2,1628,True,0,2,2,2202,5,0.5202777777777777,Document
Go,752,2399,791.589375,MERGED,11,45,2,0,2,305,False,0,0,0,2722,56,188.97444444444446,Bug
C#,80,125,888.5517708333333,MERGED,4,5,2,0,1,195,False,0,0,0,708,9,4.360277777777778,Document
Python,19250,70267,2530.4812847222224,CLOSED,4,2,1,1,2,1648,False,1,0,0,956,6,4.274444444444445,Bug
Starlark,440,286,556.6868634259259,MERGED,19,14,1,10,2,51,False,6,4,2,2164,33,795.3538888888888,Document
Erlang,2054,12122,3860.970196759259,MERGED,1,1,1,0,1,28,True,0,0,0,943,2,5.027777777777778,Document
PHP,883,2338,1897.9836689814813,CLOSED,0,20,2,9,1,0,False,4,5,2,2905,20,1.2591666666666668,Document
Erlang,2054,12122,3860.923692129629,MERGED,0,61,1,1,1,183,False,0,1,1,934,61,3.546388888888889,Document
TypeScript,41369,87416,3005.4748611111113,MERGED,0,100,2,2,2,83,True,0,2,2,2568,100,4.125555555555556,Document
TypeScript,41369,87416,3005.5089930555555,MERGED,4,4,2,2,1,84,True,0,2,2,2533,8,0.775,Document
TypeScript,41369,87416,3003.679641203704,MERGED,0,2,1,1,2,5,False,0,1,1,2196,2,4.994166666666667,Document
Python,137,75,754.9827662037037,MERGED,0,968,19,0,39,29,False,0,0,0,2104,968,674.1363888888889,Document
TypeScript,41369,87416,3004.9338425925926,MERGED,110,70,2,1,1,504,True,0,1,1,3064,180,1.6944444444444444,Document
TypeScript,41369,87416,3002.4723495370367,MERGED,4,4,1,5,1,3,False,1,4,3,2467,8,126.43611111111112,Document
TypeScript,41369,87416,3004.709826388889,MERGED,2,5,1,1,1,35,False,0,1,1,2158,7,1.845,Document
TypeScript,4,33,828.0890856481482,MERGED,1,0,1,2,1,262,True,1,1,1,879,1,0.04555555555555556,Document
TypeScript,202,107,1209.5319328703704,MERGED,21,1520,4,3,2,280,True,0,3,3,2950,1541,3.296388888888889,Bug
C#,655,7879,1897.2030787037038,MERGED,145,786,30,4,22,9,False,2,2,2,2326,931,424.0130555555556,Document
TypeScript,2070,16643,1310.351111111111,MERGED,20,33,3,1,6,0,False,1,0,0,3514,53,334.17055555555555,Bug
TypeScript,41369,87416,3003.723148148148,MERGED,0,224,2,3,6,129,True,1,2,2,2550,224,19.24388888888889,Document
C#,655,7879,1897.280486111111,MERGED,33,107,3,1,2,247,True,0,1,1,1818,140,23.47833333333333,Document
Python,137,75,755.1670717592592,MERGED,14,223,26,0,18,8,False,0,0,0,1489,237,191.92555555555555,Feature
TypeScript,1297,21107,480.60225694444443,MERGED,9,32,2,1,2,1140,True,0,1,1,2552,41,0.013888888888888888,Document
TypeScript,41369,87416,3003.8456365740744,MERGED,1,2,1,1,1,34,False,0,1,1,2444,3,0.7661111111111111,Document
TypeScript,41369,87416,3003.843229166667,MERGED,1,0,1,3,1,130,True,1,2,2,2298,1,0.6602777777777777,Document
TypeScript,41369,87416,3003.708483796296,CLOSED,2,8,1,1,4,33,False,0,1,1,2506,10,2.8325,Document
TypeScript,41369,87416,3003.5689814814814,MERGED,1,3,1,5,1,502,True,2,3,2,2205,4,2.786111111111111,Document
F#,14,41,612.5331944444445,MERGED,91,1104,7,3,47,1,False,1,2,2,7825,1195,268.19694444444445,Document
TypeScript,15,34,554.4842476851852,MERGED,423,602,22,0,7,149,False,0,0,0,931,1025,95.93277777777777,Feature
C#,80,125,885.4969560185185,MERGED,4,21,6,0,1,193,False,0,0,0,973,25,4.372777777777777,Document
C#,80,125,884.8126041666666,MERGED,18,33,8,0,2,0,False,0,0,0,758,51,21.054444444444446,Document
TypeScript,41369,87416,3002.816041666667,MERGED,3,3,3,1,3,128,True,0,1,1,2340,6,0.40166666666666667,Document
TypeScript,41369,87416,3002.5752430555553,MERGED,1,1,1,1,1,1948,True,0,1,1,2164,2,0.8708333333333333,Document
Starlark,440,286,556.538125,MERGED,0,101,2,1,2,1,False,0,1,1,1554,101,293.795,Feature
TypeScript,7,6,713.9228935185184,MERGED,42,4,1,0,5,290,False,0,0,0,1546,46,54.580555555555556,Feature
TypeScript,3706,54077,1425.8825462962961,MERGED,4,5,2,0,1,179,True,0,0,0,1220,9,3.526111111111111,Document
TypeScript,41369,87416,3006.729178240741,CLOSED,27,0,3,1,1,2,False,0,1,1,4389,27,336.57416666666666,Document
JavaScript,2,1,389.34194444444444,MERGED,1,6,1,0,1,38,False,0,0,0,1216,7,0.0077777777777777776,Document
Erlang,2054,12122,3862.9865277777776,CLOSED,5,2712,22,14,20,0,False,9,5,2,1386,2717,194.45138888888889,Document
TypeScript,7,6,714.4511342592592,MERGED,544,2,20,2,3,233,False,1,1,1,3918,546,12.046944444444444,Feature
Go,2083,11770,1583.755289351852,MERGED,9,9,6,0,1,937,True,0,0,0,2673,18,0.11777777777777777,Document
Erlang,2054,12122,3864.887083333333,MERGED,1,6,1,0,1,518,True,0,0,0,1400,7,79.6075,Document
Starlark,440,286,558.875625,CLOSED,0,448,2,3,1,0,False,1,2,2,1328,448,95.94416666666666,Feature
Erlang,2054,12122,3865.864699074074,MERGED,0,7,1,1,1,396,True,1,0,0,1260,7,2.91,Document
C#,655,7879,1898.6780787037035,MERGED,452,8,11,0,2,652,True,0,0,0,2371,460,130.80694444444444,Document
TypeScript,261,3765,746.6607175925925,MERGED,33,336,25,0,3,1033,True,0,0,0,5862,369,6.627777777777778,Document
Erlang,2054,12122,3865.2530439814814,MERGED,137,198,6,0,5,89,False,0,0,0,1280,335,20.976388888888888,Document
Java,450,746,4141.166585648148,MERGED,24,366,14,3,8,91,True,1,2,1,3656,390,211.61583333333334,Bug
Erlang,2054,12122,3865.317013888889,MERGED,9,85,6,0,2,29,False,0,0,0,1259,94,1.9494444444444445,Document
Python,72,25,1704.7588657407407,MERGED,12,238,2,0,2,40,False,0,0,0,3840,250,65.08361111111111,Bug
Erlang,2054,12122,3864.438125,MERGED,8,19,1,0,1,417,False,0,0,0,1107,27,40.75833333333333,Document
Erlang,2054,12122,3865.0044791666664,MERGED,80,85,11,0,7,184,False,0,0,0,1283,165,7.538611111111111,Document
Erlang,2054,12122,3865.0810185185182,MERGED,24,25,22,1,2,419,False,1,0,0,1089,49,2.173888888888889,Document
Erlang,2054,12122,3865.0730902777777,CLOSED,24,25,22,1,2,418,False,1,0,0,1280,49,0.17305555555555555,Document
TypeScript,85,724,384.06232638888883,MERGED,83,247,8,0,4,198,False,0,0,0,7368,330,2.473888888888889,Document
Erlang,2054,12122,3864.178819444445,MERGED,15,12,2,0,1,415,False,0,0,0,1146,27,47.02444444444444,Document
Erlang,2054,12122,3864.963553240741,MERGED,2,2,2,0,1,395,True,0,0,0,1236,4,1.8344444444444445,Document
Erlang,2054,12122,3864.921273148148,MERGED,1,2,1,0,1,394,True,0,0,0,1221,3,2.8605555555555555,Document
TypeScript,2070,16643,1311.4143287037036,CLOSED,9422,12131,8,1,4,0,False,0,1,1,3997,21553,15.010277777777778,Document
TypeScript,261,3765,745.7755671296296,MERGED,11,1740,33,0,5,1027,True,0,0,0,6016,1751,1.1069444444444445,Document
TypeScript,3393,2334,1038.0526273148148,MERGED,0,33,3,1,5,365,False,0,1,1,1271,33,1.5575,Feature
TypeScript,3393,2334,1038.0673842592594,MERGED,0,15,2,1,1,366,False,0,1,1,1465,15,0.2722222222222222,Feature
TypeScript,261,3765,744.963287037037,MERGED,19,319,21,0,3,1023,True,0,0,0,5422,338,12.623333333333333,Document
C#,655,7879,1897.4077199074075,MERGED,2,230,7,4,5,100,False,0,4,2,2264,232,90.45527777777778,Document
TypeScript,4,33,832.2951041666666,MERGED,2,5,1,1,1,407,False,0,1,1,1203,7,0.44805555555555554,Feature
TypeScript,61,71,1742.1813657407408,MERGED,2,1,1,0,1,170,True,0,0,0,1265,3,0.049444444444444444,Bug
Python,2409,12194,308.32368055555554,MERGED,2,2,1,2,2,24,False,1,1,1,1499,4,11.812777777777777,Document
TypeScript,61,71,1742.072962962963,MERGED,6,7,2,0,1,168,True,0,0,0,1658,13,0.06583333333333333,Bug
C#,655,7879,1898.0377777777778,MERGED,26,26,31,1,2,610,True,0,1,1,2363,52,5.341944444444445,Document
TypeScript,4,33,831.3058796296297,MERGED,182,847,34,2,19,401,True,0,2,2,1201,1029,20.190277777777776,Document
C#,655,7879,1898.140324074074,MERGED,9,1,1,2,1,46,False,0,2,2,1929,10,3.1591666666666667,Document
TypeScript,261,3765,741.419525462963,MERGED,340,674,80,0,33,1020,True,0,0,0,6690,1014,152.9452777777778,Document
C#,655,7879,1898.023587962963,MERGED,2,2,51,1,2,609,True,0,1,1,2163,4,4.543611111111111,Document
C#,655,7879,1897.970798611111,MERGED,118,38,23,1,3,608,True,0,1,1,2089,156,6.83,Document
TypeScript,2147,14725,1537.022650462963,MERGED,1610,703,55,0,1,776,False,0,0,0,5603,2313,116.165,Bug
JavaScript,22,26,983.7923726851851,MERGED,3,3,3,0,1,25,True,0,0,0,1522,6,0.34055555555555556,Feature
C#,655,7879,1897.9253009259257,MERGED,5,3,58,1,4,607,True,0,1,1,2102,8,4.835555555555556,Document
Java,450,746,4141.147361111111,MERGED,0,49,3,0,4,71,False,0,0,0,1638,49,21.305833333333332,Feature
C#,655,7879,1897.130173611111,MERGED,14,148,9,5,4,606,True,1,4,3,2266,162,21.763055555555557,Document
C#,80,125,888.7330787037037,MERGED,16,20,3,0,3,188,False,0,0,0,1186,36,19.44638888888889,Document
TypeScript,2070,16643,1307.2086226851852,CLOSED,0,76,4,2,1,0,False,0,2,2,3286,76,115.9811111111111,Document
C#,80,125,888.4790625,MERGED,8,8,2,0,3,194,False,0,0,0,1093,16,23.084722222222222,Document
C++,363,552,602.1259375,MERGED,0,52,2,4,3,280,False,3,1,1,1696,52,144.5625,Document
C++,363,552,604.1871296296296,MERGED,4,0,1,0,1,282,False,0,0,0,1901,4,451.38388888888886,Document
TypeScript,41369,87416,3007.5134143518517,MERGED,4,11,2,2,1,1632,True,0,2,2,3555,15,1.7122222222222223,Document
C++,363,552,603.1252546296297,MERGED,0,3,1,0,1,281,False,0,0,0,1471,3,74.8163888888889,Document
TypeScript,41369,87416,3007.4760300925923,MERGED,2,14,2,2,2,4,False,0,2,2,2505,16,0.3388888888888889,Document
TypeScript,307,2556,607.5762962962963,CLOSED,42,47,2,0,1,1,False,0,0,0,3343,89,1.6466666666666667,Bug
TypeScript,2147,14725,1537.233587962963,MERGED,70,194,7,0,1,203,False,0,0,0,4926,264,19.519444444444446,Bug
TypeScript,4,33,827.6335763888889,MERGED,129,192,4,1,12,238,False,0,1,1,1346,321,116.77083333333333,Bug
TypeScript,41369,87416,3006.9071412037033,MERGED,5,24,3,2,1,1631,True,0,2,2,3055,29,2.6038888888888887,Document
TypeScript,261,3765,740.7124421296297,MERGED,2,183,12,0,4,285,True,0,0,0,5458,185,96.49111111111111,Document
TypeScript,41369,87416,3006.7222800925924,CLOSED,27,0,3,1,3,1,False,0,1,1,4373,27,0.019166666666666665,Document
C#,80,125,885.9275347222223,MERGED,28,928,39,0,16,186,False,0,0,0,1202,956,114.43555555555555,Document
TypeScript,41369,87416,3006.544386574074,CLOSED,27,0,3,2,3,0,False,0,2,2,4389,27,4.250555555555556,Document
Erlang,2054,12122,3860.9500231481484,MERGED,10,17,3,0,2,434,True,0,0,0,1327,27,5.198611111111111,Document
TypeScript,4,33,829.3105671296297,MERGED,467,867,43,1,22,399,True,0,1,1,1652,1334,1.4347222222222222,Document
Erlang,2054,12122,3860.9695138888887,MERGED,1,2,2,0,2,393,True,0,0,0,1129,3,0.3463888888888889,Document
Go,421,1654,1575.0759722222222,CLOSED,33,97,13,0,1,490,True,0,0,0,7597,130,115.75444444444445,Document
Erlang,2054,12122,3860.3707407407405,MERGED,3,7,3,0,1,414,False,0,0,0,1176,10,17.217777777777776,Document
C#,655,7879,1894.3672453703703,MERGED,1,164,5,8,4,1525,True,3,5,3,1976,165,58.24444444444445,Document
C#,80,125,884.718900462963,MERGED,13,32,2,0,2,8,False,0,0,0,1093,45,143.20777777777778,Document
C#,80,125,884.65,CLOSED,426,4159,51,2,19,7,False,2,0,0,1211,4585,144.86527777777778,Document
Erlang,2054,12122,3859.778576388889,MERGED,93,125,4,0,5,392,True,0,0,0,1218,218,33.67333333333333,Document
Go,1835,11246,1798.1169791666669,MERGED,1,2,1,0,1,177,False,0,0,0,1537,3,0.16805555555555557,Document
C#,655,7879,1893.7190625,MERGED,0,3,1,0,1,99,False,0,0,0,2098,3,33.098333333333336,Document
V,2097,34362,1618.0682175925924,MERGED,6,42,2,0,2,0,False,0,0,0,3270,48,32.11944444444445,Document
C#,80,125,885.6956828703704,MERGED,82,213,4,0,3,9,False,0,0,0,1203,295,71.35277777777777,Document
Starlark,440,286,557.294675925926,MERGED,0,729,2,1,2,90,False,0,1,1,1561,729,275.5963888888889,Document
C++,2234,23696,2421.8000231481483,MERGED,148,27,9,1,2,63,False,0,1,1,3646,175,1.1297222222222223,Feature
TypeScript,3393,2334,1032.051712962963,MERGED,8,6,1,2,1,0,False,0,2,1,1263,14,0.2263888888888889,Bug
C#,655,7879,1897.2455092592593,MERGED,16,491,4,5,1,7,False,1,4,3,3037,507,422.29083333333335,Document
TypeScript,41369,87416,3005.512615740741,MERGED,4,5,4,2,1,505,True,0,2,2,3190,9,0.7552777777777778,Document
TypeScript,41369,87416,3005.508784722222,MERGED,2,4,1,1,1,131,True,0,1,1,3699,6,0.4772222222222222,Document
C#,80,125,884.5139351851852,MERGED,15,10,2,0,4,192,False,0,0,0,1058,25,118.2425,Document
Erlang,2054,12122,3859.6983449074073,MERGED,8,11,2,0,1,256,True,0,0,0,1416,19,3.1505555555555556,Document
Go,1835,11246,1797.179699074074,MERGED,3,3,2,0,1,24,False,0,0,0,1390,6,8.0875,Document
TypeScript,3393,2334,1033.2091319444444,MERGED,1,2,1,1,1,168,False,0,1,1,1419,3,0.07444444444444444,Feature
Starlark,440,286,556.0482291666666,MERGED,14,21,1,1,1,2,False,0,1,1,1605,35,305.57472222222225,Feature
Starlark,440,286,556.0230787037037,MERGED,0,458,4,2,2,0,False,1,1,1,1799,458,306.2111111111111,Document
TypeScript,1297,21107,481.63723379629624,MERGED,45,176,10,1,4,1144,True,0,1,1,3740,221,0.45555555555555555,Document
TypeScript,4,33,827.2205208333334,MERGED,4,6,1,1,1,65,False,0,1,1,1171,10,0.21444444444444444,Bug
JavaScript,34,25,263.10482638888885,MERGED,0,134,4,0,1,37,False,0,0,0,1385,134,0.10416666666666667,Document
TypeScript,58,78,890.2416203703705,MERGED,132,428,18,1,8,116,False,0,1,1,8931,560,73.70138888888889,Feature
C#,655,7879,1893.3002777777776,MERGED,32,36,4,2,1,1524,True,0,2,1,2173,68,21.4525,Document
Go,789,5551,1105.1004861111112,MERGED,2,3,1,0,1,11,False,0,0,0,2119,5,264.7475,Document
TypeScript,1297,21107,480.58046296296294,MERGED,264,319,14,1,1,1139,True,0,1,1,3861,583,0.22138888888888889,Document
C#,655,7879,1893.3457291666666,MERGED,1,1,1,1,1,648,True,0,1,1,2348,2,2.7355555555555555,Document
Go,421,1654,1574.0744328703704,MERGED,18,131,8,0,5,489,True,0,0,0,6570,149,27.201944444444443,Document
TypeScript,3393,2334,1031.9710763888888,MERGED,0,7,1,1,1,753,False,0,1,1,1578,7,0.19277777777777777,Bug
Go,1835,11246,1795.8322453703704,MERGED,5,4,1,0,1,585,False,0,0,0,1289,9,4.125555555555556,Document
TypeScript,1073,11366,1158.9398726851853,MERGED,4,2,1,0,1,25,True,0,0,0,1122,6,0.16305555555555556,Bug
C#,655,7879,1895.243425925926,MERGED,1064,909,48,5,6,649,True,2,3,2,2421,1973,206.97083333333333,Document
TypeScript,3706,54077,1422.7726041666667,MERGED,61,609,4,0,1,177,True,0,0,0,1807,670,73.37166666666667,Feature
Go,421,1654,1573.947025462963,MERGED,0,49,7,0,1,487,True,0,0,0,7241,49,2.681388888888889,Bug
TypeScript,41369,87416,3002.6929513888886,MERGED,1,556,7,0,5,1626,True,0,0,0,3854,557,17.995277777777776,Document
Erlang,2054,12122,3864.3902893518516,MERGED,2,130,7,1,2,416,False,1,0,0,1596,132,21.383055555555554,Document
TypeScript,41369,87416,3002.706342592593,MERGED,8,15,6,1,1,127,True,0,1,1,3245,23,0.5244444444444445,Document
TypeScript,202,107,1213.698935185185,CLOSED,880,1009,15,9,4,1,False,3,6,4,7908,1889,593.9022222222222,Document
Python,2409,12194,308.7283796296296,MERGED,10,10,4,0,3,393,True,0,0,0,1987,20,1.0325,Document
TypeScript,41369,87416,3001.802673611111,CLOSED,24,26,2,1,1,0,False,0,1,1,2287,50,0.9988888888888889,Document
Python,2409,12194,307.9018402777778,CLOSED,3,3,1,3,1,23,False,1,2,1,2000,6,10.084444444444445,Document
JavaScript,5140,7051,1268.5291898148148,MERGED,2,13,3,2,2,274,False,1,1,1,6464,15,31.27722222222222,Feature
Python,2409,12194,308.1085763888889,MERGED,1,3,1,0,2,391,True,0,0,0,1811,4,0.175,Document
Erlang,2054,12122,3860.9989930555553,MERGED,40,181,8,0,6,435,True,0,0,0,1839,221,117.91583333333334,Document
Python,14533,41196,1152.410439814815,MERGED,0,2,1,1,1,0,False,0,1,1,1863,2,204.24972222222223,Document
TypeScript,4,33,831.6129282407406,MERGED,4,14,1,1,1,240,False,0,1,1,1486,18,0.035833333333333335,Bug
TypeScript,3393,2334,1033.2098842592593,MERGED,15,29,4,2,4,500,False,0,2,1,2288,44,157.3413888888889,Feature
TypeScript,4,33,831.3106018518519,MERGED,19,27,1,2,2,264,True,1,1,1,2297,46,1.4033333333333333,Feature
Python,14533,41196,1155.5473032407408,CLOSED,9,40,1,0,1,0,False,0,0,0,2085,49,0.008055555555555555,Document
TypeScript,3706,54077,1425.8611805555556,MERGED,14,13,4,0,1,178,True,0,0,0,2325,27,4.020277777777777,Bug
C++,363,552,604.9270486111111,MERGED,37,393,11,0,1,284,False,0,0,0,1796,430,25.186666666666667,Document
Python,2409,12194,306.2532291666667,MERGED,259,0,3,0,1,389,True,0,0,0,2106,259,0.2663888888888889,Document
TypeScript,261,3765,745.5347569444444,MERGED,77,95,8,0,2,1024,True,0,0,0,8049,172,2.2241666666666666,Document
C#,655,7879,1893.2425578703703,MERGED,76,288,22,4,20,8,False,1,3,2,2442,364,258.5627777777778,Document
Starlark,440,286,554.9794212962963,MERGED,16,97,14,2,4,50,False,1,1,1,3077,113,331.26944444444445,Document
C#,655,7879,1898.0625810185186,MERGED,1025,18,107,2,2,651,True,0,2,2,2451,1043,19.755277777777778,Document
Python,2409,12194,305.54251157407407,MERGED,1,1,1,3,2,0,False,2,1,1,1793,2,7.085,Document
Erlang,2054,12122,3860.717326388889,MERGED,12,21,2,0,1,433,True,0,0,0,1896,33,11.200277777777778,Document
TypeScript,85,724,380.02447916666665,CLOSED,1199,2712,93,0,28,45,False,0,0,0,8711,3911,120.49472222222222,Document
Go,54,355,798.0009143518519,MERGED,20,81,4,0,1,27,False,0,0,0,2020,101,20.351111111111113,Bug
Go,1835,11246,1798.7553009259261,MERGED,13,47,4,0,6,115,False,0,0,0,1924,60,1.6452777777777778,Document
TypeScript,3393,2334,1033.9972916666668,MERGED,0,12,3,2,1,361,False,0,2,1,1892,12,0.14194444444444446,Feature
Go,1835,11246,1797.881087962963,MERGED,19,24,3,0,1,72,False,0,0,0,2150,43,21.23027777777778,Document
Vue,10809,21164,1089.0913194444445,CLOSED,3884,5649,7,1,1,0,False,0,1,1,2341,9533,0.05416666666666667,Bug
Java,450,746,4137.222280092593,MERGED,4,91,7,0,1,383,False,0,0,0,2150,95,89.01194444444444,Bug
Go,1835,11246,1797.6652662037038,MERGED,1,1,1,0,2,114,False,0,0,0,1844,2,5.386388888888889,Document
TypeScript,4,33,828.1669907407407,MERGED,51,277,17,1,9,402,False,0,1,1,2293,328,0.3488888888888889,Document
TypeScript,85,724,380.0386226851852,MERGED,22,192,14,0,9,120,False,0,0,0,7922,214,20.470555555555556,Document
TypeScript,4,33,827.6683912037038,MERGED,4,16,3,1,2,239,False,0,1,1,1884,20,0.24888888888888888,Feature
Java,450,746,4137.257465277778,MERGED,5,7,2,0,5,68,False,0,0,0,1989,12,19.383055555555554,Bug
C++,363,552,600.9518055555556,MERGED,4,4,1,0,1,278,False,0,0,0,2145,8,4.064444444444445,Document
TypeScript,1073,11366,1158.6190046296297,MERGED,1,1,1,1,1,23,True,0,1,1,2026,2,0.9069444444444444,Bug
Go,1835,11246,1795.8319328703703,MERGED,5,4,1,0,1,584,False,0,0,0,1989,9,4.1113888888888885,Document
Go,1835,11246,1795.8126388888888,MERGED,13,30,2,0,1,582,False,0,0,0,2050,43,0.18166666666666667,Document
Vue,10809,21164,1092.4093518518519,MERGED,91,92,17,6,1,4,False,2,4,2,8594,183,871.0386111111111,Document
TypeScript,41369,87416,3002.1727546296297,MERGED,2,2,1,1,2,0,False,0,1,1,2116,4,9.395833333333334,Document
Go,1835,11246,1797.9233680555556,MERGED,0,2,1,0,1,37,True,0,0,0,2222,2,1.0066666666666666,Document
Starlark,440,286,557.2961805555556,CLOSED,18,50,1,1,1,91,False,0,1,1,2636,68,264.25111111111113,Bug
Starlark,440,286,556.1418865740741,MERGED,0,58,2,2,1,0,False,1,1,1,3048,58,303.3127777777778,Document
Go,752,2399,795.7687500000001,MERGED,1127,7564,79,0,16,307,False,0,0,0,6236,8691,191.71527777777777,Document
Erlang,2054,12122,3865.8683449074074,CLOSED,9,14,2,0,1,437,True,0,0,0,2670,23,31.46361111111111,Document
Go,1835,11246,1793.6310300925925,MERGED,789,352,15,1,6,579,False,0,1,1,1769,1141,0.7680555555555556,Document
Python,4517,54993,995.4005671296296,MERGED,30,43,1,4,5,30,True,1,3,3,4028,73,54.16916666666667,Document
Python,2409,12194,309.65533564814814,MERGED,9,15,3,3,6,0,False,1,2,2,2594,24,8.130833333333333,Document
Python,137,75,754.2562731481481,MERGED,27,51,15,1,4,222,False,1,0,0,3005,78,0.36666666666666664,Document
Python,2409,12194,309.9476041666667,MERGED,4,15,1,0,1,397,True,0,0,0,2567,19,0.034722222222222224,Document
Python,2409,12194,309.9269791666667,MERGED,3,60,4,0,10,396,True,0,0,0,2640,63,0.27694444444444444,Document
Python,4517,54993,993.3543981481481,MERGED,15,3,1,2,2,29,True,1,1,1,4275,18,993.3375,Document
TypeScript,1297,21107,485.58383101851854,MERGED,57,127,16,1,3,1153,True,0,1,1,5501,184,0.09472222222222222,Document
C++,363,552,605.3141203703703,MERGED,145,129,6,2,2,285,False,2,0,0,2366,274,95.60583333333334,Document
V,2097,34362,1620.6868865740742,MERGED,644,1317,12,21,7,16,True,9,12,3,5735,1961,38.67444444444445,Document
Python,2409,12194,308.81406250000003,MERGED,2,2,1,0,1,394,True,0,0,0,2251,4,0.014722222222222222,Document
TypeScript,12,11,1058.5773032407408,MERGED,154,97,11,0,3,45,False,0,0,0,12625,251,158.07583333333332,Feature
Python,2409,12194,308.6674652777778,MERGED,308,783,194,0,1,392,True,0,0,0,2824,1091,1.986388888888889,Document
TypeScript,4,33,832.072650462963,MERGED,9,122,13,2,9,265,True,1,1,1,2929,131,2.9180555555555556,Bug
TypeScript,1297,21107,484.566875,MERGED,13,152,9,1,3,1148,True,0,1,1,5335,165,0.06666666666666667,Document
TypeScript,307,2556,607.6990856481482,MERGED,46,42,29,0,3,584,True,0,0,0,4878,88,3.2711111111111113,Document
TypeScript,4,33,831.3663541666666,MERGED,24,140,4,1,7,404,False,0,1,1,2678,164,0.7313888888888889,Feature
TypeScript,307,2556,607.458888888889,MERGED,0,37,6,0,1,206,True,0,0,0,5264,37,6.6175,Bug
Go,752,2399,792.7822800925925,CLOSED,415,618,17,1,3,0,False,0,1,1,5636,1033,88.35666666666667,Bug
Go,1174,11429,1906.0619212962963,MERGED,113,134,12,3,1,452,True,1,2,2,11401,247,132.7086111111111,Document
TypeScript,41369,87416,3005.8200462962964,MERGED,136,205,50,3,6,1627,True,0,3,3,5126,341,4.421111111111111,Document
TypeScript,1073,11366,1161.5713773148148,MERGED,37,35,5,1,2,774,True,0,1,1,2987,72,46.31361111111111,Bug
TypeScript,1073,11366,1161.5248263888889,MERGED,0,7,1,1,1,773,True,0,1,1,2395,7,47.15361111111111,Document
TypeScript,4,33,827.3448611111112,MERGED,1418,972,172,2,39,655,True,1,1,1,2575,2390,120.96083333333333,Feature
TypeScript,3393,2334,1032.5069328703705,MERGED,1947,243,14,2,17,499,False,0,2,1,2895,2190,133.82083333333333,Feature
Python,2409,12194,305.73310185185187,MERGED,3,3,1,0,2,388,True,0,0,0,2373,6,1.13,Document
TypeScript,85,724,385.00497685185184,MERGED,27,288,36,1,1,199,False,1,0,0,12275,315,26.81222222222222,Document
TypeScript,1073,11366,1160.780752314815,MERGED,5,126,8,1,2,772,True,0,1,1,3450,131,65.02194444444444,Feature
Python,2409,12194,305.26238425925925,MERGED,30,38,5,4,13,387,True,2,2,1,2968,68,19.682222222222222,Document
TypeScript,2147,14725,1540.755451388889,CLOSED,4694,10007,80,0,1,318,False,0,0,0,12967,14701,77.68777777777778,Document
Go,1835,11246,1798.7301851851853,MERGED,9,8,2,0,1,26,False,0,0,0,2549,17,0.09722222222222222,Document
Python,2409,12194,304.8154976851852,MERGED,5,5,4,4,3,3,False,1,3,1,2248,10,3.9975,Feature
Go,1835,11246,1798.611087962963,MERGED,8,6,4,0,1,587,False,0,0,0,2782,14,0.12583333333333332,Document
Go,1835,11246,1798.135462962963,MERGED,8,6,4,0,2,586,False,0,0,0,2703,14,8.53138888888889,Document
Python,2409,12194,304.7762384259259,MERGED,3,10,1,1,3,385,True,1,0,0,2472,13,4.987777777777778,Document
Go,1835,11246,1798.063738425926,MERGED,65,63,25,0,1,25,False,0,0,0,2418,128,0.3038888888888889,Document
Go,1835,11246,1793.6798958333331,MERGED,0,287,46,0,1,22,False,0,0,0,2679,287,1.103611111111111,Document
Go,1835,11246,1797.5830902777777,MERGED,5,40,5,0,3,36,True,0,0,0,2565,45,0.6705555555555556,Document
TypeScript,7,6,714.2107291666666,MERGED,372,698,30,0,97,255,False,0,0,0,10214,1070,238.05666666666667,Document
TypeScript,41369,87416,3003.632789351852,MERGED,71,778,100,2,15,503,True,0,2,2,6993,849,0.45472222222222225,Document
TypeScript,41369,87416,3003.5044444444447,MERGED,33,169,72,5,19,501,True,2,3,2,5200,202,1.2208333333333334,Document
PHP,883,2338,1897.0796064814815,CLOSED,10,261,20,7,11,6,False,3,4,2,7858,271,596.3661111111111,Document
Go,1835,11246,1797.1285763888889,MERGED,4,4,2,0,1,23,False,0,0,0,2149,8,0.12777777777777777,Document
TypeScript,4,33,827.2166666666667,MERGED,97,1250,28,1,10,400,False,0,1,1,3036,1347,1.2730555555555556,Document
TypeScript,261,3765,746.6299074074074,MERGED,292,360,2,0,3,1032,True,0,0,0,13432,652,0.06166666666666667,Document
TypeScript,178,1359,388.2362268518518,MERGED,199,125,9,1,2,35,True,0,1,1,12385,324,10.899722222222222,Bug
TypeScript,261,3765,745.4808101851851,MERGED,189,1026,20,0,5,51,False,0,0,0,7675,1215,52.653888888888886,Document
Python,137,75,754.078136574074,MERGED,126,1819,74,4,39,103,False,2,2,1,4739,1945,26.29277777777778,Document
TypeScript,41369,87416,3001.844201388889,MERGED,26,70,2,2,1,1,False,0,2,2,6482,96,42.43333333333333,Document
TypeScript,1073,11366,1158.9780208333334,MERGED,3,4,3,0,6,27,True,0,0,0,2201,7,0.47944444444444445,Bug
TypeScript,1073,11366,1158.941585648148,MERGED,1,1,1,0,1,26,True,0,0,0,2403,2,0.42277777777777775,Bug
TypeScript,1073,11366,1158.856388888889,MERGED,2,2,1,1,1,24,True,0,1,1,2532,4,0.355,Bug
TypeScript,1073,11366,1158.833726851852,MERGED,1,1,1,1,1,40,True,0,1,1,2135,2,0.27416666666666667,Document
TypeScript,1073,11366,1158.8274074074075,MERGED,45,16,1,0,3,39,True,0,0,0,2355,61,0.07416666666666667,Document
Go,1835,11246,1795.812997685185,MERGED,13,30,2,0,1,583,False,0,0,0,2267,43,0.24027777777777778,Document
Go,1835,11246,1794.9890046296296,MERGED,10,5,6,0,1,48,False,0,0,0,2268,15,15.428888888888888,Document
Go,1835,11246,1793.9101504629627,MERGED,10,32,4,0,3,113,False,0,0,0,2771,42,69.18722222222222,Document
Go,2083,11770,1584.0279745370372,MERGED,14,68,5,0,2,938,True,0,0,0,6453,82,0.10388888888888889,Document
Java,450,746,4142.224884259259,MERGED,174,348,15,1,9,92,True,0,1,1,9425,522,186.1838888888889,Bug
Go,1835,11246,1792.7907175925927,MERGED,118,122,2,0,1,71,False,0,0,0,2901,240,0.11833333333333333,Document
V,2097,34362,1620.6877546296298,MERGED,116,178,10,6,5,12,False,3,3,2,8329,294,52.094166666666666,Document
C++,2234,23696,2422.002349537037,MERGED,138,228,3,1,3,22,False,0,1,1,9080,366,115.1613888888889,Bug
JavaScript,2,1,389.3320486111111,MERGED,4307,4720,45,0,3,37,False,0,0,0,4306,9027,0.15694444444444444,Document
Python,4517,54993,995.0043402777778,CLOSED,2,6,1,13,7,0,False,6,7,2,3881,8,147.76111111111112,Document
TypeScript,41369,87416,3006.750821759259,MERGED,41,288,16,2,4,1629,True,0,2,2,10006,329,0.7369444444444444,Document
TypeScript,41369,87416,3005.4478819444444,CLOSED,8,61,8,3,2,1,False,0,3,3,8546,69,71.23138888888889,Document
TypeScript,41369,87416,3006.149016203704,MERGED,21,32,7,2,13,506,True,0,2,2,9356,53,9.114722222222222,Document
TypeScript,4,33,832.1047453703704,MERGED,15,71,5,1,4,405,False,0,1,1,3196,86,0.2897222222222222,Bug
Python,4517,54993,993.5691782407407,MERGED,0,51,2,2,4,116,True,0,2,2,4731,51,92.005,Document
Python,4517,54993,993.5435416666666,MERGED,0,113,2,0,2,115,True,0,0,0,3720,113,92.82888888888888,Document
Java,450,746,4137.927384259259,MERGED,85,636,15,2,38,69,False,2,0,0,4381,721,264.3125,Feature
TypeScript,61,71,1742.1963773148148,MERGED,23,98,8,0,3,171,True,0,0,0,4766,121,0.9261111111111111,Feature
TypeScript,41369,87416,3003.649537037037,MERGED,477,1922,13,4,9,616,True,1,3,3,8551,2399,43.010555555555555,Document
TypeScript,1073,11366,1163.6710648148148,MERGED,38,38,11,1,4,302,True,0,1,1,4072,76,24.004722222222224,Bug
V,2097,34362,1616.7643055555554,MERGED,260,200,5,0,14,2,False,0,0,0,8973,460,11.961388888888889,Document
Vue,10809,21164,1087.8321527777778,MERGED,185,470,43,1,29,159,False,0,1,1,8601,655,0.47694444444444445,Document
TypeScript,4,33,831.1513310185186,MERGED,153,268,22,1,6,403,False,0,1,1,4977,421,0.7311111111111112,Bug
TypeScript,1073,11366,1163.479074074074,MERGED,48,310,8,1,2,775,True,0,1,1,3647,358,0.5586111111111111,Feature
TypeScript,1073,11366,1162.7764467592592,CLOSED,4,27,5,1,1,87,True,0,1,1,4418,31,22.079444444444444,Bug
TypeScript,1073,11366,1162.5632986111111,MERGED,7,29,3,1,1,300,True,0,1,1,3715,36,0.3502777777777778,Document
Python,4517,54993,991.5212731481482,MERGED,0,1,1,4,1,0,False,1,3,3,3396,1,28.012777777777778,Document
Python,2409,12194,305.0015740740741,MERGED,3,34,2,0,3,386,True,0,0,0,3833,37,0.2361111111111111,Document
Java,450,746,4138.039305555555,MERGED,45,8,3,0,5,70,False,0,0,0,3576,53,69.93222222222222,Bug
Python,4517,54993,991.5618171296296,MERGED,3,16,1,0,3,0,False,0,0,0,3470,19,0.285,Document
Python,4517,54993,990.487488425926,MERGED,2,2,1,0,1,1,False,0,0,0,3242,4,4.574166666666667,Document
Python,4517,54993,990.7178703703704,MERGED,21,36,2,17,7,1,False,10,7,2,4922,57,1106.486111111111,Document
Go,1835,11246,1795.6851851851852,CLOSED,10,36,6,0,1,580,False,0,0,0,4097,46,2.7430555555555554,Document
Vue,10809,21164,1092.8573148148148,CLOSED,33,55,8,3,2,0,False,0,3,2,12543,88,22.81361111111111,Bug
Go,30,295,412.1507291666667,MERGED,2240,61,10,4,9,108,True,1,3,2,20984,2301,1161.411111111111,Feature
Python,2409,12194,306.25658564814813,MERGED,1757,60,18,9,9,390,True,6,3,2,6450,1817,0.8216666666666667,Document
TypeScript,7046,76150,2695.6232870370372,MERGED,18543,17992,244,1,37,112,False,0,1,1,11266,36535,0.12916666666666668,Document
Python,2409,12194,306.5853240740741,MERGED,4646,4213,383,33,71,87,True,13,20,4,6303,8859,33.08583333333333,Document
Python,4517,54993,994.4296296296296,MERGED,21,60,1,2,16,117,True,1,1,1,5145,81,296.92527777777775,Document
Python,4517,54993,992.7191435185185,MERGED,1,60,2,3,10,0,False,2,1,1,5229,61,379.5025,Document
Go,1835,11246,1798.763888888889,MERGED,2,1264,33,1,2,38,True,0,1,1,7526,1266,51.08027777777778,Document
JavaScript,22,26,984.1133796296295,MERGED,69,466,16,5,9,26,True,3,2,2,5739,535,226.86027777777778,Bug
Python,2409,12194,308.88390046296297,MERGED,749,917,215,0,38,395,True,0,0,0,5321,1666,144.18333333333334,Document
Starlark,440,286,560.3473842592592,MERGED,35,35,2,1,1,2,False,0,1,1,5412,70,11.417777777777777,Bug
Python,4517,54993,992.7860416666667,MERGED,35,58,3,1,13,152,False,0,1,1,5109,93,174.04055555555556,Document
TypeScript,4,33,832.6175694444445,MERGED,401,481,39,1,2,241,False,0,1,1,7525,882,0.4811111111111111,Feature
Go,1835,11246,1797.874363425926,CLOSED,2416,3079,90,1,22,16,False,0,1,1,6819,5495,184.89111111111112,Document
TypeScript,4,33,831.1057291666666,MERGED,25,125,8,2,5,263,True,1,1,1,7526,150,2.2783333333333333,Bug
Go,1835,11246,1798.6228819444443,CLOSED,30,637,19,0,4,2,False,0,0,0,7720,667,0.5530555555555555,Feature
Go,1835,11246,1793.669988425926,MERGED,33,57,27,0,1,21,False,0,0,0,5482,90,1.331388888888889,Document
Go,1835,11246,1793.6207638888889,CLOSED,35,58,28,0,1,20,False,0,0,0,6154,93,0.43944444444444447,Document
Go,1835,11246,1797.874502314815,CLOSED,28,639,19,0,2,1,False,0,0,0,6833,667,17.77638888888889,Feature
TypeScript,4,33,827.3055787037038,MERGED,67,91,17,1,11,401,False,0,1,1,5687,158,1.3527777777777779,Bug
TypeScript,4,33,827.1350462962963,MERGED,5,64,3,2,7,261,True,1,1,1,6590,69,2.1577777777777776,Feature
Go,1835,11246,1795.6878125,CLOSED,26,88,6,0,1,581,False,0,0,0,6291,114,2.673611111111111,Document
Go,1835,11246,1793.6208333333334,MERGED,24,13,5,0,2,578,False,0,0,0,6563,37,0.1438888888888889,Document
TypeScript,85,724,380.9572685185185,MERGED,1863,14581,152,0,75,108,False,0,0,0,22006,16444,286.07666666666665,Document
Python,4517,54993,992.7611342592592,MERGED,11,65,3,0,12,151,False,0,0,0,9402,76,479.6477777777778,Document
TypeScript,4,33,832.7386805555556,MERGED,152,151,41,1,1,242,False,0,1,1,10488,303,0.07777777777777778,Bug
TypeScript,4,33,829.4053472222222,MERGED,75,1672,55,1,33,400,True,0,1,1,7910,1747,66.06888888888889,Document
Go,1835,11246,1798.6487962962963,CLOSED,30,637,19,0,4,3,False,0,0,0,8475,667,34.39666666666667,Document
TypeScript,3393,2334,1037.9373611111112,MERGED,26,168,26,1,18,170,False,0,1,1,11639,194,171.8788888888889,Feature
TypeScript,4,33,832.4392708333334,MERGED,654,1381,68,1,4,657,True,0,1,1,11437,2035,166.3163888888889,Feature
TypeScript,1073,11366,1163.6697916666667,MERGED,292,419,28,1,25,301,True,0,1,1,13743,711,30.3725,Bug
TypeScript,1073,11366,1161.6103587962964,MERGED,211,17,18,1,3,29,True,0,1,1,11654,228,17.77138888888889,Document
TypeScript,1073,11366,1161.6756481481482,MERGED,645,1818,51,1,59,299,True,0,1,1,14477,2463,4.728611111111111,Bug
Go,1835,11246,1798.0964930555556,MERGED,3033,3517,52,1,2,18,False,0,1,1,11308,6550,39.59888888888889,Document
TypeScript,41369,87415,3006.751099537037,MERGED,520,475,54,5,8,617,True,1,4,4,21299,995,49.80972222222222,Document
TypeScript,2147,14725,1544.1995833333333,MERGED,4,4,2,0,2,213,False,0,0,0,1150,8,16.531666666666666,Feature
Rust,3809,5430,514.8995486111111,CLOSED,0,8,2,0,1,193,False,0,0,0,223,8,619.9566666666667,Feature
PHP,1334,2960,4283.086504629629,CLOSED,1,2,1,4,2,16,False,0,4,3,948,3,240.1461111111111,Bug
TypeScript,12,11,1064.677650462963,MERGED,128,155,7,0,3,78,False,0,0,0,1775,283,210.09972222222223,Feature
PHP,1334,2960,4280.18949074074,MERGED,5,7,3,1,10,173,False,0,1,1,670,12,238.09833333333333,Bug
TypeScript,12,11,1060.5113425925927,CLOSED,0,1,1,0,1,76,False,0,0,0,693,1,0.04527777777777778,Feature
TypeScript,12,11,1060.507638888889,CLOSED,0,1,1,0,1,74,False,0,0,0,745,1,0.12805555555555556,Feature
TypeScript,12,11,1060.466712962963,MERGED,0,2,1,0,1,233,False,0,0,0,935,2,0.030555555555555555,Feature
TypeScript,85,724,391.0005555555556,MERGED,0,34,3,0,2,24,False,0,0,0,1006,34,2.8433333333333333,Document
TypeScript,2147,14725,1543.812696759259,MERGED,136,1684,11,0,4,212,False,0,0,0,1594,1820,120.15388888888889,Bug
Go,395,660,1336.0852199074075,MERGED,1,1,1,0,1,95,False,0,0,0,185,2,956.0991666666666,Feature
TypeScript,12,11,1059.3277546296297,MERGED,1,6,1,0,1,231,False,0,0,0,956,7,0.08777777777777777,Feature
TypeScript,2147,14725,1544.0156944444443,MERGED,1,1,1,0,1,118,False,0,0,0,597,2,0.5619444444444445,Bug
TypeScript,2147,14725,1542.99,MERGED,0,8,1,0,5,12,False,0,0,0,589,8,1.5675,Feature
Go,421,1654,1585.0666782407407,MERGED,2,8,1,0,1,498,True,0,0,0,961,10,20.188333333333333,Document
C++,2234,23696,2432.8231597222225,MERGED,1,3,1,3,3,181,False,2,1,1,596,4,65.01916666666666,Bug
TypeScript,178,1359,397.8365162037037,MERGED,1,1,1,1,1,23,True,0,1,1,1071,2,0.5275,Feature
TypeScript,85,724,386.96619212962963,MERGED,0,44,2,0,4,13,False,0,0,0,1273,44,7.325555555555556,Document
TypeScript,2147,14725,1544.1950462962961,MERGED,7,9,1,0,1,320,False,0,0,0,797,16,12.546388888888888,Bug
TypeScript,261,3765,751.8772800925926,MERGED,1,8,2,0,1,263,False,0,0,0,1628,9,2.6708333333333334,Document
TypeScript,261,3765,751.5330671296297,MERGED,1,2,1,0,1,290,True,0,0,0,1140,3,3.2827777777777776,Document
TypeScript,261,3765,751.4975578703703,MERGED,106,139,5,0,3,260,False,0,0,0,1356,245,2.475277777777778,Document
TypeScript,261,3765,751.5038541666667,MERGED,8,3,1,0,1,1040,True,0,0,0,1186,11,0.24138888888888888,Document
TypeScript,261,3765,751.483275462963,MERGED,5,53,3,0,4,653,True,0,0,0,1121,58,1.3797222222222223,Document
Python,547,7161,2308.673298611111,MERGED,14,16,1,0,5,244,False,0,0,0,699,30,344.1075,Bug
TypeScript,2147,14725,1547.915972222222,MERGED,2,27,2,0,1,689,False,0,0,0,1149,29,29.653333333333332,Document
TypeScript,85,724,391.23506944444443,MERGED,8,5,1,0,1,128,False,0,0,0,1300,13,0.17972222222222223,Document
TypeScript,2147,14725,1543.1093055555557,MERGED,4,19,4,0,6,186,False,0,0,0,973,23,14.54111111111111,Feature
PHP,1334,2960,4279.05167824074,MERGED,1,1,1,1,1,885,False,0,1,1,776,2,1.2952777777777778,Feature
TypeScript,85,724,390.91990740740744,MERGED,5,16,2,0,1,127,False,0,0,0,1801,21,0.13083333333333333,Document
TypeScript,85,724,386.0138541666667,MERGED,1,1,1,0,1,54,False,0,0,0,1200,2,0.008055555555555555,Document
TypeScript,85,724,386.00946759259256,MERGED,0,60,2,0,1,53,False,0,0,0,1225,60,0.029166666666666667,Document
TypeScript,7,6,717.0316435185185,CLOSED,0,1,1,0,1,246,False,0,0,0,799,1,73.53333333333333,Feature
TypeScript,85,724,385.9428819444445,MERGED,1,1,1,0,1,52,False,0,0,0,1219,2,0.011666666666666667,Document
Vue,293,495,901.5932638888889,MERGED,4,6,1,8,1,0,False,0,8,6,1115,10,31.147777777777776,Bug
C++,2234,23696,2429.9410879629627,MERGED,3,0,2,1,1,26,False,0,1,1,762,3,64.02527777777777,Bug
TypeScript,2147,14725,1545.0119907407407,MERGED,26,5,1,0,1,780,False,0,0,0,1180,31,79.22972222222222,Bug
TypeScript,2147,14725,1545.2333912037038,MERGED,39,17,1,0,1,321,False,0,0,0,1646,56,61.94638888888889,Bug
TypeScript,261,3765,748.7994675925926,MERGED,1,28,1,0,3,259,False,0,0,0,1299,29,0.25972222222222224,Document
Go,421,1654,1582.008946759259,MERGED,8,27,2,0,2,495,True,0,0,0,1156,35,243.14805555555554,Bug
Go,395,660,1337.9200231481482,CLOSED,21,33,2,0,1,81,False,0,0,0,423,54,912.7738888888889,Feature
Python,547,7161,2309.481701388889,MERGED,2,2,1,0,2,152,False,0,0,0,1210,4,344.2811111111111,Bug
PHP,1334,2960,4279.066944444445,MERGED,0,3,1,1,1,172,False,0,1,1,770,3,2.2175,Bug
TypeScript,7,6,716.9927199074074,MERGED,36,141,12,0,56,294,False,0,0,0,1565,177,504.00111111111113,Document
TypeScript,85,724,388.1758101851852,MERGED,3,3,1,0,1,23,False,0,0,0,1406,6,0.3333333333333333,Document
TypeScript,261,3765,747.5249305555554,MERGED,0,15,3,0,1,132,False,0,0,0,1320,15,28.552777777777777,Document
TypeScript,261,3765,751.864375,MERGED,3,3,3,0,2,1042,True,0,0,0,1803,6,14.531944444444445,Document
TypeScript,12,11,1060.3119097222223,CLOSED,296,121,6,0,21,73,False,0,0,0,1154,417,4.8213888888888885,Feature
PowerShell,8,8,703.7807407407407,MERGED,7,94,5,0,21,10,False,0,0,0,1691,101,5.444444444444445,Bug
TypeScript,261,3765,751.8236226851851,MERGED,14,25,3,0,2,134,False,0,0,0,2077,39,15.563888888888888,Document
TypeScript,12,11,1060.5561111111112,MERGED,519,4494,29,0,11,189,False,0,0,0,2692,5013,520.7908333333334,Feature
TypeScript,261,3765,747.7987731481481,MERGED,11,9,3,0,1,257,False,0,0,0,1527,20,0.585,Document
Go,395,660,1341.0626041666667,CLOSED,31,53,1,1,5,138,False,0,1,1,302,84,551.6205555555556,Feature
Vue,293,495,904.4965046296296,MERGED,84,93,1,8,3,79,False,2,6,5,902,177,134.07333333333332,Bug
TypeScript,85,724,391.2272222222222,MERGED,2,156,5,0,3,57,False,0,0,0,2439,158,17.350277777777777,Document
TypeScript,85,724,387.1923842592593,MERGED,57,97,13,0,2,202,False,0,0,0,1909,154,17.72861111111111,Document
TypeScript,7,6,717.0415972222222,MERGED,13,24,8,0,8,295,False,0,0,0,979,37,92.86055555555555,Feature
TypeScript,261,3765,746.9761111111111,MERGED,26,40,7,0,2,232,True,0,0,0,1144,66,11.84,Document
TypeScript,261,3765,746.9631481481482,MERGED,2,2,2,0,1,1036,True,0,0,0,1289,4,0.043611111111111114,Document
F#,271,818,2803.3958333333335,MERGED,2,5,1,0,1,16,True,0,0,0,1336,7,0.06222222222222222,Feature
TypeScript,261,3765,746.757013888889,MERGED,53,53,3,0,1,208,False,0,0,0,1289,106,0.8380555555555556,Document
TypeScript,85,724,386.079837962963,MERGED,185,29,11,0,2,20,False,0,0,0,1915,214,22.232222222222223,Document
TypeScript,2147,14725,1543.054537037037,MERGED,6,84,3,0,1,777,False,0,0,0,1624,90,27.535833333333333,Feature
Python,547,7161,2313.503888888889,MERGED,101,83,41,0,1,153,False,0,0,0,866,184,0.31166666666666665,Bug
TypeScript,261,3765,748.7846064814815,MERGED,4,8,2,1,1,1,False,0,1,1,1843,12,64.55583333333334,Document
TypeScript,261,3765,746.7985069444444,MERGED,482,392,275,0,4,131,False,0,0,0,2167,874,167.46083333333334,Document
Vue,293,495,903.0743518518519,MERGED,36,38,5,7,4,418,False,1,6,5,951,74,64.24444444444444,Bug
TypeScript,2147,14725,1544.9087268518517,MERGED,33,33,3,0,1,779,False,0,0,0,2111,66,0.6608333333333334,Bug
TypeScript,85,724,387.9977777777778,MERGED,10,12,3,0,1,56,False,0,0,0,2667,22,0.9722222222222222,Document
TypeScript,178,1359,397.69149305555555,CLOSED,20,12,8,2,4,51,True,0,2,2,3016,32,116.92138888888888,Feature
Go,182,37,1780.4518055555554,MERGED,0,69,2,1,10,474,False,1,0,0,1086,69,109.12694444444445,Document
TypeScript,85,724,388.15539351851857,MERGED,5,17,5,0,1,22,False,0,0,0,2404,22,1.6022222222222222,Document
PHP,1334,2960,4280.1213310185185,MERGED,102,2,2,1,1,886,False,0,1,1,1702,104,0.3525,Bug
TypeScript,261,3765,748.6653472222223,MERGED,2,13,3,0,1,258,False,0,0,0,1839,15,2.5213888888888887,Document
PHP,1334,2960,4280.214398148149,MERGED,1,1,1,2,2,3,False,0,2,2,2116,2,138.2722222222222,Document
TypeScript,12,11,1060.5105787037037,CLOSED,296,122,6,0,22,75,False,0,0,0,2048,418,0.02361111111111111,Feature
Rust,3809,5430,515.102650462963,MERGED,4,2,2,0,1,194,False,0,0,0,297,6,40.39972222222222,Bug
JavaScript,5140,7051,1276.6402430555556,MERGED,57,792,11,1,4,107,False,0,1,1,1093,849,71.44972222222222,Bug
Vue,293,495,902.7835763888888,MERGED,424,3,2,4,5,75,False,1,3,2,1026,427,2.2891666666666666,Bug
TypeScript,261,3765,751.5028125,MERGED,49,37,10,0,2,52,False,0,0,0,2243,86,2.1705555555555556,Document
Python,72,25,1707.6046180555556,MERGED,4,53,2,0,1,42,False,0,0,0,1069,57,3.960277777777778,Feature
Go,421,1654,1585.0777314814814,CLOSED,13,28,2,0,1,499,True,0,0,0,1705,41,0.9122222222222223,Bug
TypeScript,202,107,1217.8442592592594,MERGED,1,1,1,3,1,297,True,0,3,3,1156,2,0.065,Document
TypeScript,202,107,1214.8355439814816,CLOSED,2,26,3,3,3,293,True,1,2,2,976,28,167.72805555555556,Document
Go,395,660,1337.8774768518517,MERGED,1,1,1,1,7,136,False,1,0,0,305,2,455.48083333333335,Feature
TypeScript,261,3765,747.8819097222222,MERGED,1297,103,5,0,2,1038,True,0,0,0,1966,1400,0.42,Document
Go,395,660,1341.110324074074,MERGED,2,2,1,0,1,82,False,0,0,0,210,4,162.1263888888889,Feature
Vue,10810,21164,1095.9996527777778,MERGED,0,2,1,0,1,106,True,0,0,0,1186,2,4.893055555555556,Bug
TypeScript,261,3765,746.942349537037,MERGED,1,9,2,0,1,1035,True,0,0,0,1958,10,19.990833333333335,Document
JavaScript,34,25,270.1802662037037,MERGED,0,0,1,0,1,88,False,0,0,0,75,0,2.5122222222222224,Feature
TypeScript,261,3765,746.9314351851853,MERGED,14,9,4,0,3,1034,True,0,0,0,1774,23,1.6855555555555555,Document
TypeScript,261,3765,746.8673032407409,MERGED,4,10,5,0,1,231,True,0,0,0,1783,14,0.23027777777777778,Document
TypeScript,261,3765,746.7696412037036,MERGED,1,8,2,0,2,230,True,0,0,0,1735,9,0.7252777777777778,Document
TypeScript,85,724,386.0932407407408,MERGED,1,64,3,0,1,55,False,0,0,0,2080,65,0.027777777777777776,Document
V,2097,34362,1624.2315277777777,MERGED,4,24,3,0,3,24,True,0,0,0,1023,28,5.123888888888889,Feature
TypeScript,85,724,385.9745833333333,MERGED,1,9,2,0,2,124,False,0,0,0,2085,10,2.226111111111111,Document
Go,395,660,1341.109224537037,MERGED,1,5,1,0,1,140,False,0,0,0,214,6,91.2225,Feature
Go,395,660,1341.098148148148,MERGED,4,4,1,0,1,139,False,0,0,0,214,8,91.47222222222223,Feature
Vue,293,495,903.5685995370371,MERGED,468,442,4,7,2,77,False,0,7,5,1083,910,82.41722222222222,Bug
JavaScript,5140,7051,1275.5279513888888,MERGED,6785,6981,3,5,2,0,False,0,5,3,1102,13766,17.6775,Feature
Vue,10810,21164,1093.7698032407409,MERGED,2,5,1,2,1,2,False,0,2,2,1238,7,55.715555555555554,Bug
Go,182,37,1780.187488425926,MERGED,0,69,5,1,3,473,False,1,0,0,1332,69,89.605,Document
TypeScript,261,3765,751.8245949074075,MERGED,4,21,4,0,1,292,True,0,0,0,2612,25,19.18777777777778,Document
PHP,1334,2960,4279.922685185185,MERGED,0,2,1,2,1,7,False,0,2,2,1975,2,74.42027777777778,Document
Python,547,7161,2308.7151041666666,MERGED,7,9,2,0,6,35,False,0,0,0,1169,16,0.9486111111111111,Document
TypeScript,261,3765,751.786111111111,MERGED,35,16,5,0,1,133,False,0,0,0,2693,51,0.8105555555555556,Document
Go,1174,11429,1912.8349305555555,MERGED,13,52,4,3,3,371,True,1,2,2,2710,65,120.55805555555555,Document
JavaScript,5140,7051,1274.6478587962963,MERGED,6581,6483,12,1,8,92,False,0,1,1,1503,13064,2.004166666666667,Bug
JavaScript,5140,7051,1274.9131481481481,MERGED,62,55,29,4,7,187,False,2,2,2,2333,117,163.1175,Bug
Vue,10810,21164,1093.0436458333334,CLOSED,2,5,1,1,1,1,False,0,1,1,1236,7,17.412222222222223,Bug
Vue,293,495,905.7624999999999,MERGED,178,391,9,8,4,181,True,0,8,6,1158,569,29.75138888888889,Bug
JavaScript,5140,7051,1275.1710416666667,MERGED,137,143,6,2,6,300,False,0,2,2,1902,280,181.40694444444443,Document
Go,395,660,1340.7919675925925,MERGED,1,1,1,0,1,137,False,0,0,0,173,2,2.3255555555555554,Bug
PHP,1334,2960,4279.919131944444,MERGED,1,1,1,2,1,6,False,0,2,2,1745,2,5.831111111111111,Document
PHP,883,2338,1907.3275,CLOSED,8,9,2,2,1,72,False,0,2,2,1616,17,10.897777777777778,Document
PHP,1334,2960,4279.286284722222,MERGED,1,1,1,1,1,94,False,0,1,1,1589,2,0.16277777777777777,Document
TypeScript,85,724,388.14050925925926,MERGED,7,37,7,0,4,126,False,0,0,0,3313,44,69.02444444444444,Document
TypeScript,261,3765,748.7086689814814,MERGED,70,367,11,0,1,289,True,0,0,0,2369,437,66.50472222222223,Document
Go,395,660,1336.0035416666667,MERGED,9,13,1,0,1,130,False,0,0,0,178,22,117.22944444444444,Bug
JavaScript,9664,43890,3733.137696759259,CLOSED,0,0,0,0,0,195,True,0,0,0,351,0,0.1125,Bug
TypeScript,1297,21107,490.2316666666666,CLOSED,1,2,1,4,1,0,False,1,3,2,1451,3,30.49277777777778,Document
TypeScript,7,6,717.0044907407408,MERGED,1,412,4,1,6,245,False,1,0,0,1849,413,2.370833333333333,Feature
Go,11875,71345,2769.531886574074,CLOSED,3,19,3,0,1,0,False,0,0,0,276,22,0.0075,Feature
PHP,1334,2960,4278.285277777778,MERGED,4,5,1,1,1,884,False,0,1,1,2351,9,19.42972222222222,Feature
TypeScript,15,34,562.1775115740741,CLOSED,1,1,1,0,1,195,False,0,0,0,227,2,78.62388888888889,Bug
Vue,293,495,903.5747106481481,MERGED,37,19,7,4,7,78,False,0,4,3,1219,56,52.059444444444445,Bug
Go,395,660,1337.859861111111,MERGED,1,6,1,0,1,135,False,0,0,0,251,7,72.72555555555556,Feature
TypeScript,12,11,1059.2732291666666,MERGED,576,5379,39,0,6,188,False,0,0,0,4551,5955,551.7094444444444,Bug
TypeScript,202,107,1216.940949074074,MERGED,3,3,1,2,1,294,True,0,2,2,1376,6,85.47944444444444,Document
TypeScript,7,6,716.028900462963,MERGED,2,37,2,0,4,292,False,0,0,0,1581,39,23.849722222222223,Feature
Vue,10810,21164,1093.0589351851852,MERGED,5,32,2,2,3,194,False,2,0,0,2063,37,243.0938888888889,Bug
TypeScript,12,11,1059.3775694444446,MERGED,130,133,3,0,4,232,False,0,0,0,3098,263,26.9975,Feature
JavaScript,5140,7051,1275.8609722222222,MERGED,22,513,12,2,6,338,False,1,1,1,228,535,114.00861111111111,Feature
Go,395,660,1337.1447569444445,MERGED,87,209,5,1,3,134,False,0,1,1,612,296,591.5383333333333,Feature
Go,395,660,1336.0301157407407,MERGED,60,29,5,0,5,131,False,0,0,0,226,89,116.6288888888889,Feature
TypeScript,2147,14725,1544.1777546296296,MERGED,34,446,4,0,1,61,False,0,0,0,3257,480,13.000277777777777,Feature
V,2097,34362,1625.5294675925925,MERGED,2,4,1,1,2,3,False,0,1,1,1239,6,13.399444444444445,Feature
Go,11875,71345,2767.9266319444446,MERGED,14,34,12,0,1,303,True,0,0,0,364,48,0.8866666666666667,Feature
Go,421,1654,1583.953877314815,MERGED,20,18,4,0,1,496,True,0,0,0,2936,38,22.625555555555554,Bug
TypeScript,85,724,386.9416203703704,MERGED,2,188,5,0,1,125,False,0,0,0,3479,190,3.5702777777777777,Document
TypeScript,202,107,1217.7000231481481,MERGED,4,8,2,3,2,270,True,0,3,3,1492,12,0.45222222222222225,Document
Vue,293,495,902.816261574074,MERGED,74,50,9,6,8,76,False,0,6,4,1229,124,1.5275,Bug
Vue,293,495,902.7309953703704,MERGED,225,190,5,4,6,74,False,1,3,2,1286,415,3.571388888888889,Bug
TypeScript,7,6,717.9314583333334,MERGED,298,716,17,4,5,304,False,0,4,1,417,1014,0.5663888888888889,Bug
Python,547,7161,2308.503935185185,CLOSED,2718,6782,130,0,20,41,False,0,0,0,1118,9500,120.79972222222223,Bug
Vue,10810,21164,1095.8369328703704,MERGED,6,4,1,0,1,105,True,0,0,0,1490,10,8.9275,Bug
JavaScript,9664,43890,3733.143796296296,MERGED,2,2,2,0,1,196,True,0,0,0,382,4,0.22138888888888889,Bug
JavaScript,9664,43890,3733.0590625,MERGED,82,65,20,0,3,323,True,0,0,0,461,147,1.7922222222222222,Feature
TypeScript,202,107,1216.8449421296298,MERGED,2,22,1,4,2,286,True,1,3,3,1227,24,14.934722222222222,Bug
Go,395,660,1336.8187037037037,MERGED,4,4,1,0,1,96,False,0,0,0,267,8,0.2863888888888889,Feature
TypeScript,307,2556,610.4594444444444,MERGED,3,4,1,1,2,589,True,1,0,0,993,7,95.455,Feature
TypeScript,15,34,562.6380902777778,MERGED,27,53,3,0,4,374,False,0,0,0,305,80,93.405,Feature
Vue,10810,21164,1094.825173611111,MERGED,26,28,1,0,1,196,False,0,0,0,1758,54,29.6625,Document
TypeScript,1297,21107,487.71975694444444,CLOSED,1,94,3,1,5,1160,True,0,1,1,1715,95,7.404444444444445,Document
TypeScript,15,34,560.7633796296296,MERGED,94,175,2,0,1,1069,False,0,0,0,232,269,0.0030555555555555557,Bug
Go,752,2399,799.6574652777778,MERGED,1,6,1,0,2,160,False,0,0,0,1134,7,0.2841666666666667,Bug
Go,752,2399,799.4667824074073,MERGED,13,8,1,0,1,159,False,0,0,0,1169,21,0.13111111111111112,Bug
Vue,10810,21164,1094.812037037037,MERGED,2,2,1,0,1,195,False,0,0,0,1461,4,0.5286111111111111,Document
C#,80,125,892.5772916666666,MERGED,1,0,1,0,1,229,False,0,0,0,381,1,0.8016666666666666,Document
JavaScript,5140,7051,1275.6326041666666,MERGED,47,224,33,2,20,106,False,1,1,1,2937,271,194.16861111111112,Feature
Python,547,7161,2313.525902777778,MERGED,3,14,1,0,6,36,False,0,0,0,1828,17,46.96194444444444,Document
TypeScript,15,34,561.2459143518519,MERGED,30,32,5,1,2,523,True,0,1,1,360,62,119.75694444444444,Feature
TypeScript,1297,21107,491.9648611111111,MERGED,1,6,3,1,1,1203,True,0,1,1,1806,7,0.013888888888888888,Document
TypeScript,202,107,1214.819525462963,MERGED,2,27,1,4,2,292,True,0,4,3,1279,29,38.840833333333336,Document
F#,153,337,2992.2351041666666,MERGED,31,25,1,0,1,37,False,0,0,0,2977,56,0.6186111111111111,Document
Java,450,746,4144.050324074074,MERGED,1,1,1,0,1,24,False,0,0,0,466,2,3.2908333333333335,Bug
V,2097,34362,1622.9637384259258,MERGED,1,1,1,0,1,15,False,0,0,0,1352,2,8.784722222222221,Document
TypeScript,307,2556,609.754224537037,MERGED,0,36,1,0,1,588,True,0,0,0,1178,36,23.330555555555556,Document
Go,395,660,1336.1221180555556,MERGED,39,30,2,0,2,132,False,0,0,0,303,69,115.40416666666667,Feature
Go,752,2399,797.6865046296297,MERGED,3,4,2,0,5,2,False,0,0,0,1218,7,28.87638888888889,Document
Vue,10810,21164,1093.1126736111112,CLOSED,11,0,1,4,5,4,False,2,2,2,2032,11,20.24111111111111,Bug
JavaScript,9664,43890,3727.991134259259,MERGED,11,11,2,0,1,74,True,0,0,0,358,22,0.24694444444444444,Bug
Go,395,660,1337.0510416666666,MERGED,8,18,4,0,3,133,False,0,0,0,424,26,189.42,Feature
TypeScript,307,2556,609.4778125,MERGED,6,3,2,0,1,585,True,0,0,0,1033,9,6.673611111111111,Bug
TypeScript,1297,21107,490.6351851851852,MERGED,9,57,4,1,2,1194,True,0,1,1,1760,66,0.2863888888888889,Document
TypeScript,15,34,561.7066550925925,MERGED,0,1,1,0,1,1073,False,0,0,0,418,1,0.12166666666666667,Document
Java,450,746,4143.018148148148,MERGED,146,67,7,0,5,23,False,0,0,0,537,213,143.07611111111112,Feature
JavaScript,9664,43890,3730.062928240741,MERGED,1,0,1,0,1,322,True,0,0,0,364,1,0.18388888888888888,Feature
Go,2083,11770,1591.2699537037035,MERGED,1,1,1,0,1,943,True,0,0,0,1207,2,0.010833333333333334,Document
Go,421,1654,1580.1599652777777,MERGED,143,205,4,2,7,76,False,1,1,1,2901,348,23.872777777777777,Bug
TypeScript,15,34,561.3711342592593,MERGED,18,7,4,0,3,194,False,0,0,0,398,25,4.7186111111111115,Bug
TypeScript,307,2556,613.7072916666667,MERGED,5,2,3,0,1,590,True,0,0,0,1496,7,17.51527777777778,Feature
TypeScript,1297,21107,490.0360185185186,MERGED,7,19,2,1,3,1188,True,0,1,1,1966,26,0.10027777777777777,Document
TypeScript,261,3765,751.8438657407409,MERGED,20,31,5,0,1,262,False,0,0,0,4279,51,44.956944444444446,Document
TypeScript,7,6,716.165150462963,MERGED,13,13,4,1,3,293,False,0,1,1,2684,26,0.98,Feature
TypeScript,15,34,561.0063773148148,MERGED,1,15,2,0,3,1071,False,0,0,0,304,16,1.5694444444444444,Feature
TypeScript,307,2556,613.6863194444444,MERGED,1,1,1,0,1,14,False,0,0,0,1258,2,1.378611111111111,Bug
V,2097,34362,1626.2666203703702,MERGED,2,10,1,0,1,54,True,0,0,0,1888,12,0.9058333333333334,Bug
TypeScript,1297,21107,489.7361921296296,MERGED,2,181,6,1,2,1186,True,0,1,1,2226,183,0.8913888888888889,Document
TypeScript,1297,21107,489.5865972222222,MERGED,0,7,1,1,1,1183,True,0,1,1,1751,7,9.29138888888889,Document
V,2097,34362,1625.6389699074073,CLOSED,2,27,3,1,1,230,True,0,1,1,1798,29,34.50805555555556,Document
TypeScript,15,34,560.7498842592593,MERGED,3,1,1,0,1,1068,False,0,0,0,340,4,0.4588888888888889,Document
TypeScript,15,34,560.6396412037037,MERGED,11,19,2,0,1,1067,False,0,0,0,327,30,0.37222222222222223,Bug
TypeScript,15,34,563.2282291666667,MERGED,1,1,1,0,1,525,True,0,0,0,470,2,0.36,Bug
Python,137,75,756.2592939814814,CLOSED,0,72,2,0,1,31,False,0,0,0,1242,72,996.485,Bug
TypeScript,15,34,560.5074305555555,MERGED,5,3,2,0,1,1065,False,0,0,0,289,8,0.5105555555555555,Feature
JavaScript,9664,43890,3728.1042476851853,MERGED,1818,669,20,0,8,331,True,0,0,0,541,2487,46.117222222222225,Feature
TypeScript,1297,21107,488.9744444444445,MERGED,29,103,4,1,2,1179,True,0,1,1,2475,132,0.0961111111111111,Document
TypeScript,261,3765,751.7092013888888,MERGED,1,6,2,0,4,261,False,0,0,0,3500,7,1.7622222222222221,Document
TypeScript,1297,21107,488.9066319444444,MERGED,18,49,4,1,3,1178,True,0,1,1,1870,67,0.24583333333333332,Document
JavaScript,9664,43890,3728.803113425926,MERGED,2,2,2,0,2,320,True,0,0,0,457,4,0.15916666666666668,Bug
TypeScript,261,3765,751.6703125,MERGED,48,95,12,0,1,291,True,0,0,0,4034,143,0.8183333333333334,Document
TypeScript,41369,87415,3008.6726620370373,MERGED,2,2,2,3,2,1952,True,0,3,3,2255,4,2.2258333333333336,Document
V,2097,34362,1625.2844328703704,MERGED,4,4,2,0,1,1,False,0,0,0,1831,8,0.5972222222222222,Document
TypeScript,2070,16643,1317.3454050925927,MERGED,0,1,1,0,2,47,True,0,0,0,2320,1,164.99944444444444,Bug
TypeScript,15,34,561.5903819444444,MERGED,133,324,28,0,18,373,False,0,0,0,408,457,23.714166666666667,Bug
TypeScript,15,34,561.2866666666666,MERGED,7,7,2,0,2,524,True,0,0,0,451,14,32.06583333333333,Bug
TypeScript,2070,16643,1316.6508680555555,MERGED,4,4,1,0,1,4,False,0,0,0,2811,8,183.13722222222222,Document
V,2097,34362,1624.3723842592592,CLOSED,26,53,1,13,3,20,False,7,6,1,1952,79,13.804444444444444,Document
V,2097,34362,1624.3848842592595,MERGED,7,7,1,0,1,21,False,0,0,0,1885,14,4.840833333333333,Document
V,2097,34362,1624.1042708333334,MERGED,2,2,1,5,2,0,False,1,4,2,1596,4,10.282777777777778,Document
TypeScript,15,34,560.7838425925926,MERGED,30,103,13,0,3,1070,False,0,0,0,474,133,19.104444444444443,Bug
TypeScript,2070,16643,1313.7715277777777,MERGED,0,28,1,1,4,0,False,1,0,0,4019,28,879.0830555555556,Bug
TypeScript,15,34,560.632951388889,MERGED,25,20,15,0,4,1066,False,0,0,0,513,45,3.308333333333333,Bug
TypeScript,261,3765,746.7088310185185,MERGED,1,90,9,0,1,288,True,0,0,0,3230,91,172.3022222222222,Document
TypeScript,15,34,560.4032754629629,MERGED,5,5,3,0,2,152,False,0,0,0,469,10,6.148055555555556,Bug
Go,421,1654,1583.9640393518519,MERGED,97,97,3,0,1,497,True,0,0,0,4682,194,25.079722222222223,Document
TypeScript,15,34,560.3743055555556,CLOSED,97,97,28,0,4,151,False,0,0,0,489,194,0.6563888888888889,Feature
Go,2083,11770,1592.8444328703702,MERGED,1,11,1,0,1,944,True,0,0,0,1937,12,0.10777777777777778,Document
JavaScript,9664,43890,3730.014039351852,MERGED,3,8,2,0,2,321,True,0,0,0,594,11,0.7986111111111112,Bug
F#,271,818,2803.9960300925927,MERGED,3,18,2,0,1,17,True,0,0,0,3095,21,1.4283333333333332,Document
TypeScript,202,107,1219.157349537037,MERGED,1,1,1,5,4,11,False,0,5,3,868,2,207.54611111111112,Bug
V,2097,34362,1622.726099537037,MERGED,0,24,1,0,1,14,False,0,0,0,1691,24,3.1975,Document
TypeScript,85,724,387.0815277777778,MERGED,812,37,16,0,5,201,False,0,0,0,5175,849,1.5055555555555555,Document
TypeScript,41369,87415,3009.4860763888887,MERGED,1,1,1,1,1,39,False,0,1,1,1964,2,0.4077777777777778,Document
TypeScript,41369,87415,3008.9078935185184,MERGED,8,10,5,3,10,1635,True,1,2,2,2036,18,17.48027777777778,Document
JavaScript,5140,7051,1279.531539351852,MERGED,22,834,10,1,10,107,False,0,1,1,3747,856,72.27083333333333,Feature
TypeScript,307,2556,608.752824074074,MERGED,2,12,2,0,1,27,False,0,0,0,1437,14,23.911666666666665,Bug
F#,271,818,2802.479502314815,MERGED,5,55,2,0,2,15,True,0,0,0,3890,60,21.731944444444444,Feature
TypeScript,85,724,385.9483217592593,MERGED,66,650,12,0,5,123,False,0,0,0,3976,716,4.362777777777778,Document
Erlang,2054,12122,3871.029826388889,MERGED,8,2715,26,3,21,400,True,0,3,2,1412,2723,15.692222222222222,Document
JavaScript,9664,43890,3728.078449074074,MERGED,6,6,1,1,1,1,False,0,1,1,645,12,17.807222222222222,Bug
TypeScript,41369,87415,3012.842210648148,MERGED,2,5,1,2,1,625,True,0,2,2,2538,7,0.10166666666666667,Document
TypeScript,1297,21107,491.6276388888889,MERGED,117,44,6,1,2,1199,True,0,1,1,3029,161,0.05333333333333334,Document
TypeScript,261,3765,746.8763078703704,MERGED,8,101,14,0,2,256,False,0,0,0,4745,109,1.1711111111111112,Document
TypeScript,15,34,560.7202893518519,CLOSED,148,334,26,0,11,73,False,0,0,0,574,482,49.3075,Feature
PHP,883,2338,1908.0436921296296,CLOSED,7,24,5,5,2,6,False,1,4,2,3307,31,69.68805555555555,Document
JavaScript,9664,43890,3733.1125115740742,MERGED,84,1112,25,0,5,333,True,0,0,0,761,1196,21.178333333333335,Bug
TypeScript,15,34,560.4530208333333,MERGED,221,63,11,0,5,193,False,0,0,0,605,284,40.75416666666667,Feature
TypeScript,4,33,838.4124768518518,MERGED,1,1,1,1,1,664,True,0,1,1,773,2,0.07861111111111112,Bug
TypeScript,3393,2334,1042.967013888889,MERGED,1,2,1,2,1,504,False,0,2,1,1079,3,0.3552777777777778,Document
JavaScript,9664,43890,3733.121435185185,MERGED,20,15,6,0,1,324,True,0,0,0,724,35,0.14027777777777778,Bug
C#,80,125,895.6190046296297,MERGED,24,8,6,0,1,1,False,0,0,0,714,32,7.692222222222222,Document
Go,2083,11770,1589.275162037037,CLOSED,18,115,6,0,1,0,False,0,0,0,2397,133,0.01,Document
JavaScript,9664,43890,3732.7955671296295,MERGED,7,90,7,0,1,332,True,0,0,0,850,97,0.2075,Feature
TypeScript,2070,16643,1313.1949652777778,CLOSED,2,2,1,1,1,77,True,1,0,0,2245,4,2.1894444444444443,Bug
Python,72,25,1706.7776273148147,MERGED,23,299,2,6,4,41,False,4,2,1,2942,322,116.80583333333334,Feature
TypeScript,1297,21107,490.0502314814815,MERGED,4,106,8,1,2,1189,True,0,1,1,3385,110,0.06277777777777778,Document
TypeScript,1297,21107,490.0280324074074,MERGED,1,36,3,1,1,1187,True,0,1,1,2479,37,0.010277777777777778,Document
PHP,1334,2960,4278.970173611111,MERGED,3,11,3,2,3,2,False,0,2,2,3629,14,2.925,Document
TypeScript,41369,87415,3012.8963310185186,MERGED,317,361,3,5,5,626,True,1,4,4,3065,678,12.393611111111111,Document
TypeScript,41369,87415,3012.7338078703706,MERGED,0,8,2,2,6,0,False,0,2,2,2490,8,17.615833333333335,Document
Python,137,75,757.1274537037037,CLOSED,0,279,16,0,6,32,False,0,0,0,2492,279,959.2572222222223,Bug
JavaScript,22,26,988.9246180555556,MERGED,1,1,1,0,1,16,True,0,0,0,953,2,3.8672222222222223,Feature
JavaScript,9664,43890,3728.4857638888893,MERGED,13,13,1,0,1,0,False,0,0,0,940,26,32.93,Bug
TypeScript,41369,87415,3012.7656597222226,MERGED,2,2,1,2,1,1956,True,0,2,2,2554,4,0.48388888888888887,Document
TypeScript,41369,87415,3012.6548379629626,MERGED,3,4,1,2,1,516,True,0,2,2,2561,7,0.7552777777777778,Document
TypeScript,41369,87415,3012.642071759259,MERGED,8,7,6,2,1,1955,True,0,2,2,2753,15,0.6141666666666666,Document
TypeScript,3989,23861,2903.1622569444444,MERGED,4,23,3,1,7,37,False,0,1,1,1573,27,428.74888888888887,Feature
TypeScript,41369,87415,3012.4597337962964,MERGED,1613,1591,2,2,3,135,True,0,2,2,2216,3204,1.3688888888888888,Document
TypeScript,41369,87415,3012.460138888889,MERGED,0,1,1,2,1,623,True,0,2,2,2515,1,0.15166666666666667,Document
TypeScript,41369,87415,3012.145115740741,CLOSED,42915,42915,5,3,3,32,False,0,3,3,2714,85830,11.71,Document
TypeScript,1297,21107,488.86123842592593,MERGED,1,178,9,1,6,1176,True,0,1,1,3184,179,0.1313888888888889,Document
TypeScript,1297,21107,488.83752314814814,MERGED,8,15,2,1,1,1175,True,0,1,1,2548,23,0.011944444444444445,Document
JavaScript,5140,7051,1274.8705208333333,MERGED,20,326,9,2,7,105,False,1,1,1,3534,346,111.30388888888889,Bug
TypeScript,41369,87415,3009.730358796296,MERGED,2,251,4,2,5,1636,True,0,2,2,2726,253,144.92333333333335,Document
TypeScript,1297,21107,488.6514467592593,MERGED,0,139,3,1,2,1169,True,0,1,1,2141,139,0.009444444444444445,Document
Java,450,746,4143.996226851852,MERGED,23,620,30,0,28,41,False,0,0,0,755,643,122.63138888888889,Feature
C#,655,7879,1902.405763888889,MERGED,3,3,2,3,2,7,True,1,2,2,1986,6,568.6938888888889,Document
TypeScript,41369,87415,3011.9383564814816,MERGED,1,1,1,2,1,1954,True,0,2,2,2239,2,0.24916666666666668,Document
TypeScript,41369,87415,3011.8555671296294,CLOSED,2,6,1,2,1,5,False,0,2,2,2354,8,0.14944444444444444,Document
JavaScript,5140,7051,1275.7039236111111,MERGED,19,27,17,1,13,19,False,0,1,1,4123,46,24.635833333333334,Feature
TypeScript,4,33,835.5193518518519,MERGED,1,0,1,1,1,663,True,0,1,1,971,1,0.05555555555555555,Feature
TypeScript,4,33,835.4025115740741,MERGED,2,1,1,1,1,661,True,0,1,1,729,3,0.041666666666666664,Feature
TypeScript,1297,21107,487.9470023148148,MERGED,22,205,7,1,3,1162,True,0,1,1,2552,227,0.11916666666666667,Document
TypeScript,202,107,1216.8086805555556,MERGED,20,23,1,3,1,285,True,0,3,3,3152,43,0.5894444444444444,Bug
TypeScript,4,33,835.3420833333333,MERGED,1,1,1,1,1,659,True,0,1,1,967,2,0.14333333333333334,Bug
TypeScript,41369,87415,3010.9991087962967,MERGED,2,2,1,4,1,1,False,1,3,3,2265,4,20.551111111111112,Document
TypeScript,15,34,562.43,MERGED,179,438,22,0,7,153,False,0,0,0,936,617,91.74944444444445,Bug
TypeScript,307,2556,610.7238310185186,MERGED,2,2,1,0,1,207,True,0,0,0,551,4,71.01472222222222,Bug
C#,80,125,892.7234606481483,MERGED,10,1113,3,0,1,196,False,0,0,0,779,1123,0.9186111111111112,Document
TypeScript,307,2556,609.513761574074,MERGED,17,24,4,2,1,587,True,0,2,2,2262,41,101.03166666666667,Bug
C#,655,7879,1904.1735069444446,MERGED,14,208,4,1,1,248,True,0,1,1,1852,222,8.20111111111111,Document
TypeScript,41369,87415,3010.7025810185187,MERGED,42966,42959,10,4,4,3,False,0,4,3,3007,85925,2.647222222222222,Document
Go,752,2399,798.6717708333334,MERGED,1,102,4,0,1,158,False,0,0,0,2913,103,18.963333333333335,Bug
C#,80,125,891.6546643518518,MERGED,0,1,1,0,1,197,False,0,0,0,1032,1,22.74888888888889,Document
TypeScript,7,6,720.1668981481481,MERGED,17,37,3,0,23,46,True,0,0,0,4964,54,193.51777777777778,Feature
TypeScript,41369,87415,3010.0566203703706,MERGED,7,5,1,2,3,1,False,0,2,2,1317,12,0.5388888888888889,Bug
V,2097,34362,1622.9870949074075,MERGED,2,18,2,0,1,18,False,0,0,0,2616,20,8.238611111111112,Document
V,2097,34362,1622.9805439814816,MERGED,2,13,1,0,2,17,False,0,0,0,1922,15,8.372777777777777,Document
V,2097,34362,1622.9671296296294,MERGED,19,12,1,0,1,16,False,0,0,0,2347,31,8.711944444444445,Document
TypeScript,41369,87415,3009.9761226851856,MERGED,1,6,2,2,1,1637,True,0,2,2,2995,7,0.5527777777777778,Document
Starlark,440,286,562.7367361111111,MERGED,3,12,1,3,2,1,False,2,1,1,1729,15,792.7455555555556,Feature
TypeScript,41369,87415,3009.658171296296,MERGED,9,3,2,2,1,2,False,0,2,2,2466,12,0.40166666666666667,Document
JavaScript,9664,43890,3728.279953703704,MERGED,0,1,1,1,3,0,False,0,1,1,683,1,12.918333333333333,Feature
C#,655,7879,1902.4186574074074,MERGED,3,0,1,0,1,8,True,0,0,0,1714,3,39.64277777777778,Document
C#,655,7879,1904.1869675925927,MERGED,19,243,9,2,11,10,False,0,2,2,2442,262,264.06666666666666,Document
TypeScript,41369,87415,3009.4669907407406,MERGED,11,4,3,1,5,510,True,0,1,1,2721,15,1.7202777777777778,Document
TypeScript,41369,87415,3009.4628009259263,MERGED,0,8,2,1,1,37,False,0,1,1,2321,8,0.33916666666666667,Document
TypeScript,15,34,561.7563310185185,MERGED,10,23,2,0,5,74,False,0,0,0,772,33,19.754444444444445,Bug
TypeScript,41369,87415,3008.8572337962964,MERGED,2,32,4,2,3,1634,True,0,2,2,3435,34,0.5327777777777778,Document
TypeScript,41369,87415,3008.8294791666667,CLOSED,43,27,2,4,1,36,False,1,3,3,2899,70,0.12416666666666666,Document
TypeScript,41369,87415,3008.8013194444447,MERGED,1,1,1,5,1,509,True,2,3,3,2197,2,0.5077777777777778,Document
TypeScript,307,2556,613.4677083333333,MERGED,84,103,2,12,3,2,False,5,7,2,879,187,22.98027777777778,Document
Go,1174,11429,1913.139050925926,MERGED,293,1333,37,8,1,391,True,7,1,1,3027,1626,329.5725,Document
C#,655,7879,1901.241261574074,MERGED,2,41,2,5,2,1528,True,2,3,2,1870,43,34.644444444444446,Document
TypeScript,2070,16643,1316.896701388889,MERGED,7,30,2,0,1,4,False,0,0,0,3498,37,175.76833333333335,Bug
TypeScript,41369,87415,3007.7405555555556,MERGED,0,54,2,1,1,133,True,0,1,1,2467,54,0.4222222222222222,Document
Go,1174,11429,1912.9139583333333,MERGED,22,42,7,4,4,372,True,3,1,1,4934,64,308.5911111111111,Document
JavaScript,22,26,993.657048611111,MERGED,0,7,2,0,1,17,True,0,0,0,1319,7,0.03111111111111111,Document
TypeScript,2070,16643,1315.9056597222223,MERGED,26,16,8,0,4,79,True,0,0,0,4622,42,199.55333333333334,Bug
Java,450,746,4148.086342592593,MERGED,60,102,2,1,5,17,False,0,1,1,1285,162,193.74333333333334,Document
TypeScript,202,107,1219.6185648148148,MERGED,98,160,1,4,8,287,True,0,4,3,3826,258,210.62916666666666,Bug
Python,72,25,1711.7692592592593,MERGED,32,361,2,0,2,44,False,0,0,0,4506,393,40.46666666666667,Bug
Erlang,2054,12122,3871.1090162037035,CLOSED,1,1,1,0,1,148,False,0,0,0,1142,2,25.952222222222222,Document
C#,655,7879,1899.4426851851852,MERGED,0,26,3,4,1,81,False,0,4,2,1590,26,21.021944444444443,Document
TypeScript,2147,14725,1546.8689583333335,MERGED,243,320,12,0,2,214,False,0,0,0,9152,563,27.829166666666666,Document
Erlang,2054,12122,3871.0002893518517,MERGED,3,4,2,0,3,258,True,0,0,0,1102,7,3.7669444444444444,Document
Erlang,2054,12122,3870.8839814814814,MERGED,6,57,2,0,1,399,True,0,0,0,1111,63,3.508888888888889,Document
Erlang,2054,12122,3868.423645833333,MERGED,31,1346,28,0,3,423,False,0,0,0,1361,1377,138.015,Document
TypeScript,149,2900,453.8136921296296,MERGED,0,18,1,6,2,122,False,3,3,2,1145,18,123.16694444444444,Document
C#,655,7879,1904.2139583333335,MERGED,7,52,26,1,2,660,True,0,1,1,2308,59,74.51472222222222,Document
Go,1174,11429,1912.618136574074,MERGED,12,18,1,3,1,457,True,1,2,1,1530,30,7.76,Document
C++,363,552,612.2398032407408,MERGED,1,74,1,3,1,292,False,2,1,1,1710,75,41.00277777777778,Document
TypeScript,4,33,837.3800925925925,MERGED,422,359,41,1,22,406,True,0,1,1,1409,781,77.1,Feature
TypeScript,41369,87415,3012.802650462963,MERGED,20,48,3,3,7,1638,True,1,2,2,3623,68,69.49472222222222,Document
Erlang,2054,12122,3868.9869675925925,MERGED,1,1,1,0,1,398,True,0,0,0,1141,2,39.80416666666667,Document
TypeScript,3393,2334,1043.1359027777778,MERGED,10,119,3,1,2,172,False,0,1,1,1670,129,0.5269444444444444,Document
Erlang,2054,12122,3868.1519675925924,MERGED,4,67,3,0,1,24,False,0,0,0,1253,71,77.72972222222222,Document
TypeScript,3393,2334,1042.957673611111,MERGED,0,42,1,2,4,369,False,1,1,1,1282,42,0.5747222222222222,Feature
C#,80,125,895.7260648148149,MERGED,18,22,4,0,1,207,True,0,0,0,1031,40,20.091944444444444,Document
Java,450,746,4143.261342592593,MERGED,235,243,10,0,2,384,False,0,0,0,1741,478,282.18638888888887,Feature
TypeScript,184,377,1982.721273148148,MERGED,0,641,2,0,14,50,False,0,0,0,1447,641,24.56361111111111,Document
C#,655,7879,1903.842152777778,MERGED,4,37,2,3,2,659,True,1,2,2,2267,41,41.949444444444445,Document
Starlark,440,286,562.3242361111111,CLOSED,0,59,1,2,1,0,False,1,1,1,1016,59,92.74416666666667,Feature
TypeScript,1297,21107,491.6409143518519,MERGED,21,163,9,1,3,1200,True,0,1,1,3417,184,0.08972222222222222,Document
Go,752,2399,802.4747222222222,MERGED,39,17,1,0,1,63,False,0,0,0,4241,56,56.089166666666664,Bug
C#,655,7879,1904.1303356481483,MERGED,3,0,1,0,1,9,True,0,0,0,2012,3,15.432222222222222,Document
TypeScript,2147,14725,1544.8771412037038,MERGED,57,52,11,0,1,688,False,0,0,0,5317,109,0.8013888888888889,Document
TypeScript,261,3765,749.4859490740741,MERGED,216,137,18,0,3,1039,True,0,0,0,7849,353,47.79083333333333,Document
Erlang,2054,12122,3867.385821759259,MERGED,17,15,4,0,1,93,False,0,0,0,965,32,84.56305555555555,Document
TypeScript,4,33,835.3025810185185,MERGED,469,536,64,1,20,405,True,0,1,1,1186,1005,71.45611111111111,Bug
C++,363,552,611.0408101851853,MERGED,0,22,3,0,2,291,False,0,0,0,1730,22,46.00194444444445,Document
V,2097,34362,1627.4155092592591,MERGED,6,48,5,6,5,231,True,2,4,2,3287,54,6.3036111111111115,Document
C#,80,125,891.6917824074075,MERGED,1639,3501,11,0,16,189,False,0,0,0,1687,5140,628.1516666666666,Document
TypeScript,2147,14725,1544.0746064814814,MERGED,58,177,10,0,1,778,False,0,0,0,5407,235,3.1547222222222224,Bug
TypeScript,3393,2334,1041.1580208333332,MERGED,0,68,5,2,2,367,False,0,2,2,1615,68,42.03388888888889,Feature
TypeScript,3393,2334,1040.753912037037,MERGED,1,1,1,2,1,0,False,0,2,1,1414,2,52.37083333333333,Bug
Erlang,2054,12122,3868.264282407408,MERGED,3,6,4,0,1,91,False,0,0,0,1109,9,1.8911111111111112,Document
TypeScript,2070,16643,1314.9955324074074,MERGED,2,20,1,0,1,78,True,0,0,0,3165,22,0.5436111111111112,Document
TypeScript,12,11,1061.5515046296296,MERGED,326,3276,24,0,10,190,False,0,0,0,7656,3602,496.78805555555556,Feature
V,2097,34362,1624.7268287037039,CLOSED,207,151,2,2,4,0,False,0,2,1,3107,358,8.703055555555556,Document
Erlang,2054,12122,3867.9485763888893,MERGED,0,2,1,0,1,90,False,0,0,0,1144,2,0.02666666666666667,Document
Erlang,2054,12122,3867.9062615740745,MERGED,13,10,3,0,1,440,True,0,0,0,1184,23,1.456388888888889,Document
Erlang,2054,12122,3867.896412037037,MERGED,9,86,6,0,3,31,False,0,0,0,1375,95,1.9630555555555556,Document
Erlang,2054,12122,3867.5076041666666,MERGED,2,5,4,0,1,23,False,0,0,0,1216,7,22.544722222222223,Document
TypeScript,41369,87415,3013.080613425926,CLOSED,16,31,3,2,4,517,True,0,2,2,3335,47,32.705,Document
Erlang,2054,12122,3867.768587962963,MERGED,3,3,3,0,1,439,True,0,0,0,1258,6,3.2019444444444445,Document
Python,1912,12143,144.1475462962963,MERGED,29,47,6,3,7,0,False,2,1,1,1695,76,21.604444444444443,Document
C#,80,125,892.7596180555556,MERGED,6199,44876,244,0,30,41,False,0,0,0,994,51075,93.91,Document
Erlang,2054,12122,3867.3853125,CLOSED,370,581,47,1,24,422,False,0,1,1,1252,951,16.6425,Document
Erlang,2054,12122,3867.115787037037,CLOSED,21,348,5,5,2,92,False,1,4,2,1289,369,22.85333333333333,Document
C#,655,7879,1900.0472222222222,MERGED,22,33,3,9,3,1527,True,4,5,3,2143,55,149.99527777777777,Document
Python,2409,12194,311.92315972222224,MERGED,1,2,1,1,4,4,True,0,1,1,1112,3,8.778611111111111,Bug
C#,655,7879,1901.2639583333332,MERGED,27,56,6,1,3,615,True,0,1,1,2137,83,74.5286111111111,Document
Java,450,746,4144.299618055556,CLOSED,73168,1689,47,0,8,164,False,0,0,0,4544,74857,137.18055555555554,Bug
TypeScript,41369,87415,3012.578425925926,MERGED,5,215,7,2,8,136,True,0,2,2,4301,220,20.500833333333333,Document
Erlang,2054,12122,3866.1881944444444,MERGED,8,110,5,1,2,420,False,1,0,0,1239,118,53.20861111111111,Document
Python,137,75,755.8431944444445,MERGED,6,39,6,0,4,104,False,0,0,0,2086,45,0.38722222222222225,Document
JavaScript,5140,7051,1279.6361574074074,MERGED,20,370,9,3,5,276,False,2,1,1,6955,390,44.8525,Bug
TypeScript,41369,87415,3012.6313310185183,MERGED,42915,42915,5,2,4,33,False,0,2,2,3453,85830,0.8733333333333333,Document
TypeScript,261,3765,747.8532291666667,MERGED,194,138,36,0,6,1037,True,0,0,0,6021,332,15.855,Document
Erlang,2054,12122,3866.198773148148,MERGED,3,40,4,1,1,22,False,1,0,0,1171,43,31.43138888888889,Document
TypeScript,4,33,835.3812037037037,MERGED,0,17,8,1,2,660,True,0,1,1,1383,17,0.2633333333333333,Bug
Erlang,2054,12122,3866.093576388889,MERGED,79,47,5,0,2,91,False,0,0,0,1006,126,24.18138888888889,Document
TypeScript,4,33,835.3177893518518,MERGED,18,14,3,2,3,272,True,1,1,1,1692,32,0.15444444444444444,Bug
Erlang,2054,12122,3866.1606944444447,MERGED,1,1,1,0,1,30,False,0,0,0,1045,2,18.338055555555556,Document
C++,363,552,609.2346412037037,MERGED,31,31,19,2,2,289,False,1,1,1,1580,62,11.154444444444444,Document
TypeScript,1297,21107,488.6976273148148,MERGED,75,213,7,1,2,1172,True,0,1,1,5109,288,0.21944444444444444,Document
TypeScript,3393,2334,1039.4378819444444,MERGED,4,8,3,2,2,503,False,0,2,1,1247,12,11.854444444444445,Document
V,2097,34362,1624.7130092592595,MERGED,14,23,3,4,3,22,False,2,2,1,3201,37,10.281944444444445,Document
C#,655,7879,1899.0746180555554,MERGED,6,182,3,7,7,1526,True,2,5,2,2094,188,129.33166666666668,Document
Python,137,75,757.9005787037037,CLOSED,0,280,13,3,31,3,False,0,3,3,3089,280,843.85,Document
C#,655,7879,1901.179201388889,MERGED,1,1,1,1,1,656,True,0,1,1,2353,2,6.1113888888888885,Document
C#,80,125,892.4479513888888,MERGED,76,177,28,0,3,228,False,0,0,0,1070,253,7.305833333333333,Document
C#,655,7879,1901.072511574074,MERGED,15,93,8,1,5,613,True,0,1,1,2311,108,4.162222222222222,Document
PHP,1334,2960,4280.155081018519,MERGED,84,26,3,1,1,887,False,0,1,1,5379,110,0.19277777777777777,Bug
JavaScript,9664,43890,3729.1825231481484,MERGED,1,1,1,0,1,0,False,0,0,0,1021,2,15.883055555555556,Feature
TypeScript,3393,2334,1039.1511458333332,MERGED,1,1,1,1,1,171,False,0,1,1,1462,2,0.13111111111111112,Bug
TypeScript,307,2556,609.4784953703703,MERGED,297,436,79,0,16,586,True,0,0,0,4156,733,125.60083333333333,Feature
Go,2083,11770,1594.2459722222222,MERGED,35,44,6,0,2,946,True,0,0,0,3756,79,0.21611111111111111,Document
TypeScript,4,33,834.2349305555555,MERGED,12,229,7,2,9,269,True,1,1,1,1346,241,2.1733333333333333,Bug
TypeScript,41369,87415,3010.9209953703703,MERGED,8,7,4,2,3,513,True,0,2,2,3467,15,12.474166666666667,Document
TypeScript,4,33,833.3207638888889,MERGED,4822,2626,626,1,23,658,True,0,1,1,1387,7448,47.94777777777778,Feature
TypeScript,61,71,1743.8920833333334,MERGED,5,5,4,0,2,173,True,0,0,0,1273,10,0.48694444444444446,Feature
C++,363,552,608.1019791666666,MERGED,1,9,1,0,1,287,False,0,0,0,1757,10,1.9308333333333334,Document
V,2097,34362,1623.5577777777778,MERGED,21,51,1,0,1,0,False,0,0,0,3365,72,17.998333333333335,Document
TypeScript,41369,87415,3009.472627314815,MERGED,8,8,5,4,2,38,False,1,3,3,3361,16,72.73861111111111,Document
TypeScript,41369,87415,3010.5818518518518,MERGED,33,39,2,2,3,511,True,0,2,2,3787,72,8.132777777777777,Document
C#,655,7879,1900.0941203703703,MERGED,0,2,1,4,1,654,True,0,4,2,2294,2,7.176944444444445,Document
C#,655,7879,1900.0514351851853,MERGED,0,0,1,1,1,612,True,0,1,1,2005,0,8.299166666666666,Document
TypeScript,4,33,833.6793981481482,MERGED,1,177,5,1,3,243,False,0,1,1,1661,178,0.17305555555555555,Document
TypeScript,4,33,833.4639120370371,MERGED,224,247,11,1,13,404,True,0,1,1,1675,471,4.158888888888889,Document
JavaScript,22,26,993.0492361111111,MERGED,0,25,2,0,1,29,True,0,0,0,1959,25,0.7952777777777778,Bug
JavaScript,5140,7051,1274.9814583333334,MERGED,6612,7838,21,3,10,0,False,2,1,1,3666,14450,212.82666666666665,Document
C#,655,7879,1898.9860416666668,MERGED,1,27,2,3,2,611,True,1,2,1,2362,28,47.185,Document
Python,137,75,761.0236805555555,MERGED,0,11,6,0,2,223,False,0,0,0,2209,11,0.21805555555555556,Document
TypeScript,4,33,833.1804629629629,MERGED,35,36,2,4,2,267,True,3,1,1,1277,71,0.49777777777777776,Bug
C#,80,125,890.5177662037037,MERGED,24,164,6,0,3,187,True,0,0,0,1083,188,24.530555555555555,Document
C#,655,7879,1899.13375,MERGED,1,4,1,1,1,13,False,0,1,1,2409,5,22.032777777777778,Document
TypeScript,307,2556,609.8046064814815,CLOSED,1,32,1,2,2,0,False,1,1,1,4075,33,19.558611111111112,Bug
C#,655,7879,1898.9644212962965,MERGED,25,59,6,0,1,653,True,0,0,0,2404,84,26.057222222222222,Document
V,2097,34362,1622.7046874999999,MERGED,6,37,2,0,2,13,False,0,0,0,3488,43,3.7047222222222222,Document
TypeScript,41369,87415,3008.1224305555556,MERGED,8,4,2,2,1,85,True,0,2,2,3116,12,91.78111111111112,Document
Starlark,440,286,564.3816782407407,MERGED,5,17,1,1,2,92,False,0,1,1,2081,22,105.94472222222223,Bug
Go,1835,11246,1801.785474537037,MERGED,0,2,1,0,2,592,False,0,0,0,1512,2,0.017222222222222222,Document
TypeScript,41369,87415,3009.586018518519,MERGED,15,19,4,2,1,1953,True,0,2,2,3331,34,1.3905555555555555,Document
Erlang,2054,12122,3870.989733796296,MERGED,71,297,4,1,5,519,True,1,0,0,1558,368,25.23638888888889,Document
Python,2409,12194,315.9200231481481,MERGED,69,71,7,0,18,405,True,0,0,0,1853,140,7.1947222222222225,Document
JavaScript,22,26,992.0646296296296,MERGED,10,10,4,0,1,27,True,0,0,0,2270,20,0.6852777777777778,Bug
Python,2409,12194,315.94642361111113,MERGED,7,15,1,1,1,406,True,1,0,0,2147,22,0.3441666666666667,Document
Starlark,440,286,563.5262037037037,MERGED,2,33,1,1,1,6,False,0,1,1,2106,35,126.51,Feature
PHP,1334,2960,4277.959351851851,CLOSED,7191,147,758,4,20,1,False,1,3,3,3337,7338,25.70888888888889,Document
TypeScript,41369,87415,3008.742060185185,MERGED,39,18,3,6,2,35,False,1,5,3,4614,57,2.020277777777778,Document
TypeScript,41369,87415,3007.9933449074074,MERGED,18,43,3,2,3,1633,True,0,2,2,3460,61,10.310555555555556,Document
Python,2409,12194,315.0528935185185,MERGED,8,12,2,0,2,402,True,0,0,0,1995,20,0.7866666666666666,Document
PHP,883,2338,1904.2514467592591,CLOSED,0,222,10,8,9,1,False,3,5,3,6923,222,680.4958333333333,Document
TypeScript,3393,2334,1043.1993287037037,MERGED,0,20,4,2,2,505,False,0,2,1,2341,20,18.081666666666667,Feature
Go,1835,11246,1799.9296064814814,MERGED,1,1,1,1,1,0,False,0,1,1,1567,2,16.459722222222222,Document
TypeScript,41369,87415,3007.7677662037036,MERGED,7,12,2,2,1,621,True,0,2,2,3664,19,0.8188888888888889,Document
TypeScript,41369,87415,3007.768472222222,MERGED,97,79,2,1,1,134,True,0,1,1,3096,176,0.6625,Document
TypeScript,41369,87415,3007.6926620370373,MERGED,8,232,2,1,3,132,True,0,1,1,3876,240,0.6886111111111111,Document
Go,1174,11429,1911.850300925926,MERGED,27,652,8,2,1,453,True,1,1,1,1923,679,19.154722222222222,Document
Go,1174,11429,1916.6479050925927,MERGED,269,194,42,3,1,459,True,3,0,0,1879,463,11.14638888888889,Document
C#,655,7879,1899.0247916666667,MERGED,2,40,3,0,10,6,True,0,0,0,2559,42,427.12388888888887,Document
Go,421,1654,1584.2581365740741,CLOSED,504,731,21,0,7,77,False,0,0,0,10150,1235,171.28861111111112,Bug
Go,1835,11246,1798.829363425926,MERGED,32,0,2,0,1,116,False,0,0,0,1576,32,0.015277777777777777,Document
Python,137,75,757.3535069444443,MERGED,0,247,11,0,14,33,False,0,0,0,2082,247,20.20888888888889,Bug
TypeScript,4,33,833.3481134259259,MERGED,319,594,33,1,14,408,False,0,1,1,2291,913,192.50972222222222,Document
Python,14533,41196,1160.9190162037037,MERGED,9,9,2,0,6,1431,True,0,0,0,1827,18,0.17166666666666666,Document
Starlark,440,286,562.7186458333333,CLOSED,3,12,1,3,1,0,False,2,1,1,1843,15,0.19027777777777777,Bug
Python,2409,12194,311.84063657407404,MERGED,1,4,2,8,13,0,False,6,2,1,1799,5,52.132222222222225,Document
Python,2409,12194,312.2747337962963,MERGED,1,4,2,0,3,399,True,0,0,0,1809,5,0.5108333333333334,Document
Python,2409,12194,311.7127314814815,MERGED,2,0,1,0,3,1,False,0,0,0,1605,2,13.881666666666666,Document
Python,2409,12194,311.6845023148148,MERGED,10,11,4,3,4,0,False,2,1,1,1770,21,14.236944444444445,Document
TypeScript,4,33,834.6574999999999,MERGED,1405,3615,35,1,24,409,False,0,1,1,1702,5020,45.06111111111111,Bug
Erlang,2054,12122,3866.8661458333336,MERGED,32,70,3,0,2,438,True,0,0,0,1919,102,7.491388888888889,Document
TypeScript,4,33,835.2484722222222,MERGED,10,16,5,2,2,271,True,1,1,1,2123,26,0.12694444444444444,Document
TypeScript,85,724,388.11083333333335,CLOSED,57,97,13,0,1,204,False,0,0,0,9303,154,0.06,Document
TypeScript,4,33,834.3887500000001,MERGED,12,9,7,1,3,244,False,0,1,1,1777,21,0.08138888888888889,Document
TypeScript,1073,11366,1166.538310185185,MERGED,11,18,1,1,3,305,True,0,1,1,1952,29,2.4719444444444445,Bug
C++,363,552,608.0907407407407,MERGED,0,3,1,0,1,286,False,0,0,0,1903,3,1.6972222222222222,Document
TypeScript,2147,14725,1543.9967245370372,MERGED,4694,10007,80,0,1,319,False,0,0,0,10038,14701,3.1794444444444445,Document
C#,655,7879,1900.9160763888888,MERGED,14,328,8,1,3,655,True,1,0,0,2492,342,77.06166666666667,Document
TypeScript,4,33,833.1409953703704,MERGED,949,426,13,1,11,403,True,0,1,1,1719,1375,2.6466666666666665,Bug
TypeScript,4,33,833.1433796296296,MERGED,103,0,2,3,1,266,True,2,1,1,1614,103,1.2675,Bug
C#,80,125,890.8248958333334,MERGED,89,1880,37,0,12,206,True,0,0,0,1711,1969,46.145,Document
TypeScript,58,78,892.1716087962964,MERGED,56,456,11,1,6,117,False,0,1,1,11625,512,45.839166666666664,Feature
Go,1835,11246,1801.8039467592591,MERGED,4,4,1,0,1,594,False,0,0,0,1970,8,0.021666666666666667,Document
Go,1835,11246,1801.7535069444446,MERGED,1,1,1,0,1,590,False,0,0,0,1637,2,0.010277777777777778,Document
Vue,10810,21164,1096.1989467592591,MERGED,31,167,4,1,6,107,True,0,1,1,13914,198,288.6361111111111,Bug
TypeScript,3393,2334,1043.4308217592593,MERGED,12,12,4,3,1,0,False,0,3,2,2383,24,11.757222222222222,Bug
JavaScript,22,26,993.0473958333333,MERGED,23,31,5,0,1,28,True,0,0,0,2622,54,0.8363888888888888,Bug
Starlark,440,286,565.4257638888889,MERGED,0,197,4,2,1,0,False,1,1,1,2420,197,80.8463888888889,Document
Starlark,440,286,565.4191087962963,MERGED,20,59,1,1,2,93,False,0,1,1,2482,79,81.01222222222222,Bug
C++,2234,23696,2429.883275462963,MERGED,131,254,12,1,27,25,False,0,1,1,6083,385,113.75361111111111,Bug
Python,4517,54993,999.8112268518518,CLOSED,6,31,1,0,2,154,False,0,0,0,2905,37,166.09694444444443,Document
TypeScript,7,6,717.0031944444445,MERGED,135,205,15,0,7,44,True,0,0,0,6291,340,5.4863888888888885,Feature
Python,2409,12194,313.9066203703704,CLOSED,28,29,2,12,3,1,False,6,6,1,2410,57,48.36388888888889,Document
Python,2409,12194,314.76444444444445,MERGED,2,5,1,0,3,401,True,0,0,0,2391,7,1.24,Document
Go,1174,11429,1912.0571874999998,MERGED,111,230,10,2,1,454,True,1,1,1,2623,341,159.10777777777778,Document
Starlark,440,286,561.2213541666666,MERGED,0,299,3,1,2,3,False,0,1,1,2511,299,181.60861111111112,Document
Starlark,440,286,561.2213310185185,MERGED,17,2,1,1,4,2,False,0,1,1,3049,19,181.6025,Document
Python,2409,12194,312.7941666666667,MERGED,1,3,1,7,6,0,False,2,5,1,2549,4,49.431111111111115,Document
TypeScript,307,2556,610.6238425925926,CLOSED,1,33,1,1,3,1,False,0,1,1,3107,34,242.4475,Bug
TypeScript,1297,21107,490.5675810185185,MERGED,22,40,6,1,1,1192,True,0,1,1,5491,62,0.10583333333333333,Document
TypeScript,307,2556,613.7554050925926,CLOSED,172,309,73,1,11,3,False,1,0,0,5691,481,0.13111111111111112,Document
TypeScript,7,6,716.0159375,MERGED,651,2628,62,1,118,43,True,0,1,1,5942,3279,4.542777777777777,Bug
Python,137,75,758.0863541666666,MERGED,0,120,4,0,7,36,False,0,0,0,2220,120,7.155277777777778,Document
Python,137,75,757.8943634259259,MERGED,0,96,4,0,8,35,False,0,0,0,2806,96,8.251944444444444,Document
TypeScript,1073,11366,1167.012986111111,CLOSED,13,14,1,1,6,1,False,0,1,1,2740,27,141.96166666666667,Document
TypeScript,41369,87415,3012.880150462963,MERGED,51,39,8,2,3,1639,True,0,2,2,4824,90,14.169166666666667,Document
V,2097,34362,1625.5239699074073,MERGED,18,21,8,0,1,53,True,0,0,0,5695,39,2.9830555555555556,Document
TypeScript,1073,11366,1167.7139814814816,MERGED,98,160,4,2,8,33,True,1,1,1,3112,258,913.53,Bug
Python,137,75,757.2881481481481,MERGED,2,97,6,0,7,1,False,0,0,0,2775,99,16.238055555555555,Document
TypeScript,1297,21107,489.5768055555556,MERGED,111,133,18,1,2,1182,True,0,1,1,8455,244,0.17083333333333334,Document
TypeScript,202,107,1217.7218055555556,MERGED,21,51,4,3,1,295,True,0,3,3,5554,72,0.3638888888888889,Document
TypeScript,41369,87415,3012.6603125,MERGED,31,67,5,4,5,624,True,0,4,4,4352,98,1.5222222222222221,Document
TypeScript,7046,76150,2701.866365740741,MERGED,4,51,1,4,1,0,False,0,4,3,2683,55,65.99638888888889,Feature
TypeScript,1297,21107,489.02006944444446,MERGED,349,329,15,1,9,1180,True,0,1,1,7354,678,0.6247222222222222,Document
Python,2409,12194,311.0950462962963,MERGED,1,18,2,5,8,1,False,3,2,1,2698,19,28.684722222222224,Document
TypeScript,1297,21107,488.6585300925926,MERGED,74,95,41,1,2,1170,True,0,1,1,6980,169,0.20333333333333334,Document
Go,1835,11246,1799.945497685185,MERGED,18,26,3,0,2,21,False,0,0,0,2601,44,15.674166666666666,Document
V,2097,34362,1623.7841203703704,MERGED,11,70,3,1,6,19,False,1,0,0,4366,81,19.344444444444445,Document
Erlang,2054,12122,3866.359699074074,MERGED,315,281,32,1,4,421,False,1,0,0,2658,596,22.793055555555554,Document
TypeScript,1297,21107,487.80243055555553,MERGED,40,427,15,1,6,1161,True,0,1,1,5808,467,3.138888888888889,Document
Python,2409,12194,311.2696296296296,MERGED,7,10,3,0,6,398,True,0,0,0,2177,17,0.065,Document
TypeScript,1073,11366,1167.0071875,CLOSED,13,14,1,0,6,0,False,0,0,0,2442,27,0.006388888888888889,Document
TypeScript,41369,87415,3010.497962962963,MERGED,62,70,4,2,3,2,False,0,2,2,3717,132,0.7302777777777778,Bug
Python,4517,54993,996.5299768518518,MERGED,2,2,2,0,1,118,True,0,0,0,3228,4,20.42,Document
TypeScript,41369,87415,3009.7025578703706,MERGED,14,90,9,2,3,622,True,0,2,2,5267,104,0.7636111111111111,Document
TypeScript,1073,11366,1165.8694328703702,MERGED,1,1,1,1,1,32,True,0,1,1,2335,2,0.9983333333333333,Bug
TypeScript,4,33,833.2935185185185,MERGED,8,28,3,2,4,268,True,1,1,1,2727,36,17.373333333333335,Feature
TypeScript,1073,11366,1165.7331712962962,MERGED,428,473,3,1,3,304,True,0,1,1,2689,901,0.6358333333333334,Bug
TypeScript,1073,11366,1165.5777430555556,MERGED,1,1,1,1,2,303,True,0,1,1,2503,2,0.15166666666666667,Bug
Go,1835,11246,1801.7900462962962,MERGED,3,5,2,0,3,593,False,0,0,0,2376,8,0.03361111111111111,Document
Go,1835,11246,1801.781909722222,MERGED,4,105,2,0,2,591,False,0,0,0,2163,109,0.008333333333333333,Document
TypeScript,218,1201,3000.1688310185186,CLOSED,1512,2112,28,1,89,12,False,1,0,0,5358,3624,0.15388888888888888,Bug
Go,2083,11770,1591.0489699074076,MERGED,4,309,10,0,3,942,True,0,0,0,6915,313,0.35805555555555557,Document
Go,1835,11246,1800.7425,MERGED,52,0,1,0,1,589,False,0,0,0,2033,52,3.08,Document
Go,1835,11246,1800.6561226851852,MERGED,1005,1,6,2,1,588,False,1,1,1,2409,1006,1.9833333333333334,Document
Go,1835,11246,1799.7815162037039,MERGED,1,9,1,0,1,39,True,0,0,0,2247,10,2.0902777777777777,Document
Python,4517,54993,998.4826041666666,CLOSED,8,4,2,1,1,0,False,0,1,1,3734,12,453.63166666666666,Document
TypeScript,184,377,1982.155150462963,MERGED,2,8,3,0,2,49,False,0,0,0,3970,10,16.398888888888887,Document
TypeScript,3393,2334,1039.4215509259259,MERGED,191,245,10,2,24,502,False,0,2,1,3598,436,445.99111111111114,Feature
TypeScript,7,6,717.2744907407408,MERGED,264,3157,71,0,320,45,True,0,0,0,9238,3421,0.48944444444444446,Feature
Go,789,5551,1115.858275462963,MERGED,6,18,5,2,2,26,False,2,0,0,3544,24,23.70111111111111,Document
TypeScript,184,377,1984.0197222222223,MERGED,3,2,1,0,4,50,False,0,0,0,3534,5,69.93944444444445,Document
C++,2234,23696,2428.6866550925924,MERGED,122,175,21,1,4,24,False,0,1,1,9076,297,29.1175,Bug
TypeScript,41369,87415,3012.6046412037035,MERGED,44625,44602,21,4,8,515,True,1,3,3,8155,89227,0.5427777777777778,Document
Python,2409,12194,315.9026157407407,MERGED,14,14,8,0,1,404,True,0,0,0,4568,28,0.2586111111111111,Document
Python,4517,54993,1000.5930324074075,MERGED,1,20,1,1,3,0,False,0,1,1,3287,21,120.24,Document
TypeScript,12,11,1064.5928472222222,MERGED,141,2423,19,0,8,191,False,0,0,0,15810,2564,423.6475,Bug
TypeScript,4,33,838.171736111111,MERGED,25,42,5,2,10,273,True,1,1,1,4244,67,24.720555555555556,Bug
Python,14533,41196,1162.4403472222223,MERGED,10,10,4,0,1,1432,True,0,0,0,4094,20,0.2569444444444444,Document
TypeScript,4,33,838.2168634259259,CLOSED,395,145,155,1,2,411,False,0,1,1,3813,540,0.4563888888888889,Feature
Starlark,440,286,560.7950694444445,MERGED,4,70,1,1,1,45,False,0,1,1,3995,74,191.57416666666666,Feature
Java,450,746,4143.359884259259,MERGED,938,807,5,1,4,388,True,0,1,1,4052,1745,283.0838888888889,Feature
Python,4517,54993,999.9021643518519,MERGED,15,24,1,0,2,155,False,0,0,0,3511,39,41.280833333333334,Document
Python,137,75,757.8442592592593,MERGED,1,99,13,0,10,34,False,0,0,0,4115,100,8.834444444444445,Document
Python,2409,12194,313.0721064814815,MERGED,25,85,9,0,27,400,True,0,0,0,4695,110,23.352222222222224,Document
Python,4517,54993,999.5437384259259,MERGED,11,7,1,0,2,123,True,0,0,0,4164,18,30.064444444444444,Document
TypeScript,4,33,835.0939120370371,MERGED,24,25,2,2,3,270,True,1,1,1,3619,49,70.84527777777778,Bug
Python,4517,54993,999.3167476851851,MERGED,5,5,1,0,2,121,True,0,0,0,3749,10,1.1897222222222221,Document
Python,2409,12194,312.13444444444445,MERGED,16,19,3,2,7,0,False,1,1,1,3707,35,3.8569444444444443,Document
TypeScript,12,11,1063.3593055555555,MERGED,1213,1731,83,0,6,77,False,0,0,0,19574,2944,241.83555555555554,Feature
TypeScript,41369,87415,3007.9504976851854,MERGED,769,3498,128,3,34,507,True,0,3,3,8455,4267,0.595,Document
TypeScript,4803,40786,3831.387407407407,MERGED,27,34,8,1,2,159,True,0,1,1,4399,61,1.6847222222222222,Bug
TypeScript,1073,11366,1166.7324189814815,MERGED,0,28,2,1,1,306,True,0,1,1,3756,28,0.2761111111111111,Bug
Python,4517,54993,996.835,MERGED,3,14,4,2,4,119,True,1,1,1,4007,17,12.969722222222222,Document
TypeScript,1073,11366,1165.731215277778,MERGED,3,25,7,1,3,31,True,0,1,1,3673,28,0.6763888888888889,Bug
TypeScript,1073,11366,1165.5410879629628,MERGED,6,6,6,1,1,30,True,0,1,1,3601,12,0.3738888888888889,Bug
Go,1835,11246,1800.8817708333333,MERGED,79,249,3,0,1,22,False,0,0,0,3389,328,28.988611111111112,Document
Go,1835,11246,1799.854699074074,MERGED,1452,1501,70,1,1,20,False,0,1,1,3685,2953,19.175555555555555,Document
Go,1835,11246,1799.750196759259,MERGED,6120,7076,23,1,7,50,False,0,1,1,4261,13196,3.24,Document
Go,1835,11246,1798.8790740740742,MERGED,11,34,6,0,2,117,False,0,0,0,4017,45,0.6861111111111111,Document
JavaScript,5140,7051,1279.574375,MERGED,201,181,3,3,2,275,False,0,3,2,21820,382,22.153333333333332,Feature
Python,137,75,756.9604282407407,MERGED,151,108,20,0,21,106,False,0,0,0,6039,259,3.755,Document
Python,137,75,756.1836111111111,MERGED,178,116,21,2,12,105,False,1,1,1,7453,294,163.7425,Document
Starlark,440,286,561.6918518518519,MERGED,140,197,2,1,6,9,False,0,1,1,5815,337,436.7661111111111,Bug
TypeScript,4803,40786,3831.6109722222222,MERGED,98,104,33,1,1,160,True,0,1,1,7503,202,19.490833333333335,Feature
TypeScript,3393,2334,1043.2658449074074,MERGED,30,35,14,1,2,756,False,0,1,1,5458,65,71.69277777777778,Feature
Python,4517,54993,999.1497569444444,MERGED,36,104,8,2,6,153,False,1,1,1,6611,140,158.69611111111112,Document
Python,137,75,758.1364120370371,MERGED,0,489,15,0,9,37,False,0,0,0,6060,489,68.77055555555556,Document
Go,1835,11246,1800.8893171296295,MERGED,19,41,6,1,2,40,True,0,1,1,4499,60,2.5613888888888887,Document
TypeScript,184,377,1984.9494907407407,MERGED,20,536,17,0,36,51,False,0,0,0,7912,556,748.31,Document
Go,1835,11246,1801.6916666666666,CLOSED,19,41,6,0,1,41,True,0,0,0,4599,60,0.12277777777777778,Document
TypeScript,3393,2334,1038.3205439814815,MERGED,1457,497,31,3,4,0,False,0,3,2,10563,1954,980.5030555555555,Bug
TypeScript,7,6,716.1170138888889,MERGED,1907,1988,71,2,61,237,False,0,2,2,16008,3895,547.0247222222222,Document
Python,2409,12194,310.7099074074074,CLOSED,18,507,7,0,7,0,False,0,0,0,5363,525,0.0661111111111111,Document
TypeScript,4,33,833.1223495370369,MERGED,628,1259,72,1,19,402,True,0,1,1,6916,1887,34.870555555555555,Document
Go,1835,11246,1800.133298611111,MERGED,603,66,7,0,2,4,False,0,0,0,6272,669,18.708055555555557,Bug
TypeScript,0,0,229.01549768518518,MERGED,2040,2064,14,0,2,12,False,0,0,0,7601,4104,0.09833333333333333,Document
TypeScript,4,33,837.7651851851851,MERGED,503,367,87,1,36,407,True,0,1,1,8224,870,14.46861111111111,Document
Go,2083,11770,1593.9265625,MERGED,330,470,109,0,1,945,True,0,0,0,17203,800,0.31305555555555553,Document
Python,4517,54993,999.4953587962963,MERGED,28,34,5,0,6,122,True,0,0,0,7386,62,31.89388888888889,Document
TypeScript,4,33,835.4384837962963,MERGED,648,708,171,1,4,662,True,0,1,1,9974,1356,1.6477777777777778,Document
Python,4517,54994,998.3249537037037,MERGED,2,8,2,0,1,120,True,0,0,0,7248,10,14.366111111111111,Document
TypeScript,1073,11366,1166.936863425926,MERGED,62,244,7,1,9,307,True,0,1,1,8066,306,17.836666666666666,Bug
Go,1835,11246,1798.8963310185184,MERGED,1711,13028,73,2,2,19,False,0,2,2,7664,14739,21.737222222222222,Document
Go,1835,11246,1798.9010185185186,MERGED,57,65,15,0,4,49,False,0,0,0,9409,122,0.23972222222222223,Document
TypeScript,3393,2334,1038.9617476851852,MERGED,184,1804,32,2,58,501,False,0,2,1,11367,1988,272.12,Feature
TypeScript,4,33,834.7241782407408,MERGED,788,628,26,1,13,245,False,0,1,1,11085,1416,23.247777777777777,Bug
TypeScript,4803,40786,3830.648136574074,MERGED,121,394,27,1,3,158,True,0,1,1,12922,515,17.31222222222222,Document
TypeScript,12,11,1067.1980902777777,MERGED,1,1,1,0,2,393,False,0,0,0,724,2,840.2461111111111,Feature
TypeScript,2147,14725,1549.804236111111,MERGED,5,19,1,0,1,216,False,0,0,0,693,24,2.0122222222222224,Bug
TypeScript,2147,14725,1548.8956018518518,MERGED,1,1,1,0,1,215,False,0,0,0,685,2,0.7861111111111111,Bug
PHP,1334,2960,4284.101793981482,MERGED,3,7,2,2,6,175,False,0,2,2,717,10,356.6797222222222,Bug
TypeScript,85,724,394.9953125,MERGED,24,261,7,0,18,16,False,0,0,0,1690,285,400.7030555555556,Document
TypeScript,2147,14725,1551.1472222222221,MERGED,3,20,3,0,1,788,False,0,0,0,595,23,17.645555555555557,Feature
TypeScript,2147,14725,1550.8369444444445,MERGED,0,1,1,0,1,17,False,0,0,0,598,1,4.268055555555556,Document
TypeScript,2147,14725,1550.814560185185,MERGED,1,1,1,0,1,119,False,0,0,0,720,2,2.810277777777778,Bug
TypeScript,2147,14725,1550.1971412037037,MERGED,1,1,1,0,1,786,False,0,0,0,670,2,12.451944444444445,Bug
TypeScript,85,724,395.1884722222222,MERGED,0,3,1,0,2,113,False,0,0,0,1141,3,0.2788888888888889,Document
TypeScript,85,724,395.1538773148148,MERGED,1,2,1,0,2,112,False,0,0,0,1080,3,0.029166666666666667,Document
TypeScript,85,724,395.3215277777778,MERGED,1,4,1,0,1,17,False,0,0,0,1156,5,0.8697222222222222,Document
TypeScript,85,724,395.1471990740741,MERGED,1,1,1,0,1,60,False,0,0,0,1056,2,2.285833333333333,Document
TypeScript,85,724,395.1473379629629,MERGED,1,1,1,0,1,111,False,0,0,0,1182,2,0.012777777777777779,Document
TypeScript,2147,14725,1548.9784259259259,MERGED,2,2,2,0,1,782,False,0,0,0,624,4,4.1425,Bug
TypeScript,2147,14725,1551.0625462962962,CLOSED,0,0,0,0,0,120,False,0,0,0,1024,0,21.101388888888888,Feature
JavaScript,5140,7051,1282.8916666666667,MERGED,38,148,10,3,12,68,False,2,1,1,597,186,113.67361111111111,Document
Go,421,1654,1590.0431597222223,MERGED,1,4,2,0,1,505,True,0,0,0,1101,5,45.83416666666667,Bug
TypeScript,58,78,900.0794444444444,MERGED,12,23,5,1,4,120,False,0,1,1,1604,35,120.72611111111111,Feature
TypeScript,7,6,721.9386689814814,MERGED,28,0,2,0,1,238,False,0,0,0,652,28,151.54333333333332,Feature
PHP,1334,2960,4285.101597222222,CLOSED,999173,90835,9411,8,1180,0,False,2,6,4,1676,1090008,385.7636111111111,Document
TypeScript,12,11,1066.5280092592593,MERGED,20,84,3,0,3,46,False,0,0,0,2016,104,157.4425,Feature
TypeScript,85,724,395.4202662037037,MERGED,1,6,1,0,3,18,False,0,0,0,1391,7,68.53333333333333,Document
TypeScript,7,6,723.9977662037037,MERGED,3,37,6,0,5,50,True,0,0,0,796,40,2.606388888888889,Feature
TypeScript,7,6,723.887824074074,MERGED,0,1,1,0,2,9,False,0,0,0,792,1,2.1008333333333336,Feature
TypeScript,15,34,568.8698263888889,CLOSED,1,4,2,0,3,78,False,0,0,0,364,5,193.69833333333332,Feature
JavaScript,5140,7051,1281.8655324074073,CLOSED,0,77,1,2,1,0,False,0,2,2,763,77,18.740833333333335,Feature
Go,421,1654,1588.3478935185185,MERGED,5,13,3,1,4,78,False,1,0,0,861,18,17.185,Bug
TypeScript,7,6,721.1234027777778,CLOSED,1,1,1,0,1,297,False,0,0,0,732,2,146.02027777777778,Bug
TypeScript,261,3765,755.7242013888889,MERGED,1,7,3,0,1,296,True,0,0,0,1586,8,1.4219444444444445,Document
TypeScript,2147,14725,1549.8296874999999,MERGED,0,181,7,0,14,690,False,0,0,0,1612,181,142.60694444444445,Document
TypeScript,85,724,394.9471875,MERGED,0,20,1,0,1,109,False,0,0,0,1589,20,0.28194444444444444,Document
TypeScript,2147,14725,1551.9438310185185,MERGED,16,4,2,0,1,121,False,0,0,0,1548,20,1.2452777777777777,Feature
TypeScript,85,724,394.29891203703704,MERGED,241,218,2,1,3,14,False,1,0,0,1678,459,23.65138888888889,Document
JavaScript,5140,7051,1283.4822569444443,MERGED,0,29,2,1,2,114,False,0,1,1,771,29,0.07611111111111112,Feature
PHP,1334,2960,4284.965428240741,MERGED,3,23,3,1,2,888,False,0,1,1,1064,26,6.769166666666667,Bug
Go,421,1654,1586.0498611111109,MERGED,1,1,1,0,1,501,True,0,0,0,795,2,1.3397222222222223,Bug
TypeScript,261,3765,753.9930092592593,MERGED,34,76,42,0,1,654,True,0,0,0,1546,110,0.23666666666666666,Document
TypeScript,261,3765,753.9294328703704,MERGED,9,0,1,0,1,294,True,0,0,0,1247,9,0.4583333333333333,Document
TypeScript,261,3765,753.846099537037,MERGED,51,58,3,0,1,213,False,0,0,0,1518,109,1.2261111111111112,Document
TypeScript,261,3765,753.8256944444444,MERGED,1,7,2,0,1,137,False,0,0,0,1459,8,0.4230555555555556,Document
TypeScript,202,107,1223.9583912037037,MERGED,2,2,1,3,2,293,True,0,3,3,710,4,1.5830555555555557,Bug
Go,1835,11246,1806.6066435185185,MERGED,150,49,6,0,1,126,False,0,0,0,250,199,1.4191666666666667,Feature
TypeScript,261,3765,753.6370949074075,MERGED,2,16,4,0,1,136,False,0,0,0,1495,18,0.3011111111111111,Document
TypeScript,178,1359,398.7846759259259,MERGED,3,5,2,1,1,52,True,0,1,1,1404,8,0.25083333333333335,Bug
TypeScript,261,3765,753.5219560185186,MERGED,0,3,1,0,1,211,False,0,0,0,1121,3,0.18833333333333332,Document
TypeScript,85,724,393.2622685185185,MERGED,29,13,2,0,2,25,False,0,0,0,1518,42,17.31833333333333,Document
Go,421,1654,1586.0450578703703,MERGED,3,1,1,0,1,500,True,0,0,0,1040,4,1.4452777777777779,Bug
TypeScript,41369,87415,3017.8893634259257,CLOSED,33,48,2,5,7,1,False,1,4,4,1652,81,592.7825,Document
TypeScript,2147,14725,1550.1548958333333,MERGED,98,107,7,0,1,217,False,0,0,0,1537,205,16.095833333333335,Feature
TypeScript,7,6,722.0043634259259,MERGED,557,1135,53,0,1,48,True,0,0,0,1034,1692,149.42333333333335,Feature
TypeScript,2147,14725,1549.2083101851852,MERGED,20,64,4,1,4,95,False,1,0,0,1741,84,67.31,Document
JavaScript,5140,7051,1281.786261574074,MERGED,1,67,3,1,2,341,False,0,1,1,1153,68,19.080277777777777,Feature
TypeScript,261,3765,752.7769212962962,MERGED,2,2,2,0,1,135,False,0,0,0,1314,4,2.362222222222222,Document
TypeScript,261,3765,752.6083101851851,CLOSED,140,104,3,0,1,209,False,0,0,0,1515,244,1.0822222222222222,Document
TypeScript,7,6,723.9797685185185,MERGED,15,41,4,1,4,252,False,1,0,0,978,56,1.4813888888888889,Feature
PHP,1334,2960,4284.041770833333,MERGED,4,17,1,1,5,174,False,0,1,1,1223,21,215.87555555555556,Bug
C++,2234,23696,2436.899849537037,MERGED,12,13,1,1,1,562,False,0,1,1,935,25,2.225,Feature
TypeScript,2147,14725,1549.014664351852,MERGED,48,73,7,0,1,783,False,0,0,0,1686,121,3.268611111111111,Feature
Go,421,1654,1589.0920601851851,MERGED,4,4,1,0,1,504,True,0,0,0,1423,8,7.826388888888889,Bug
TypeScript,2147,14725,1548.896076388889,MERGED,120,162,3,0,4,93,False,0,0,0,1416,282,1.0666666666666667,Bug
TypeScript,261,3765,754.685162037037,MERGED,2,14,2,0,2,152,True,0,0,0,1432,16,0.18222222222222223,Document
TypeScript,261,3765,755.6565625,MERGED,2,24,3,0,2,1051,True,0,0,0,1957,26,0.3352777777777778,Document
TypeScript,85,724,395.0801041666667,MERGED,5,11,3,0,2,110,False,0,0,0,2348,16,0.42055555555555557,Document
TypeScript,261,3765,755.5018518518518,MERGED,4,18,5,0,1,1050,True,0,0,0,2305,22,0.5544444444444444,Document
F#,153,337,2998.8178125,MERGED,9,7,1,0,1,39,False,0,0,0,1806,16,0.575,Document
TypeScript,202,107,1222.7006481481483,CLOSED,8,4,2,3,2,309,True,0,3,3,1183,12,148.95777777777778,Document
Go,11875,71345,2772.9151041666664,MERGED,25,22,11,0,1,308,True,0,0,0,394,47,0.14527777777777778,Bug
TypeScript,58,78,898.2837384259259,MERGED,0,5,1,1,1,119,False,0,1,1,1764,5,18.92388888888889,Bug
Python,547,7161,2315.6256597222223,MERGED,124,122,5,0,2,249,False,0,0,0,876,246,143.49805555555557,Bug
Vue,10810,21164,1101.998773148148,MERGED,0,1,1,1,1,1,False,0,1,1,1513,1,75.13555555555556,Document
Java,450,746,4152.335810185185,MERGED,3,3,3,1,2,17,False,0,1,1,227,6,235.19666666666666,Feature
JavaScript,5140,7051,1281.6942592592593,MERGED,480,2093,59,2,14,339,False,1,1,1,1315,2573,142.16166666666666,Feature
Go,395,660,1343.896701388889,MERGED,0,1,1,0,1,85,False,0,0,0,191,1,288.75666666666666,Feature
Python,547,7161,2316.695393518519,MERGED,15,41,4,0,10,38,False,0,0,0,1469,56,427.15055555555557,Bug
TypeScript,261,3765,753.9820486111112,MERGED,56,73,8,0,6,1048,True,0,0,0,2394,129,15.463611111111112,Document
TypeScript,7,6,721.239837962963,CLOSED,382,672,30,0,83,257,False,0,0,0,970,1054,0.08138888888888889,Feature
Vue,293,495,907.7441782407408,MERGED,21,66,8,3,1,182,True,0,3,3,773,87,56.0525,Bug
Go,1174,11429,1920.1783449074073,CLOSED,411,521,11,2,1,466,True,1,1,1,1793,932,11.375,Document
TypeScript,261,3765,754.0063310185186,MERGED,5,4,4,0,1,295,True,0,0,0,1737,9,0.3425,Document
Go,421,1654,1590.2633680555555,MERGED,4,33,1,0,2,79,False,0,0,0,2164,37,44.5975,Bug
Go,1174,11429,1919.954247685185,CLOSED,63,476,15,1,2,465,True,1,0,0,1993,539,16.7575,Document
V,2097,34362,1630.9646527777777,MERGED,21,10,1,0,1,57,True,0,0,0,852,31,6.2427777777777775,Feature
TypeScript,261,3765,753.8649074074074,MERGED,125,42,8,0,1,293,True,0,0,0,2082,167,0.5616666666666666,Document
Go,30,295,425.05313657407413,MERGED,3,40,4,0,1,46,True,0,0,0,1808,43,0.13694444444444445,Feature
JavaScript,5140,7051,1282.8130208333334,MERGED,3,3,2,3,3,67,False,1,2,2,1654,6,24.938055555555554,Feature
V,2097,34362,1631.200752314815,MERGED,7,10,1,0,2,25,True,0,0,0,777,17,1.8527777777777779,Bug
Vue,10810,21164,1101.8349189814815,MERGED,1,0,1,0,1,108,True,0,0,0,1228,1,10.532777777777778,Bug
TypeScript,7,6,724.0557638888889,MERGED,1,3,2,1,1,306,False,0,1,1,238,4,0.10888888888888888,Feature
Go,421,1654,1586.1083449074074,MERGED,45,87,2,0,1,503,True,0,0,0,1800,132,24.141944444444444,Bug
TypeScript,261,3765,752.8750578703704,MERGED,32,39,3,0,2,265,False,0,0,0,1826,71,20.24277777777778,Document
TypeScript,261,3765,752.9987037037037,MERGED,0,36,6,0,2,1046,True,0,0,0,2109,36,12.845,Document
TypeScript,202,107,1222.5395717592594,MERGED,2,2,2,4,2,289,True,0,4,4,915,4,27.434166666666666,Bug
PHP,1334,2960,4284.140023148148,MERGED,17,0,1,1,2,176,False,0,1,1,1500,17,2.026666666666667,Document
PHP,1334,2960,4284.046319444445,CLOSED,2,12,1,2,2,95,False,0,2,2,1430,14,23.80388888888889,Document
TypeScript,261,3765,752.4774768518519,MERGED,28,24,3,0,4,264,False,0,0,0,1986,52,29.778055555555557,Document
Go,752,2399,805.7596296296297,MERGED,2,14,2,0,5,165,False,0,0,0,949,16,18.105555555555554,Bug
TypeScript,202,107,1222.6817361111111,MERGED,2,9,1,3,2,290,True,0,3,3,934,11,1.5469444444444445,Bug
Go,421,1654,1586.0559606481481,MERGED,7,7,6,0,1,502,True,0,0,0,1807,14,1.1783333333333332,Document
Go,752,2399,805.9017361111111,MERGED,8,9,1,0,1,166,False,0,0,0,776,17,0.2941666666666667,Bug
Go,752,2399,805.7507060185185,MERGED,12,14,1,0,1,164,False,0,0,0,781,26,3.3505555555555557,Bug
TypeScript,2147,14725,1549.0478935185185,MERGED,10,27,2,0,1,784,False,0,0,0,2077,37,2.4544444444444444,Bug
TypeScript,2147,14725,1549.0448842592593,MERGED,7,225,4,0,4,61,False,0,0,0,2229,232,2.511111111111111,Document
TypeScript,178,1359,401.86472222222227,MERGED,7,170,4,2,2,53,True,0,2,2,3270,177,71.07916666666667,Feature
TypeScript,2147,14725,1548.9502777777777,MERGED,93,95,5,0,3,94,False,0,0,0,2236,188,2.1019444444444444,Bug
V,2097,34362,1630.5341782407406,MERGED,13,13,7,0,1,56,True,0,0,0,2174,26,7.724722222222222,Document
TypeScript,202,107,1221.687476851852,MERGED,3,5,1,3,2,306,True,0,3,3,946,8,18.458055555555557,Document
TypeScript,202,107,1221.5698958333335,MERGED,2,8,2,3,2,303,True,0,3,3,1162,10,21.30666666666667,Document
JavaScript,5140,7051,1280.821539351852,MERGED,4,12,2,1,1,278,False,0,1,1,1353,16,40.094722222222224,Bug
JavaScript,9664,43890,3736.3872453703702,CLOSED,2,2,1,1,1,2,False,0,1,1,364,4,302.4088888888889,Bug
Python,547,7161,2314.5232060185185,MERGED,56,68,16,0,9,248,False,0,0,0,787,124,22.126944444444444,Bug
TypeScript,7,6,722.8810416666666,CLOSED,0,12,2,0,5,249,False,0,0,0,1414,12,128.87722222222223,Feature
TypeScript,7,6,724.8819097222222,MERGED,8,8,4,0,1,240,False,0,0,0,1878,16,0.015277777777777777,Document
Python,547,7161,2314.4040046296295,MERGED,3,10,4,0,3,628,True,0,0,0,736,13,0.7805555555555556,Document
Python,547,7161,2314.3736921296295,CLOSED,1203,148,18,0,4,627,True,0,0,0,897,1351,1.618611111111111,Bug
TypeScript,7,6,722.0339930555556,MERGED,3,3,1,0,1,305,False,0,0,0,203,6,0.1938888888888889,Feature
Vue,10810,21164,1099.8693055555557,CLOSED,4,20,1,1,1,2,False,0,1,1,1874,24,340.09194444444444,Bug
Python,547,7161,2313.834548611111,MERGED,111,68,7,0,4,317,True,0,0,0,920,179,4.081111111111111,Document
TypeScript,202,107,1220.5167708333333,CLOSED,1,1,1,3,1,17,True,1,2,2,919,2,7.205277777777778,Document
Vue,10810,21164,1101.0080671296296,MERGED,2,2,1,1,2,0,False,0,1,1,1680,4,259.18416666666667,Document
TypeScript,7,6,724.214363425926,MERGED,27,12,2,0,1,254,False,0,0,0,2075,39,0.8511111111111112,Feature
PHP,1334,2960,4285.138067129629,MERGED,2,5,2,2,3,177,False,0,2,2,1780,7,23.738055555555555,Document
TypeScript,7,6,723.8789583333333,MERGED,34,3,4,0,5,299,False,0,0,0,1298,37,0.7347222222222223,Feature
TypeScript,15,34,568.9469675925926,MERGED,2,3,1,0,1,1079,False,0,0,0,178,5,1.2947222222222223,Feature
Go,30,295,425.92940972222226,MERGED,5,5,3,1,2,47,True,0,1,1,1269,10,0.057777777777777775,Bug
TypeScript,7,6,721.0220601851852,MERGED,3,11,4,0,1,296,False,0,0,0,1869,14,148.5075,Document
PHP,1334,2960,4285.064780092593,CLOSED,1,1,1,2,1,74,False,1,1,1,1678,2,0.035833333333333335,Document
TypeScript,2070,16643,1322.2701157407407,CLOSED,5,15,1,2,1,1,False,0,2,1,2447,20,675.0197222222222,Bug
PHP,883,2338,1910.789733796296,CLOSED,1,11,2,3,2,16,False,0,3,2,2331,12,821.0702777777777,Document
Go,395,660,1343.8711458333335,MERGED,9,53,2,0,1,143,False,0,0,0,307,62,291.4472222222222,Bug
TypeScript,58,78,898.2811574074075,MERGED,1,13,3,1,1,118,False,0,1,1,2357,14,24.62472222222222,Feature
TypeScript,202,107,1223.5150115740742,MERGED,6,6,1,3,1,291,True,0,3,3,1605,12,125.11361111111111,Bug
Python,19251,70267,2538.881724537037,CLOSED,22,169,5,1,6,161,False,1,0,0,318,191,136.61305555555555,Feature
Go,1174,11429,1920.7777546296295,MERGED,8,8,8,0,1,678,True,0,0,0,1337,16,1.7605555555555557,Feature
TypeScript,1297,21107,496.7220486111111,MERGED,1,1,1,3,1,47,False,1,2,2,1323,2,2.7577777777777777,Document
JavaScript,5140,7051,1281.7470949074075,MERGED,9,36,5,2,5,340,False,1,1,1,2139,45,50.69027777777778,Bug
Python,19251,70267,2538.6971180555556,CLOSED,59,70,6,2,5,160,False,2,0,0,284,129,122.04694444444445,Feature
Go,1174,11429,1919.9979166666665,MERGED,1062,780,106,0,1,677,True,0,0,0,1304,1842,16.44333333333333,Feature
TypeScript,2147,14725,1551.0124768518517,MERGED,2,114,6,0,1,787,False,0,0,0,2568,116,16.746944444444445,Feature
TypeScript,261,3765,754.7891666666666,MERGED,0,13,4,0,2,1049,True,0,0,0,2583,13,0.9488888888888889,Document
JavaScript,5140,7051,1283.6724768518518,MERGED,150,199,9,1,7,343,False,0,1,1,2743,349,239.02583333333334,Bug
TypeScript,261,3765,754.5095023148148,MERGED,0,35,5,0,1,214,False,0,0,0,2391,35,2.868888888888889,Document
Vue,293,495,909.8780902777777,MERGED,1,1,1,3,3,321,True,0,3,2,1455,2,0.08611111111111111,Bug
Vue,293,495,907.0444212962963,MERGED,80,95,7,12,9,420,False,3,9,6,1098,175,165.89666666666668,Bug
Python,547,7161,2315.000787037037,MERGED,19,211,14,0,8,12,False,0,0,0,1265,230,157.59472222222223,Feature
V,2097,34362,1631.7678587962964,MERGED,0,19,7,2,3,59,True,1,1,1,1314,19,23.625,Document
V,2097,34362,1631.8130439814815,MERGED,1,1,1,0,1,60,True,0,0,0,1130,2,13.889722222222222,Document
TypeScript,15,34,568.3925810185185,MERGED,1,1,1,0,1,200,False,0,0,0,207,2,0.8947222222222222,Feature
TypeScript,202,107,1224.0244907407407,MERGED,1,7,2,3,2,294,True,0,3,3,1285,8,0.355,Bug
Go,752,2399,805.5110416666666,MERGED,20,6,3,0,1,163,False,0,0,0,1863,26,0.015555555555555555,Bug
TypeScript,15,34,567.4931712962963,MERGED,13,138,10,0,7,1076,False,0,0,0,200,151,46.340833333333336,Bug
Vue,10810,21164,1100.2626851851853,CLOSED,2,3,1,11,2,3,False,7,4,2,1264,5,133.30277777777778,Bug
Vue,10810,21164,1101.2752893518518,MERGED,1,68,5,0,1,197,False,0,0,0,2203,69,59.28388888888889,Document
TypeScript,2147,14725,1551.0343518518519,MERGED,2039,2478,4,0,1,322,False,0,0,0,4790,4517,425.615,Document
TypeScript,202,107,1223.108113425926,MERGED,5,6,1,3,1,121,True,0,3,3,1504,11,13.748611111111112,Document
Go,395,660,1342.1231134259258,MERGED,1,5,1,0,2,142,False,0,0,0,236,6,66.91694444444444,Feature
TypeScript,15,34,567.269386574074,MERGED,12,36,3,0,3,157,False,0,0,0,277,48,4.139166666666667,Feature
Go,752,2399,806.4366898148147,MERGED,9,6,3,0,1,75,False,0,0,0,1748,15,1.9177777777777778,Bug
TypeScript,15,34,567.4881828703703,MERGED,1,1,1,0,2,158,False,0,0,0,237,2,174.14583333333334,Bug
TypeScript,202,107,1222.8018634259258,MERGED,3,12,1,3,2,16,True,0,3,3,1427,15,21.12611111111111,Document
TypeScript,261,3765,752.8172222222223,MERGED,1,63,5,0,2,210,False,0,0,0,2294,64,1.2047222222222222,Document
TypeScript,261,3765,752.7388425925925,MERGED,5,77,2,0,1,233,True,0,0,0,2348,82,0.07361111111111111,Document
JavaScript,5140,7051,1280.1459837962964,MERGED,4,28,3,1,1,137,False,0,1,1,1807,32,0.17694444444444443,Feature
Go,752,2399,805.9163310185186,MERGED,8,36,1,0,1,167,False,0,0,0,1818,44,17.2025,Bug
Vue,10810,21164,1100.1499999999999,MERGED,0,32,1,2,1,0,False,0,2,2,1466,32,75.8575,Bug
TypeScript,261,3765,752.4576736111111,MERGED,2,10,2,0,1,1043,True,0,0,0,2379,12,1.5622222222222222,Document
TypeScript,202,107,1222.5209837962964,MERGED,28,54,5,3,3,308,True,0,3,3,1442,82,5.172777777777778,Document
TypeScript,7,6,723.1673842592592,MERGED,28,50,3,0,8,298,False,0,0,0,2264,78,94.35972222222222,Feature
Go,752,2399,805.6913194444445,MERGED,3,1,3,0,1,460,False,0,0,0,1158,4,0.34,Bug
TypeScript,202,107,1221.577974537037,MERGED,3,3,2,3,7,288,True,0,3,3,1354,6,50.522222222222226,Bug
Go,752,2399,805.4820601851852,MERGED,20,6,3,0,3,162,False,0,0,0,1814,26,0.6247222222222222,Bug
Go,395,660,1342.1105092592593,MERGED,16,18,1,0,1,141,False,0,0,0,251,34,140.09416666666667,Bug
TypeScript,15,34,569.3071643518518,MERGED,32,41,5,0,2,202,False,0,0,0,372,73,1.5016666666666667,Feature
TypeScript,7,6,724.2273842592593,CLOSED,27,12,2,0,1,255,False,0,0,0,2466,39,0.08666666666666667,Feature
Go,1174,11429,1920.9307754629629,MERGED,2,18,1,2,1,204,True,1,1,1,1620,20,69.53694444444444,Bug
TypeScript,202,107,1221.5866435185185,MERGED,3,2,1,3,1,305,True,0,3,3,1566,5,20.885277777777777,Document
TypeScript,202,107,1221.576712962963,MERGED,12,10,2,3,2,304,True,0,3,3,1490,22,21.13388888888889,Document
TypeScript,1297,21107,492.6108217592593,MERGED,26,96,13,1,4,1206,True,0,1,1,1654,122,0.6533333333333333,Document
Go,752,2399,804.8788310185186,MERGED,8,4,3,0,2,457,False,0,0,0,1233,12,0.10388888888888889,Document
JavaScript,5140,7051,1282.8283449074074,MERGED,86,491,10,2,5,342,False,1,1,1,3314,577,90.67583333333333,Feature
Go,395,660,1342.0667824074073,MERGED,9,14,2,0,1,84,False,0,0,0,293,23,139.25472222222223,Bug
JavaScript,9664,43890,3734.7872800925925,MERGED,1,1,1,0,1,75,True,0,0,0,295,2,0.5591666666666667,Bug
TypeScript,7,6,723.148113425926,MERGED,0,15,7,1,5,250,False,0,1,1,2116,15,24.005555555555556,Bug
TypeScript,41369,87415,3016.6950462962964,CLOSED,1,1,1,3,1,6,False,1,2,2,2121,2,240.65583333333333,Document
Python,547,7161,2314.351608796296,MERGED,1199,137,13,0,1,626,True,0,0,0,1172,1336,0.35138888888888886,Bug
JavaScript,9664,43890,3736.8532060185184,MERGED,11,17,1,0,1,335,True,0,0,0,438,28,0.5672222222222222,Feature
Go,1174,11429,1920.968252314815,MERGED,0,1,1,1,1,145,True,1,0,0,1831,1,0.08861111111111111,Document
Go,1174,11429,1920.8193055555555,MERGED,25,35,6,1,2,501,True,1,0,0,1800,60,2.6466666666666665,Document
JavaScript,9664,43890,3734.0836805555555,MERGED,68,158,12,0,1,327,True,0,0,0,409,226,1.0477777777777777,Feature
Vue,10810,21164,1098.8643287037037,CLOSED,1,5,1,1,1,0,False,0,1,1,1243,6,23.289166666666667,Bug
Go,1174,11429,1920.7192824074073,MERGED,5,5,2,1,1,143,True,1,0,0,1927,10,0.7472222222222222,Document
Go,11875,71345,2772.652627314815,MERGED,12,30,3,0,1,307,True,0,0,0,406,42,0.13166666666666665,Document
TypeScript,85,724,394.4736111111111,MERGED,0,597,4,0,16,15,False,0,0,0,4160,597,188.83777777777777,Document
TypeScript,15,34,567.6762152777777,MERGED,1,16,1,0,6,77,False,0,0,0,307,17,1.7969444444444445,Bug
TypeScript,41369,87415,3014.7224768518518,MERGED,36,18,1,2,11,42,False,0,2,2,2051,54,309.87583333333333,Document
JavaScript,9664,43890,3736.384861111111,MERGED,5,9,1,0,1,334,True,0,0,0,461,14,0.1725,Feature
TypeScript,15,34,567.5146180555556,MERGED,27,19,3,0,1,159,False,0,0,0,339,46,0.3491666666666667,Bug
TypeScript,15,34,567.4855208333333,MERGED,1,3,1,0,1,199,False,0,0,0,290,4,1.0438888888888889,Bug
TypeScript,15,34,567.2661689814814,MERGED,1,3,1,0,1,156,False,0,0,0,338,4,5.834722222222222,Feature
Go,1174,11429,1918.7375694444445,CLOSED,4,1,1,0,1,1046,True,0,0,0,2097,5,477.5275,Document
TypeScript,307,2556,614.8442013888889,CLOSED,11,4,4,0,4,29,False,0,0,0,1208,15,0.3375,Bug
TypeScript,15,34,569.2967824074075,MERGED,107,254,13,0,5,161,False,0,0,0,521,361,23.496388888888887,Feature
TypeScript,15,34,566.6383449074074,MERGED,0,118,1,0,2,1075,False,0,0,0,328,118,27.01861111111111,Feature
TypeScript,7,6,722.0122916666666,CLOSED,68,947,3,0,2,247,False,0,0,0,2118,1015,1.9027777777777777,Feature
TypeScript,261,3765,752.8939467592592,MERGED,55,99,5,0,1,1045,True,0,0,0,2488,154,13.986666666666666,Document
TypeScript,15,34,566.4308680555556,MERGED,0,9,1,0,1,196,False,0,0,0,311,9,6.094166666666666,Feature
V,2097,34362,1631.3638541666667,MERGED,232,248,4,2,5,58,True,1,1,1,2036,480,24.766666666666666,Document
TypeScript,15,34,566.2609259259259,MERGED,25,86,5,0,1,154,False,0,0,0,455,111,8.716944444444444,Feature
Go,1174,11429,1918.8988194444444,MERGED,28,29,4,1,1,463,True,1,0,0,1713,57,0.7544444444444445,Document
TypeScript,15,34,566.2613888888889,MERGED,3,6,1,0,2,526,True,0,0,0,263,9,0.9227777777777778,Bug
Go,1174,11429,1918.6989351851853,MERGED,6,21,1,1,2,498,True,1,0,0,1649,27,0.45555555555555555,Document
TypeScript,85,724,395.20423611111113,MERGED,51,159,6,0,6,26,False,0,0,0,4658,210,67.60722222222222,Document
TypeScript,1297,21107,494.8651273148148,MERGED,1,45,3,1,1,1219,True,0,1,1,2015,46,0.010555555555555556,Document
Python,137,75,765.0281249999999,MERGED,4,17,3,0,10,0,False,0,0,0,1025,21,283.1061111111111,Bug
JavaScript,5140,7051,1280.5756365740742,MERGED,16,168,7,2,1,277,False,1,1,1,3054,184,46.00277777777778,Bug
TypeScript,2147,14725,1552.0910300925925,MERGED,96,175,5,1,2,122,False,0,1,1,3442,271,64.16111111111111,Document
TypeScript,15,34,568.2469560185185,MERGED,4,9,2,0,2,160,False,0,0,0,415,13,8.84361111111111,Bug
TypeScript,15,34,567.4805902777778,MERGED,10,34,4,0,20,76,False,0,0,0,359,44,49.45194444444444,Feature
JavaScript,9664,43890,3734.14212962963,MERGED,12,202,4,0,2,649,False,0,0,0,486,214,0.37472222222222223,Feature
JavaScript,9664,43890,3734.142546296296,MERGED,32,26,4,0,1,330,True,0,0,0,433,58,0.24027777777777778,Feature
Go,1174,11429,1918.0171527777777,MERGED,7,1,1,1,1,462,True,0,1,1,1678,8,16.11861111111111,Document
JavaScript,9664,43890,3734.081053240741,MERGED,577,473,3,0,5,647,False,0,0,0,424,1050,0.22333333333333333,Feature
TypeScript,15,34,567.4835069444445,MERGED,148,243,12,0,8,528,True,0,0,0,483,391,44.030277777777776,Bug
JavaScript,9664,43890,3734.0215277777775,MERGED,110,9,2,0,2,326,True,0,0,0,459,119,0.17583333333333334,Feature
Java,450,746,4151.330821759259,MERGED,71,249,14,1,9,42,False,0,1,1,629,320,110.93277777777777,Feature
TypeScript,41369,87415,3016.6667476851853,MERGED,0,24,1,1,4,0,False,0,1,1,2167,24,69.74916666666667,Document
TypeScript,261,3765,755.7969907407409,MERGED,16,133,2,0,3,1052,True,0,0,0,4158,149,65.44027777777778,Document
PHP,883,2338,1911.8226504629629,CLOSED,3,41,3,2,1,5,False,0,2,2,2631,44,308.6791666666667,Document
TypeScript,41369,87415,3017.1486342592593,CLOSED,1,0,1,1,1,208,False,0,1,1,2052,1,0.46111111111111114,Document
TypeScript,261,3765,753.7770601851852,MERGED,54,161,4,0,4,234,True,0,0,0,3494,215,143.71916666666667,Document
JavaScript,9664,43890,3734.069236111111,MERGED,46,608,20,0,11,334,True,0,0,0,573,654,162.36833333333334,Feature
TypeScript,41369,87415,3015.4572800925926,CLOSED,0,9,1,2,2,633,True,0,2,2,2094,9,0.11138888888888888,Document
TypeScript,202,107,1221.841574074074,MERGED,3,8,2,3,1,307,True,0,3,3,2010,11,14.738888888888889,Document
TypeScript,307,2556,614.7630671296296,MERGED,19,22,1,0,1,28,False,0,0,0,1638,41,136.75166666666667,Bug
TypeScript,85,724,391.95934027777776,MERGED,63,5112,51,1,49,58,False,1,0,0,4397,5175,146.59416666666667,Document
TypeScript,307,2556,614.5081481481482,CLOSED,5,3,4,2,4,20,False,0,2,2,311,8,2.3158333333333334,Bug
TypeScript,1297,21107,492.876712962963,MERGED,268,412,4,1,2,1210,True,0,1,1,1790,680,0.10083333333333333,Document
JavaScript,9664,43890,3736.080949074074,MERGED,61,189,6,0,2,651,False,0,0,0,544,250,1.4580555555555557,Feature
Go,1835,11246,1805.9248495370368,MERGED,58,48,7,0,1,125,False,0,0,0,459,106,1.9508333333333334,Bug
JavaScript,9664,43890,3735.905451388889,MERGED,670,280,99,0,1,332,True,0,0,0,608,950,0.7908333333333334,Bug
Vue,10810,21164,1099.843275462963,CLOSED,2336,2512,2,1,1,1,False,0,1,1,1915,4848,0.10916666666666666,Bug
TypeScript,307,2556,615.7263078703703,MERGED,9,10,1,3,1,592,True,0,3,2,1695,19,27.709722222222222,Bug
TypeScript,7,6,724.1765277777778,MERGED,1,25,3,0,13,51,True,0,0,0,3633,26,97.29527777777778,Feature
Erlang,2054,12122,3874.298877314815,MERGED,169,805,27,1,23,427,False,1,0,0,1440,974,764.0561111111111,Document
TypeScript,41369,87415,3015.4391550925925,MERGED,1,1,1,2,1,520,True,0,2,2,2159,2,2.3716666666666666,Document
TypeScript,307,2556,615.7537962962963,MERGED,1,2,1,1,1,31,False,0,1,1,1068,3,1.3552777777777778,Bug
TypeScript,307,2556,615.4817939814815,MERGED,4,4,1,5,1,313,True,2,3,2,1417,8,3.742777777777778,Bug
TypeScript,307,2556,614.8617476851852,CLOSED,6,2,1,3,1,30,False,1,2,2,1371,8,37.40888888888889,Bug
JavaScript,9664,43890,3734.9830671296295,MERGED,5,67,5,0,3,650,False,0,0,0,585,72,0.16472222222222221,Feature
Go,1174,11429,1920.6203819444445,MERGED,422,33,13,5,2,380,True,2,3,3,2345,455,96.97,Document
V,2097,34362,1627.7302314814815,MERGED,2,9,2,0,1,18,True,0,0,0,1809,11,2.5033333333333334,Bug
V,2097,34362,1627.7396064814814,MERGED,1,1,1,0,1,23,False,0,0,0,1690,2,2.733888888888889,Document
TypeScript,15,34,568.4297222222223,MERGED,41,101,5,0,8,201,False,0,0,0,560,142,16.579166666666666,Bug
TypeScript,7,6,724.1130787037036,MERGED,12,27,2,1,5,253,False,1,0,0,2724,39,1.1983333333333333,Feature
TypeScript,2147,14725,1548.853738425926,MERGED,6,139,6,0,1,781,False,0,0,0,4933,145,2.328611111111111,Document
Go,1174,11429,1919.6872569444442,MERGED,38,53,5,13,4,0,False,5,8,2,2458,91,106.91472222222222,Document
JavaScript,9664,43890,3734.1225925925924,MERGED,1,1,1,0,1,329,True,0,0,0,538,2,0.16416666666666666,Bug
JavaScript,9664,43890,3734.1086689814815,MERGED,1,3,1,0,1,328,True,0,0,0,489,4,0.18472222222222223,Feature
TypeScript,4,33,839.1404629629629,MERGED,0,8,1,3,4,274,True,2,1,1,724,8,1.6372222222222221,Bug
JavaScript,9664,43890,3733.982083333334,MERGED,3,12,1,0,1,325,True,0,0,0,526,15,2.5236111111111112,Feature
TypeScript,41369,87415,3013.6494444444447,MERGED,1,8,2,2,2,40,False,0,2,2,2005,9,4.586111111111111,Document
TypeScript,41369,87415,3013.6408449074074,MERGED,15,3,2,2,2,1958,True,0,2,2,2108,18,2.3247222222222224,Document
TypeScript,7,6,720.9182638888889,CLOSED,13,18,6,1,2,47,True,1,0,0,3071,31,148.05694444444444,Feature
Go,1174,11429,1920.859212962963,MERGED,9,30,2,1,5,144,True,1,0,0,2091,39,0.7388888888888889,Document
Python,547,7161,2313.7364930555555,MERGED,8,27,4,0,3,43,False,0,0,0,685,35,0.23833333333333334,Bug
TypeScript,2070,16643,1321.4310648148148,CLOSED,2,27,2,2,2,6,False,1,1,1,2789,29,1.1508333333333334,Bug
JavaScript,5140,7051,1281.897986111111,MERGED,0,2744,13,3,19,188,False,2,1,1,4436,2744,183.1975,Document
JavaScript,5140,7051,1282.8790509259259,MERGED,85,726,9,2,4,110,False,1,1,1,4995,811,110.85333333333334,Feature
Go,1174,11429,1919.8662962962962,MERGED,307,864,18,2,1,464,True,1,1,1,2541,1171,23.852222222222224,Document
TypeScript,2070,16643,1318.8508912037037,MERGED,2,29,2,0,2,2,False,0,0,0,2262,31,128.86777777777777,Bug
Go,1174,11429,1919.7518518518518,MERGED,0,12,5,4,3,1048,True,3,1,1,2633,12,21.24888888888889,Document
PHP,883,2338,1908.616539351852,CLOSED,1,35,2,0,1,0,False,0,0,0,3164,36,0.07416666666666667,Document
V,2097,34362,1631.8792708333333,MERGED,3,14,2,0,7,0,False,0,0,0,2341,17,66.39166666666667,Document
TypeScript,202,107,1222.797060185185,MERGED,6,22,2,4,4,310,True,0,4,3,2666,28,142.35361111111112,Document
TypeScript,7,6,721.0874768518519,CLOSED,388,212,18,0,10,2,False,0,0,0,3494,600,71.1775,Feature
C#,80,125,899.713900462963,MERGED,251,432,23,0,3,209,True,0,0,0,950,683,93.30027777777778,Document
Go,1174,11429,1918.8766203703706,MERGED,3787,4,39,2,4,499,True,1,1,1,2400,3791,42.404444444444444,Document
Go,1174,11429,1918.876875,MERGED,2523,2553,84,2,7,676,True,2,0,0,2051,5076,26.58138888888889,Document
Go,1174,11429,1918.809861111111,MERGED,350,305,10,0,3,674,True,0,0,0,2126,655,27.073333333333334,Document
TypeScript,307,2556,617.7200115740741,MERGED,5,11,1,1,1,594,True,0,1,1,1786,16,88.97888888888889,Bug
Go,1174,11429,1918.7411805555555,MERGED,0,17,1,4,7,1047,True,3,1,1,2090,17,4.437777777777778,Document
Python,72,25,1713.6530092592593,MERGED,7,34,2,0,2,46,False,0,0,0,2985,41,0.5991666666666666,Bug
TypeScript,202,107,1223.9469675925927,MERGED,16,77,1,3,2,292,True,0,3,3,2803,93,0.17194444444444446,Bug
TypeScript,61,71,1752.1373958333334,MERGED,38,1,16,0,1,175,True,0,0,0,904,39,0.17972222222222223,Feature
Go,1174,11429,1917.7620949074073,MERGED,17,17,10,5,1,378,True,3,2,2,2345,34,23.539722222222224,Document
JavaScript,5140,7051,1282.194074074074,MERGED,14,35,3,1,7,138,False,0,1,1,5128,49,17.857777777777777,Bug
TypeScript,307,2556,615.8429629629629,MERGED,3,5,1,7,2,23,True,3,4,2,1845,8,134.15833333333333,Bug
TypeScript,4,33,841.2518981481481,MERGED,0,156,2,2,2,4,True,1,1,1,996,156,28.6225,Document
TypeScript,4,33,841.5685185185185,MERGED,4,4,1,1,1,679,True,0,1,1,848,8,0.035833333333333335,Bug
V,2097,34362,1630.4735648148146,MERGED,42,0,5,0,1,55,True,0,0,0,3195,42,1.175,Feature
JavaScript,9664,43890,3736.1465625,MERGED,27,51,24,0,1,333,True,0,0,0,857,78,0.14777777777777779,Bug
TypeScript,41369,87415,3017.104363425926,MERGED,1,0,1,2,1,522,True,0,2,2,2080,1,0.8891666666666667,Document
Python,547,7161,2315.860914351852,MERGED,26,26,6,0,8,45,False,0,0,0,4597,52,356.2536111111111,Document
Erlang,2054,12122,3875.2135879629627,MERGED,68,511,26,1,5,429,False,1,0,0,1316,579,242.89138888888888,Document
TypeScript,41369,87415,3016.4440046296295,CLOSED,0,3,2,2,2,1,False,0,2,2,2969,3,6.379166666666666,Document
TypeScript,41369,87415,3016.5014583333336,MERGED,5,6,3,2,1,39,False,0,2,2,3094,11,0.6,Document
JavaScript,9664,43890,3735.036712962963,MERGED,4,158,10,0,8,76,True,0,0,0,909,162,18.745833333333334,Bug
TypeScript,41369,87415,3016.4658449074072,MERGED,6,14,2,2,1,1649,True,0,2,2,2346,20,0.4880555555555556,Document
TypeScript,3393,2334,1045.141261574074,MERGED,1,1,1,1,1,373,False,0,1,1,961,2,0.1411111111111111,Bug
Go,2083,11770,1599.0688194444444,MERGED,8,60,4,0,1,948,True,0,0,0,2618,68,0.10666666666666667,Document
TypeScript,41369,87415,3016.0383796296296,MERGED,2,0,1,2,1,38,False,0,2,2,2464,2,9.255833333333333,Document
TypeScript,41369,87415,3015.8136458333333,CLOSED,0,1,1,3,1,0,False,0,3,3,2214,1,3.207222222222222,Document
JavaScript,9664,43890,3734.8903356481483,MERGED,17,731,7,0,1,335,True,0,0,0,749,748,0.24416666666666667,Bug
JavaScript,5140,7051,1279.775636574074,MERGED,25,67,20,2,6,108,False,1,1,1,5037,92,47.690555555555555,Feature
TypeScript,41369,87415,3015.522465277778,CLOSED,6,12,2,7,1,4,False,3,4,3,2450,18,22.246666666666666,Document
TypeScript,307,2556,615.7441203703703,MERGED,2,4,1,2,1,211,True,1,1,1,690,6,2.113888888888889,Bug
TypeScript,3393,2334,1047.1116550925926,CLOSED,1,7,1,1,1,762,False,0,1,1,1532,8,33.218333333333334,Feature
TypeScript,41369,87415,3015.652361111111,MERGED,1,4,2,2,1,1648,True,0,2,2,2624,5,0.85,Document
TypeScript,58,78,897.2792708333333,MERGED,6,130,5,1,10,135,False,0,1,1,5555,136,356.9002777777778,Feature
TypeScript,41369,87415,3015.5163078703704,MERGED,2,2,2,1,1,142,True,0,1,1,2443,4,2.3175,Document
TypeScript,41369,87415,3015.509502314815,MERGED,2,2,2,1,1,141,True,0,1,1,2483,4,2.4869444444444446,Document
Erlang,2054,12122,3875.495358796296,MERGED,4,2553,34,0,2,26,False,0,0,0,1464,2557,302.7313888888889,Document
TypeScript,41369,87415,3015.4746296296294,MERGED,2,2,2,3,1,139,True,1,2,2,2516,4,0.9597222222222223,Document
TypeScript,41369,87415,3015.4772685185185,MERGED,2,2,2,1,1,140,True,0,1,1,2367,4,0.6425,Document
TypeScript,3393,2334,1044.1278472222223,MERGED,0,8,1,1,2,371,False,0,1,1,1032,8,0.255,Feature
TypeScript,41369,87415,3015.4239699074074,MERGED,1,1,1,2,1,37,False,0,2,2,2400,2,0.5144444444444445,Document
TypeScript,3393,2334,1046.2952777777778,CLOSED,1,10,2,1,2,758,False,0,1,1,1490,11,0.2833333333333333,Document
JavaScript,9664,43890,3734.116412037037,MERGED,0,131,5,0,1,648,False,0,0,0,882,131,0.2866666666666667,Feature
C#,80,125,896.6047916666666,MERGED,232,210,5,0,5,8,True,0,0,0,1356,442,582.3477777777778,Document
Python,137,75,764.1349189814815,MERGED,0,33,3,0,4,241,False,0,0,0,1332,33,285.20916666666665,Document
Vue,10810,21164,1099.0435300925926,MERGED,5,2,1,1,1,0,False,0,1,1,1014,7,17.786944444444444,Bug
TypeScript,41369,87415,3013.570474537037,MERGED,2,12,2,2,1,1957,True,0,2,2,2318,14,0.7427777777777778,Document
TypeScript,41369,87415,3014.5202777777777,MERGED,3,7,5,1,2,138,True,0,1,1,2469,10,22.280555555555555,Document
TypeScript,41369,87415,3014.6809143518517,MERGED,1,5,3,3,1,41,False,0,3,3,2760,6,0.515,Document
TypeScript,41369,87415,3014.460069444445,MERGED,2,2,1,4,1,630,True,0,4,3,2268,4,5.444444444444445,Document
TypeScript,41369,87415,3014.4264583333334,MERGED,8,13,3,2,2,207,False,0,2,2,2557,21,1.2241666666666666,Document
TypeScript,41369,87415,3013.851261574074,MERGED,656,1,43,3,1,1959,True,0,3,3,2245,657,14.0975,Document
TypeScript,41369,87415,3013.573854166667,MERGED,1,2,1,6,1,86,True,2,4,3,2350,3,28.245,Document
C#,655,7879,1907.2902777777779,MERGED,14,154,8,1,2,232,True,0,1,1,1500,168,12.126388888888888,Document
C#,655,7879,1907.3165625000001,MERGED,4,9,1,3,2,1529,True,0,3,3,1890,13,10.444444444444445,Document
TypeScript,15,34,566.3806481481481,MERGED,66,199,12,1,9,527,True,0,1,1,772,265,23.064444444444444,Feature
TypeScript,15,34,566.453125,MERGED,78,122,8,0,3,155,False,0,0,0,774,200,18.56222222222222,Bug
TypeScript,12,11,1066.594502314815,MERGED,27,135,6,0,17,79,False,0,0,0,5281,162,187.3138888888889,Feature
TypeScript,41369,87415,3013.8411805555556,MERGED,42,107,3,3,6,1644,True,1,2,2,2808,149,1.93,Document
TypeScript,41369,87415,3013.740150462963,CLOSED,1,1,1,8,1,4,False,2,6,5,847,2,1.0080555555555555,Bug
TypeScript,85,724,392.3431134259259,MERGED,544,4247,100,0,49,129,False,0,0,0,7370,4791,312.7638888888889,Document
TypeScript,41369,87415,3013.6827893518516,MERGED,0,13,4,3,2,1642,True,1,2,2,2600,13,0.655,Document
TypeScript,41369,87415,3013.628148148148,MERGED,42,55,4,2,3,629,True,0,2,2,3020,97,0.5627777777777778,Document
TypeScript,41369,87415,3013.4846875000003,MERGED,6,4,4,1,10,137,True,0,1,1,2575,10,4.078611111111111,Document
TypeScript,41369,87415,3013.495277777778,MERGED,6,1,2,2,1,628,True,0,2,2,3003,7,0.3811111111111111,Document
TypeScript,41369,87415,3013.4722685185184,MERGED,2,30,4,2,1,1640,True,0,2,2,2286,32,0.6863888888888889,Document
Python,137,75,761.249675925926,MERGED,20,12,3,1,4,107,False,1,0,0,1744,32,17.924722222222222,Bug
Python,137,75,764.890613425926,CLOSED,0,42,2,0,1,40,False,0,0,0,1291,42,88.08472222222223,Document
C#,655,7879,1905.346412037037,MERGED,1,1,1,2,1,231,True,0,2,2,1447,2,23.302777777777777,Document
TypeScript,7,6,724.1569907407408,MERGED,897,854,55,0,66,3,False,0,0,0,4344,1751,73.78777777777778,Feature
TypeScript,7,6,723.239849537037,MERGED,139,172,8,2,13,251,False,2,0,0,4834,311,94.94,Bug
Go,1174,11429,1920.912013888889,MERGED,185,171,13,3,1,467,True,1,2,1,2985,356,66.60388888888889,Document
C++,363,552,617.2581597222222,MERGED,149,192,16,0,1,300,False,0,0,0,1631,341,114.08305555555556,Document
Erlang,2054,12122,3875.3221990740744,MERGED,2,9,4,3,1,430,False,3,0,0,1493,11,67.11638888888889,Document
TypeScript,2070,16643,1322.5113541666667,MERGED,4,50,2,0,3,0,False,0,0,0,4375,54,41.016666666666666,Bug
TypeScript,2070,16643,1322.0846296296297,MERGED,9,9,2,1,1,0,False,1,0,0,4218,18,50.583333333333336,Document
TypeScript,261,3765,755.6029166666667,MERGED,152,354,6,0,3,235,True,0,0,0,4871,506,101.48833333333333,Document
TypeScript,7,6,724.1715162037036,MERGED,30,128,40,0,8,258,False,0,0,0,4458,158,0.8913888888888889,Feature
PHP,883,2338,1908.6308796296296,CLOSED,1,72,3,3,3,1,False,0,3,3,3255,73,315.5444444444444,Document
C++,2234,23696,2436.4104745370373,MERGED,18,11,2,1,2,182,False,0,1,1,1333,29,35.6,Bug
TypeScript,307,2556,617.4282986111111,CLOSED,83,103,3,6,3,4,False,2,4,2,3173,186,242.10666666666665,Document
Python,72,25,1714.8041203703704,MERGED,77,668,5,2,4,49,False,1,1,1,4953,745,86.57138888888889,Document
Java,450,746,4151.954629629629,MERGED,10,35,3,1,4,19,False,0,1,1,1635,45,146.3761111111111,Bug
Python,137,75,761.8941898148149,CLOSED,0,62,4,0,1,38,False,0,0,0,2211,62,554.9675,Document
PHP,883,2338,1910.2547685185184,CLOSED,510,1319,147,4,27,1,False,1,3,3,2995,1829,179.79083333333332,Document
TypeScript,7,6,722.8664930555556,CLOSED,0,194,12,1,4,239,False,0,1,1,3735,194,26.235555555555557,Feature
Python,137,75,763.2482986111112,MERGED,0,81,4,0,8,2,False,0,0,0,1062,81,26.244722222222222,Document
Go,1174,11429,1919.945289351852,MERGED,112,147,3,1,7,142,True,1,0,0,3083,259,21.35638888888889,Document
Erlang,2054,12122,3874.3642824074072,MERGED,24,104,6,0,1,428,False,0,0,0,1190,128,21.52027777777778,Document
Java,450,746,4151.255277777777,MERGED,6,274,11,4,15,167,False,1,3,2,3855,280,161.91083333333333,Bug
Python,547,7161,2314.7819791666666,MERGED,0,6,1,0,7,44,False,0,0,0,1173,6,212.8,Feature
TypeScript,3393,2334,1047.9437731481482,MERGED,1,1,1,1,1,765,False,0,1,1,1530,2,0.006111111111111111,Feature
TypeScript,3393,2334,1047.9376041666667,MERGED,1,1,1,1,1,764,False,0,1,1,1449,2,0.034166666666666665,Feature
Java,450,746,4150.9224537037035,MERGED,1,13,3,3,15,75,False,0,3,2,1521,14,143.7836111111111,Feature
Java,450,746,4150.01193287037,MERGED,17,27,3,1,23,74,False,0,1,1,1665,44,192.2875,Bug
Starlark,440,286,568.7968402777777,MERGED,0,1,1,1,1,47,False,0,1,1,1147,1,3.689722222222222,Feature
Go,1174,11429,1919.1041898148148,MERGED,1,1,1,6,1,183,True,6,0,0,3012,2,39.492777777777775,Document
TypeScript,4,33,842.7972800925926,MERGED,27,25,2,1,1,411,True,0,1,1,1220,52,0.0625,Feature
Python,137,75,762.9772916666667,MERGED,0,58,2,1,2,240,False,0,1,1,1222,58,0.4911111111111111,Document
TypeScript,2070,16643,1318.572986111111,MERGED,4,63,7,6,4,1,False,1,5,2,3909,67,134.56805555555556,Bug
C#,80,125,896.9654976851853,MERGED,55,220,22,2,17,208,True,1,1,1,1447,275,209.91611111111112,Document
TypeScript,3393,2334,1047.0956597222223,MERGED,2,2,2,1,2,761,False,0,1,1,1355,4,0.30027777777777775,Feature
TypeScript,3393,2334,1047.0216898148149,MERGED,25,66,6,1,3,377,False,0,1,1,1637,91,1.3141666666666667,Feature
Erlang,2054,12122,3872.4381712962963,MERGED,3,40,3,0,1,425,False,0,0,0,1127,43,63.3825,Document
TypeScript,3393,2334,1046.9317592592593,MERGED,1,10,3,2,1,760,False,1,1,1,1361,11,0.1238888888888889,Bug
TypeScript,4,33,842.3134027777778,MERGED,7,83,1,1,1,682,True,0,1,1,1324,90,0.3425,Document
TypeScript,4,33,842.3055092592593,MERGED,4,4,2,1,1,681,True,0,1,1,1039,8,0.06055555555555556,Feature
TypeScript,261,3765,754.6976157407407,MERGED,114,286,26,0,4,215,False,0,0,0,5318,400,5.493611111111111,Document
TypeScript,4,33,842.1053125,MERGED,9,253,7,1,5,413,False,0,1,1,1254,262,2.9125,Bug
C#,655,7879,1907.388449074074,CLOSED,41,272,10,0,5,4,False,0,0,0,1685,313,0.044444444444444446,Document
TypeScript,149,2900,460.0708564814815,MERGED,0,84,2,2,2,125,False,0,2,1,1667,84,358.5686111111111,Bug
Erlang,2054,12122,3872.8976851851853,MERGED,2,14,3,0,3,401,True,0,0,0,1130,16,18.415555555555557,Document
TypeScript,307,2556,617.5158912037037,MERGED,28,43,2,1,1,593,True,0,1,1,3377,71,93.86305555555556,Bug
C#,655,7879,1908.1769212962963,MERGED,11,11,2,0,1,667,True,0,0,0,2310,22,6.5575,Document
Erlang,2054,12122,3872.67625,MERGED,1,1,1,0,1,30,True,0,0,0,1485,2,23.787222222222223,Document
TypeScript,4,33,841.5536111111111,MERGED,42,53,14,1,11,412,False,0,1,1,1445,95,12.362777777777778,Feature
TypeScript,3393,2334,1046.348888888889,MERGED,3,3,2,1,1,376,False,0,1,1,1539,6,0.22138888888888889,Feature
TypeScript,3393,2334,1046.3131944444444,MERGED,5,10,2,1,1,176,False,0,1,1,1723,15,0.13527777777777777,Feature
Erlang,2054,12122,3872.451585648148,MERGED,20,84,5,0,1,426,False,0,0,0,1045,104,21.526666666666667,Document
TypeScript,4,33,841.5086458333334,MERGED,21,115,14,1,1,678,True,0,1,1,1461,136,0.14055555555555554,Feature
TypeScript,3393,2334,1046.1633796296296,MERGED,1,1,1,2,1,0,False,0,2,1,1285,2,0.37722222222222224,Bug
TypeScript,307,2556,616.6645023148147,MERGED,6,30,3,3,2,315,True,1,2,1,2500,36,115.2088888888889,Bug
TypeScript,41369,87415,3016.623553240741,MERGED,3,596,7,2,4,1650,True,0,2,2,3188,599,3.0719444444444446,Document
C++,363,552,615.1029976851852,MERGED,6,7,2,1,1,298,False,1,0,0,1389,13,4.926388888888889,Document
Go,752,2399,805.8698379629631,MERGED,6,9,2,0,4,462,False,0,0,0,1236,15,14.345833333333333,Bug
TypeScript,261,3765,753.7098611111111,MERGED,50,340,13,0,2,1047,True,0,0,0,5781,390,0.4761111111111111,Document
TypeScript,4,33,840.9295254629629,MERGED,1,4,1,1,1,249,False,0,1,1,1285,5,0.03972222222222222,Feature
TypeScript,1297,21107,494.7403125,MERGED,3814,341,55,1,1,1218,True,0,1,1,4849,4155,0.16361111111111112,Document
Python,72,25,1712.7548842592594,MERGED,55,180,7,0,3,45,False,0,0,0,4547,235,21.848055555555554,Document
C++,363,552,614.9451273148148,MERGED,44,24,10,0,3,297,False,0,0,0,1529,68,5.164444444444444,Document
Java,450,746,4148.130219907408,MERGED,303,333,31,1,18,25,False,0,1,1,1424,636,195.3736111111111,Feature
TypeScript,41369,87415,3015.8374537037034,MERGED,24,153,8,7,15,634,True,1,6,5,3848,177,111.1763888888889,Document
Erlang,2054,12122,3872.2595486111113,MERGED,3,5,4,1,1,32,False,0,1,1,1093,8,2.1991666666666667,Document
Python,2409,12194,316.8626967592592,MERGED,0,1,1,0,2,91,True,0,0,0,1548,1,0.6055555555555555,Document
C#,80,125,898.8078703703704,MERGED,3,3,1,0,1,11,False,0,0,0,1080,6,0.43944444444444447,Document
C#,655,7879,1906.803460648148,CLOSED,1,4,1,0,3,664,True,0,0,0,2275,5,7.579722222222222,Document
C#,655,7879,1905.9952546296297,MERGED,24,14,2,1,2,23,False,0,1,1,2012,38,7.829166666666667,Document
Erlang,2054,12122,3871.458425925926,MERGED,14,170,5,0,1,147,False,0,0,0,987,184,17.00138888888889,Bug
TypeScript,261,3765,752.7736574074074,MERGED,53,286,29,0,2,1044,True,0,0,0,5165,339,2.231388888888889,Document
Erlang,2054,12122,3871.3969444444447,MERGED,3,33,4,1,1,25,False,1,0,0,1191,36,17.966944444444444,Document
C#,655,7879,1905.9172569444445,MERGED,1,10925,2183,1,4,663,True,0,1,1,2377,10926,39.01111111111111,Document
JavaScript,5140,7051,1282.6230787037036,MERGED,21,394,9,2,10,109,False,1,1,1,7745,415,121.69666666666667,Feature
TypeScript,3393,2334,1045.1866203703705,MERGED,9,2,1,1,1,757,False,0,1,1,1711,11,0.1663888888888889,Feature
C#,655,7879,1905.920925925926,MERGED,5,84,4,6,5,616,True,2,4,4,2040,89,17.23138888888889,Document
C#,80,125,896.4306134259259,MERGED,18901,27180,97,2,91,188,True,0,2,2,1776,46081,529.3025,Document
TypeScript,202,107,1221.5619907407406,MERGED,45,35,4,3,1,302,True,0,3,3,3559,80,21.511388888888888,Document
TypeScript,41369,87415,3016.555532407407,MERGED,2,12,2,1,2,26,True,0,1,1,3221,14,1.6569444444444446,Document
TypeScript,1073,11366,1171.7422222222222,MERGED,1,3,1,1,5,776,True,0,1,1,1454,4,1.2383333333333333,Feature
C++,363,552,613.2486805555556,MERGED,52,62,5,0,2,293,False,0,0,0,1555,114,2.0080555555555555,Document
TypeScript,1073,11366,1171.5336574074074,MERGED,9,3,1,1,1,228,False,0,1,1,1122,12,1.1497222222222223,Bug
TypeScript,1297,21107,492.6978125,MERGED,17,588,17,1,15,1209,True,0,1,1,4797,605,2.9138888888888888,Document
TypeScript,41369,87415,3015.9627777777782,MERGED,0,1,1,2,3,635,True,0,2,2,3988,1,0.13166666666666665,Document
TypeScript,307,2556,615.6531365740741,MERGED,6,30,4,1,1,591,True,0,1,1,3033,36,29.469444444444445,Bug
TypeScript,3393,2334,1043.9363194444445,MERGED,0,5,1,1,1,174,False,0,1,1,1302,5,0.06277777777777778,Document
Python,2409,12194,318.56796296296295,MERGED,1,3,1,4,5,0,False,2,2,1,1593,4,11.416944444444445,Document
TypeScript,15,34,567.4478472222222,MERGED,150,150,116,0,1,198,False,0,0,0,1306,300,0.49333333333333335,Feature
Java,450,746,4148.310277777778,MERGED,1,1,1,0,2,18,False,0,0,0,1155,2,42.86472222222222,Bug
C#,655,7879,1904.7347685185186,MERGED,3,0,1,0,1,11,True,0,0,0,2017,3,7.450833333333334,Document
C#,655,7879,1904.720798611111,MERGED,3,0,1,0,1,10,True,0,0,0,2074,3,7.792777777777777,Document
TypeScript,307,2556,615.605324074074,MERGED,52,53,3,5,3,314,True,2,3,2,3965,105,5.429444444444444,Bug
TypeScript,41369,87415,3014.9168750000003,MERGED,5,75,3,3,1,1647,True,0,3,3,3820,80,12.30638888888889,Document
Starlark,440,286,570.732175925926,MERGED,0,201,2,1,1,1,False,0,1,1,2077,201,50.600833333333334,Document
JavaScript,22,26,997.216400462963,MERGED,0,0,46,0,1,18,True,0,0,0,1783,0,11.3075,Bug
TypeScript,41369,87415,3014.449675925926,MERGED,10,63,7,2,3,1646,True,0,2,2,4265,73,0.6461111111111111,Document
TypeScript,12,11,1068.3562962962963,CLOSED,1260,1974,65,0,9,192,False,0,0,0,9751,3234,125.28361111111111,Bug
TypeScript,41369,87415,3013.9529398148147,CLOSED,2,94,2,2,3,1645,True,0,2,2,3694,96,11.258611111111112,Document
TypeScript,41369,87415,3013.458773148148,MERGED,1,25,5,2,5,518,True,0,2,2,3786,26,3.464166666666667,Document
TypeScript,41369,87415,3013.4763310185185,MERGED,136,201,2,2,4,627,True,0,2,2,3236,337,0.6944444444444444,Document
TypeScript,12,11,1067.4307754629629,MERGED,171,419,16,0,16,47,False,0,0,0,8436,590,135.86416666666668,Bug
Python,137,75,764.4102662037036,MERGED,4,5,3,0,2,226,False,0,0,0,1884,9,0.1511111111111111,Document
Python,137,75,764.3907060185185,MERGED,1,9,4,0,1,225,False,0,0,0,2245,10,0.3347222222222222,Document
TypeScript,2147,14725,1551.7753587962964,MERGED,48,256,2,0,1,62,False,0,0,0,9929,304,95.83111111111111,Feature
Python,2409,12194,319.0659837962963,MERGED,4,1,1,2,1,0,False,1,1,1,2131,5,18.63083333333333,Bug
Python,2409,12194,318.28363425925926,MERGED,18,304,7,7,14,2,False,2,5,2,1989,322,37.48694444444445,Document
Python,2409,12194,319.0454282407407,MERGED,0,2,1,0,2,410,True,0,0,0,1656,2,0.16416666666666666,Document
C#,80,125,896.6335069444444,MERGED,355,15556,175,0,146,102,False,0,0,0,2023,15911,239.53333333333333,Document
C#,80,125,897.9091319444445,MERGED,20984,7066,195,0,23,190,False,0,0,0,1711,28050,141.23611111111111,Document
Python,14534,41196,1164.4086342592593,MERGED,13,13,5,1,2,0,False,0,1,1,2266,26,94.7911111111111,Document
C#,655,7879,1907.8826967592593,MERGED,10,19,5,0,4,666,True,0,0,0,2584,29,179.70277777777778,Document
Java,450,746,4152.160972222222,MERGED,6,2,1,1,1,77,False,0,1,1,2012,8,3.8841666666666668,Bug
TypeScript,4,33,841.3921643518519,MERGED,203,671,31,1,12,408,True,0,1,1,1638,874,8.491111111111111,Bug
TypeScript,4,33,841.5048032407408,MERGED,14,50,3,0,1,677,True,0,0,0,2046,64,0.06472222222222222,Feature
TypeScript,3393,2334,1046.229363425926,MERGED,38,120,7,3,3,506,False,0,3,2,2539,158,20.136666666666667,Feature
Starlark,440,286,566.1573263888889,MERGED,1,6,1,2,2,30,False,0,2,2,1558,7,63.242222222222225,Bug
Starlark,440,286,566.1242361111111,MERGED,0,9,1,2,1,94,False,0,2,2,1986,9,64.0513888888889,Feature
C++,363,552,614.821400462963,MERGED,11,12,5,0,1,296,False,0,0,0,2044,23,4.972222222222222,Document
Python,2409,12194,316.90534722222225,MERGED,8,8,3,0,8,408,True,0,0,0,1946,16,2.2936111111111113,Document
Python,2409,12194,316.93425925925925,MERGED,1,17,1,0,3,409,True,0,0,0,2134,18,0.3080555555555556,Document
TypeScript,4,33,840.5632060185185,MERGED,16,67,9,1,5,247,False,0,1,1,2305,83,1.0944444444444446,Bug
C#,80,125,898.5683449074073,MERGED,1,5,2,0,1,10,False,0,0,0,1476,6,1.2663888888888888,Document
Python,2409,12194,316.65174768518517,MERGED,1,2,1,0,3,90,True,0,0,0,1822,3,5.633055555555556,Document
C#,655,7879,1904.8985185185186,MERGED,118,169,14,7,7,661,True,4,3,3,2507,287,239.40444444444444,Document
TypeScript,3393,2334,1045.3770601851852,MERGED,2,19,1,1,1,175,False,0,1,1,1595,21,0.10305555555555555,Bug
TypeScript,2147,14725,1549.797997685185,MERGED,49,420,15,0,1,785,False,0,0,0,8673,469,22.015833333333333,Document
C++,363,552,613.2518287037037,MERGED,463,295,8,0,3,294,False,0,0,0,1875,758,43.72083333333333,Document
C#,655,7879,1908.3068402777778,MERGED,1,1,1,1,1,668,True,0,1,1,2516,2,3.4325,Document
V,2097,34362,1628.9051851851852,MERGED,17,11,2,3,1,24,False,1,2,1,1862,28,4.043055555555555,Document
TypeScript,3393,2334,1044.0142824074073,MERGED,0,15,2,1,1,370,False,0,1,1,1982,15,0.22111111111111112,Feature
F#,153,337,2997.1861111111107,MERGED,56,72,4,0,4,38,False,0,0,0,10828,128,37.87888888888889,Document
Go,1835,11246,1805.750486111111,MERGED,23,20,6,0,6,18,False,0,0,0,2071,43,25.638055555555557,Document
Go,1835,11246,1805.5868171296297,MERGED,7,7,2,0,1,43,True,0,0,0,1691,14,0.1461111111111111,Document
TypeScript,2070,16643,1321.3384143518517,MERGED,11,67,2,0,2,5,False,0,0,0,4437,78,70.47527777777778,Document
Python,2409,12194,320.67011574074075,MERGED,3,3,3,0,4,92,True,0,0,0,2293,6,5.887777777777778,Document
TypeScript,7,6,722.0919560185185,CLOSED,434,1293,20,0,25,248,False,0,0,0,6081,1727,25.358888888888888,Bug
TypeScript,41369,87415,3016.6360995370374,MERGED,355,354,288,2,4,1651,True,0,2,2,5710,709,1.4055555555555554,Document
C++,2234,23696,2434.3293055555555,MERGED,48,358,2,1,5,10,False,0,1,1,7678,406,24.91638888888889,Bug
Erlang,2054,12122,3873.6883101851854,MERGED,1,1,1,0,1,31,True,0,0,0,2237,2,0.8622222222222222,Document
TypeScript,3393,2334,1044.2520601851852,MERGED,18,18,6,3,1,0,False,0,3,2,3300,36,67.855,Bug
TypeScript,4,33,841.4519328703703,MERGED,19,526,26,1,10,409,True,0,1,1,2538,545,8.597222222222221,Document
TypeScript,1073,11366,1172.9839930555556,MERGED,1,7,1,1,1,35,True,0,1,1,2286,8,59.08138888888889,Bug
TypeScript,1297,21107,493.70400462962965,MERGED,15,174,15,1,5,1212,True,0,1,1,7921,189,0.42277777777777775,Document
TypeScript,3393,2334,1046.2962615740742,MERGED,1,156,8,1,5,375,False,0,1,1,2824,157,0.39305555555555555,Feature
TypeScript,12,11,1067.1899421296296,MERGED,507,758,39,0,3,80,False,0,0,0,13968,1265,149.6775,Feature
TypeScript,3393,2334,1046.1395717592593,MERGED,16,49,6,2,1,0,False,0,2,1,3175,65,0.94,Bug
TypeScript,1297,21107,492.9292939814815,MERGED,309,1190,22,1,12,1,False,0,1,1,6201,1499,14.359444444444444,Document
Python,2409,12194,316.63653935185187,MERGED,2,3,3,1,1,89,True,0,1,1,2398,5,5.962777777777778,Document
TypeScript,149,2900,455.95086805555553,MERGED,7,17,3,3,1,123,False,1,2,2,2797,24,57.471111111111114,Feature
TypeScript,1297,21107,492.71741898148144,CLOSED,0,0,0,1,3,0,False,0,1,1,5936,0,4.98,Document
Erlang,2054,12122,3871.4508680555555,MERGED,25,88,3,2,1,424,False,1,1,1,2075,113,16.934444444444445,Document
TypeScript,1297,21107,492.67707175925926,MERGED,140,95,46,1,3,1208,True,0,1,1,6203,235,0.20416666666666666,Document
Python,2409,12194,316.28256944444445,MERGED,44,55,9,0,5,407,True,0,0,0,2792,99,2.8233333333333333,Document
TypeScript,1073,11366,1172.4981828703703,MERGED,9,3,1,1,1,312,True,0,1,1,2395,12,5.784166666666667,Bug
TypeScript,3393,2334,1045.1671875,MERGED,11,21,2,1,2,374,False,0,1,1,2494,32,0.12555555555555556,Bug
TypeScript,3393,2334,1045.1327199074074,MERGED,0,16,2,1,1,372,False,0,1,1,2213,16,0.3038888888888889,Feature
Go,1174,11429,1917.9218402777778,MERGED,348,395,18,3,1,461,True,2,1,1,2179,743,19.739166666666666,Document
TypeScript,41369,87415,3014.619039351852,MERGED,37,234,10,2,14,519,True,0,2,2,5555,271,29.595277777777778,Document
TypeScript,15,34,567.644525462963,MERGED,306,1789,48,0,27,375,False,0,0,0,1910,2095,32.55694444444445,Document
TypeScript,41369,87415,3014.5181828703703,MERGED,38,198,12,3,13,631,True,0,3,3,6323,236,23.4675,Document
TypeScript,3393,2334,1043.9134027777777,MERGED,23,59,3,1,1,173,False,0,1,1,3599,82,0.165,Document
TypeScript,1073,11366,1170.8582986111112,MERGED,16,22,2,1,1,309,True,0,1,1,3176,38,16.094444444444445,Bug
C#,655,7879,1907.2057523148148,MERGED,8,19,7,5,4,665,True,2,3,3,3160,27,19.474722222222223,Document
TypeScript,178,1359,399.1798726851852,MERGED,195,101,2,1,1,37,True,0,1,1,12222,296,10.19138888888889,Bug
TypeScript,1073,11366,1170.5891087962962,MERGED,6,12,1,1,2,308,True,0,1,1,2476,18,0.9286111111111112,Bug
TypeScript,41369,87415,3013.710543981482,MERGED,12,15,4,1,5,36,False,0,1,1,4913,27,3.1083333333333334,Document
Java,450,746,4148.128958333334,MERGED,11,20,3,0,3,72,False,0,0,0,2679,31,19.496111111111112,Bug
Go,1835,11246,1806.0141203703704,MERGED,1,13,1,0,1,595,False,0,0,0,2107,14,15.741111111111111,Document
Go,1835,11246,1805.857488425926,MERGED,8,18,3,0,4,119,False,0,0,0,2883,26,0.6538888888888889,Document
Go,1835,11246,1805.615462962963,MERGED,5,9,1,0,2,118,False,0,0,0,3149,14,0.3347222222222222,Document
F#,153,337,2998.2499421296293,MERGED,368,305,19,0,4,187,False,0,0,0,13566,673,12.318333333333333,Document
F#,271,818,2806.4219328703707,MERGED,29,87,4,1,1,18,True,1,0,0,10112,116,22.059444444444445,Document
JavaScript,5140,7051,1282.8448148148148,MERGED,230,421,32,2,9,0,False,1,1,1,9632,651,455.46416666666664,Feature
Go,752,2399,805.6623958333333,MERGED,529,12466,96,0,11,74,False,0,0,0,9224,12995,92.31444444444445,Document
TypeScript,1297,21107,494.7217592592593,MERGED,1081,39,35,1,2,1217,True,0,1,1,9791,1120,0.25722222222222224,Document
TypeScript,1297,21107,494.6351041666667,CLOSED,86,146,9,1,2,1215,True,0,1,1,8964,232,2.0991666666666666,Document
Java,450,746,4148.980775462963,MERGED,193,430,19,2,14,93,True,0,2,1,9672,623,143.07222222222222,Bug
TypeScript,41369,87415,3016.7132407407407,MERGED,517,1559,334,1,26,521,True,0,1,1,8131,2076,24.08888888888889,Document
TypeScript,149,2900,460.00718750000004,MERGED,4126,83,44,1,1,124,False,0,1,1,5191,4209,0.37083333333333335,Document
Python,137,75,763.4586921296296,MERGED,0,139,10,0,2,39,False,0,0,0,3598,139,1.0505555555555555,Document
Python,4517,54993,1005.7772569444445,MERGED,3,9,2,0,1,157,False,0,0,0,4460,12,7.308888888888889,Document
Starlark,440,286,568.6945717592592,MERGED,0,262,5,1,1,46,False,0,1,1,3298,262,2.285833333333333,Document
Java,450,746,4151.138287037037,MERGED,77,226,12,2,15,76,False,0,2,1,4429,303,123.14833333333333,Document
TypeScript,1073,11366,1173.6997685185186,MERGED,139,332,4,2,4,313,True,1,1,1,4647,471,69.93527777777778,Bug
Python,4517,54993,1004.5862384259259,MERGED,8,35,1,0,4,125,True,0,0,0,4292,43,45.78611111111111,Document
Python,4517,54993,1004.5679166666667,MERGED,6,7,1,0,2,124,True,0,0,0,3656,13,46.01694444444445,Document
Starlark,440,286,567.1559953703703,MERGED,0,263,3,2,1,4,False,0,2,2,4564,263,39.26083333333333,Document
TypeScript,4,33,841.6302199074074,MERGED,164,27,17,1,1,680,True,0,1,1,4507,191,0.255,Bug
TypeScript,41369,87415,3013.640543981481,MERGED,12,251,13,2,5,1641,True,0,2,2,7948,263,1.5,Document
TypeScript,4,33,840.1013425925926,MERGED,21,66,8,2,6,275,True,1,1,1,3320,87,0.2644444444444444,Document
TypeScript,4,33,840.2314814814814,MERGED,79,114,6,2,6,276,True,1,1,1,3645,193,1.1433333333333333,Feature
Java,450,746,4149.114398148148,MERGED,11,30,6,2,20,73,False,0,2,1,3729,41,75.75944444444444,Feature
TypeScript,1073,11366,1171.567650462963,MERGED,36,68,6,1,1,88,True,0,1,1,4209,104,32.568888888888885,Bug
TypeScript,1073,11366,1171.8207407407408,MERGED,18,5,3,1,2,311,True,0,1,1,3715,23,16.532777777777778,Bug
TypeScript,1073,11366,1171.6857291666668,MERGED,4,144,6,1,7,310,True,0,1,1,3769,148,0.6747222222222222,Bug
TypeScript,1073,11366,1171.632175925926,MERGED,36,37,2,1,5,34,True,0,1,1,4321,73,0.5283333333333333,Bug
TypeScript,4,33,839.4450115740741,MERGED,41,98,15,1,1,666,True,0,1,1,4820,139,0.06138888888888889,Document
TypeScript,4,33,839.3873611111111,MERGED,35,34,12,1,1,665,True,0,1,1,4902,69,0.06305555555555556,Feature
Go,1835,11246,1806.8663888888889,MERGED,28,72,9,0,6,19,False,0,0,0,3219,100,97.05611111111111,Document
Go,1835,11246,1804.974976851852,CLOSED,1,1119,16,1,3,7,False,0,1,1,4256,1120,45.17,Document
Go,1835,11246,1805.069085648148,MERGED,33,75,4,0,1,16,False,0,0,0,3545,108,13.33611111111111,Document
Go,1835,11246,1804.9259606481482,CLOSED,1,558,15,0,1,5,False,0,0,0,3772,559,0.10444444444444445,Feature
Go,752,2399,803.4735416666667,MERGED,525,857,31,0,14,161,False,0,0,0,11580,1382,24.239722222222223,Bug
Go,1835,11246,1806.8778125,MERGED,64,1024,27,1,14,120,False,0,1,1,7059,1088,599.3111111111111,Document
Python,137,75,764.9020717592592,MERGED,98,228,19,0,2,41,False,0,0,0,5576,326,1.0658333333333334,Bug
JavaScript,22,26,996.0779629629629,MERGED,103,194,6,0,3,30,True,0,0,0,5744,297,17.219722222222224,Bug
Python,137,75,764.3738310185186,MERGED,20,35,6,0,3,224,False,0,0,0,5354,55,0.2816666666666667,Document
Go,789,5551,1117.0534375,MERGED,57,132,14,0,3,197,True,0,0,0,7948,189,26.645833333333332,Document
TypeScript,4,33,841.6704398148148,MERGED,133,253,14,1,4,250,False,0,1,1,7186,386,0.18138888888888888,Document
TypeScript,4,33,841.2697916666666,MERGED,112,112,29,1,1,675,True,0,1,1,6964,224,5.625277777777778,Document
Python,2409,12194,316.41449074074075,MERGED,408,183,15,8,23,88,True,4,4,1,7971,591,44.290277777777774,Document
Python,4517,54993,1004.1441550925925,MERGED,7,19,3,0,3,156,False,0,0,0,6325,26,7.092222222222222,Document
TypeScript,1073,11366,1172.829849537037,MERGED,36,55,3,1,2,230,False,0,1,1,6259,91,19.703055555555554,Document
TypeScript,4,33,840.5134490740742,MERGED,1831,467,36,1,1,673,True,0,1,1,6414,2298,16.965,Document
TypeScript,4,33,840.1774537037037,MERGED,284,678,31,1,1,669,True,0,1,1,6182,962,0.23777777777777778,Document
TypeScript,4,33,839.6084027777778,MERGED,109,517,51,1,2,668,True,0,1,1,5398,626,12.5775,Document
TypeScript,4,33,838.6832986111111,MERGED,830,847,54,1,17,246,False,0,1,1,6095,1677,23.7175,Feature
JavaScript,34,25,273.9308564814815,MERGED,8,47,4,0,2,89,False,0,0,0,5722,55,4.036944444444444,Feature
Go,1835,11246,1806.005902777778,CLOSED,24,1207,18,1,3,8,False,0,1,1,5337,1231,20.423055555555557,Document
Go,1835,11246,1805.885173611111,MERGED,33,125,12,0,6,44,True,0,0,0,4800,158,18.100277777777777,Document
Go,1835,11246,1805.5797569444446,MERGED,2422,2428,87,1,24,17,False,0,1,1,6028,4850,1.8025,Document
Go,1835,11246,1804.909837962963,MERGED,29,121,8,0,1,42,True,0,0,0,7064,150,16.83,Document
Go,1835,11246,1804.9418981481483,CLOSED,1,1119,16,1,2,6,False,0,1,1,5439,1120,0.7811111111111111,Feature
Go,752,2399,803.7574189814815,MERGED,3363,13925,161,0,92,308,False,0,0,0,20797,17288,357.8722222222222,Document
JavaScript,22,26,997.7367013888888,MERGED,344,346,7,0,1,31,True,0,0,0,9882,690,0.2538888888888889,Document
TypeScript,3393,2334,1047.2197800925926,MERGED,7,24,8,1,4,378,False,0,1,1,9712,31,0.46305555555555555,Bug
TypeScript,4,33,842.6096296296296,MERGED,334,325,31,1,11,410,True,0,1,1,8917,659,2.701111111111111,Bug
TypeScript,4,33,840.8941087962962,MERGED,93,56,10,1,3,248,False,0,1,1,8185,149,0.36138888888888887,Feature
TypeScript,4,33,840.273761574074,MERGED,115,188,49,1,1,671,True,0,1,1,10696,303,0.9013888888888889,Document
TypeScript,4,33,840.2133101851852,MERGED,142,184,48,1,1,670,True,0,1,1,8832,326,2.2708333333333335,Feature
Go,1835,11246,1807.9032291666665,CLOSED,20,158,5,0,2,9,False,0,0,0,8334,178,89.78722222222223,Bug
Go,1835,11246,1806.985023148148,MERGED,44,239,8,0,6,45,True,0,0,0,8509,283,86.37694444444445,Document
TypeScript,1073,11366,1173.8980787037037,MERGED,9,36,7,1,6,314,True,0,1,1,13311,45,68.21277777777777,Bug
TypeScript,3393,2334,1045.4210648148148,MERGED,97,124,23,2,2,0,False,0,2,1,14809,221,11.101944444444445,Bug
TypeScript,12,11,1074.2552546296297,MERGED,1,1,1,0,1,81,False,0,0,0,959,2,0.13111111111111112,Feature
TypeScript,2147,14725,1556.8659722222221,MERGED,15,28,1,0,1,797,False,0,0,0,664,43,124.69055555555556,Bug
TypeScript,2147,14725,1556.088101851852,MERGED,1,10,1,0,1,795,False,0,0,0,707,11,160.2686111111111,Bug
TypeScript,2147,14725,1558.0341435185185,MERGED,0,1,1,0,1,4,False,0,0,0,777,1,186.525,Feature
TypeScript,2147,14725,1558.7949421296296,MERGED,2,2,1,0,1,327,False,0,0,0,956,4,123.81111111111112,Feature
TypeScript,2147,14725,1557.1704282407409,MERGED,0,7,1,0,1,323,False,0,0,0,530,7,19.165555555555557,Feature
TypeScript,12,11,1073.5164467592592,CLOSED,57,1756,45,0,50,50,False,0,0,0,1953,1813,376.3544444444444,Feature
TypeScript,2147,14725,1557.9663657407407,MERGED,1,4,1,0,1,800,False,0,0,0,870,5,115.2,Feature
TypeScript,2147,14725,1557.9943287037038,MERGED,23,40,7,0,4,14,False,0,0,0,982,63,90.60055555555556,Bug
TypeScript,85,724,402.34938657407406,MERGED,1,7,1,0,1,20,False,0,0,0,1088,8,0.20305555555555554,Document
Go,30,295,434.0391319444445,MERGED,2,0,1,0,1,112,True,0,0,0,958,2,0.12666666666666668,Feature
TypeScript,2147,14725,1557.9637962962963,CLOSED,2,33,2,0,2,13,False,0,0,0,1056,35,0.6608333333333334,Feature
TypeScript,12,11,1072.1441666666667,CLOSED,4,4,1,0,1,2,True,0,0,0,1167,8,316.6141666666667,Feature
TypeScript,12,11,1072.134537037037,CLOSED,23,24,2,0,3,1,True,0,0,0,1266,47,316.84305555555557,Bug
TypeScript,12,11,1072.1294328703705,CLOSED,71,76,9,0,6,0,True,0,0,0,1151,147,316.95944444444444,Feature
F#,271,818,2814.8225694444445,MERGED,11,11,3,0,1,19,True,0,0,0,1442,22,393.45472222222224,Bug
TypeScript,2147,14725,1557.1900347222224,MERGED,3,5,2,0,1,64,False,0,0,0,882,8,14.242777777777778,Bug
TypeScript,85,724,399.96952546296296,MERGED,1,0,1,0,3,120,False,0,0,0,1154,1,22.255,Document
TypeScript,2147,14725,1557.1801157407408,MERGED,0,7,1,0,1,324,False,0,0,0,897,7,0.014722222222222222,Feature
JavaScript,5140,7051,1290.7294791666666,MERGED,0,4,1,1,1,116,False,0,1,1,662,4,0.35583333333333333,Document
TypeScript,7,6,729.0851967592592,CLOSED,24,24,1,0,1,258,False,0,0,0,564,48,0.23027777777777778,Feature
TypeScript,261,3765,763.5546643518519,MERGED,1,2,1,0,1,140,False,0,0,0,1077,3,2.4305555555555554,Document
TypeScript,12,11,1072.4698958333333,MERGED,677,905,6,1,9,193,False,0,1,1,2183,1582,401.405,Feature
TypeScript,261,3765,762.9096180555556,MERGED,3,10,3,0,1,1069,True,0,0,0,1467,13,0.43805555555555553,Document
TypeScript,2147,14725,1559.0651041666667,MERGED,5,15,2,0,1,123,False,0,0,0,1451,20,65.545,Feature
TypeScript,261,3765,762.8639699074074,MERGED,1,7,2,0,2,139,False,0,0,0,1522,8,2.4097222222222223,Document
TypeScript,2147,14725,1555.1845486111113,MERGED,0,2,1,0,1,793,False,0,0,0,767,2,13.974722222222223,Bug
TypeScript,261,3765,762.7111805555555,MERGED,801,40,9,0,2,1066,True,0,0,0,1455,841,0.48055555555555557,Document
TypeScript,2147,14725,1557.8541435185186,MERGED,11,140,2,0,1,798,False,0,0,0,1401,151,120.84027777777777,Feature
TypeScript,85,724,397.98869212962967,MERGED,1,1,1,0,1,61,False,0,0,0,1202,2,0.31444444444444447,Document
Vue,293,495,917.9627430555556,MERGED,1,1,4,5,2,426,False,0,5,4,773,2,2.562222222222222,Bug
TypeScript,12,11,1075.3753935185184,MERGED,126,768,16,1,7,84,False,1,0,0,2189,894,166.67416666666668,Feature
TypeScript,12,11,1074.494363425926,MERGED,0,145,2,0,2,83,False,0,0,0,1701,145,17.461666666666666,Feature
TypeScript,2147,14725,1557.8964930555555,MERGED,16,18,4,0,1,799,False,0,0,0,1401,34,98.87166666666667,Feature
TypeScript,2147,14725,1557.8468981481483,MERGED,119,129,3,0,1,65,False,0,0,0,1688,248,95.7761111111111,Feature
TypeScript,261,3765,761.7732060185185,MERGED,104,1438,49,0,11,71,False,0,0,0,1430,1542,23.811944444444446,Document
Go,421,1654,1594.891574074074,CLOSED,1,1,1,2,1,0,False,1,1,1,980,2,1.1922222222222223,Bug
TypeScript,261,3765,761.7853356481481,MERGED,363,77399,490,0,5,138,False,0,0,0,1154,77762,19.25777777777778,Document
PHP,1334,2960,4293.035,MERGED,1,1,1,5,1,0,False,1,4,3,1494,2,260.5213888888889,Document
TypeScript,202,107,1227.4370601851851,MERGED,1,1,1,3,2,296,True,0,3,3,546,2,22.932777777777776,Bug
Go,421,1654,1593.1514236111109,MERGED,1,5,1,0,1,253,False,0,0,0,820,6,44.31027777777778,Bug
Python,547,7161,2324.437337962963,MERGED,1,1,1,0,2,249,False,0,0,0,738,2,2.866388888888889,Document
JavaScript,5140,7051,1287.109085648148,MERGED,0,1,1,2,1,139,False,1,1,1,656,1,0.175,Document
Rust,3809,5430,529.2391435185185,CLOSED,0,6,2,0,1,198,False,0,0,0,215,6,0.034166666666666665,Feature
TypeScript,85,724,401.0455555555556,MERGED,2,18,3,0,2,133,False,0,0,0,1579,20,0.041666666666666664,Document
V,2097,34362,1638.6499884259258,MERGED,2,58,2,3,4,66,True,0,3,2,628,60,9.918611111111112,Bug
TypeScript,261,3765,760.828923611111,MERGED,1,8,2,0,4,268,False,0,0,0,1399,9,0.4891666666666667,Document
TypeScript,261,3765,760.7747916666667,MERGED,7,24,4,0,4,237,True,0,0,0,1372,31,3.4530555555555558,Document
TypeScript,261,3765,760.7517592592593,MERGED,0,10,2,0,1,298,True,0,0,0,1339,10,4.4075,Document
TypeScript,85,724,400.91858796296293,MERGED,9,1,2,0,3,131,False,0,0,0,1450,10,1.2502777777777778,Document
TypeScript,85,724,400.8987268518519,MERGED,8,24,1,0,1,130,False,0,0,0,1346,32,1.123888888888889,Document
V,2097,34362,1640.7787384259261,MERGED,2,10,1,1,3,68,True,1,0,0,888,12,32.34638888888889,Feature
Python,547,7161,2323.82625,MERGED,2,1,1,0,2,154,False,0,0,0,856,3,0.30083333333333334,Bug
Go,421,1654,1597.037928240741,MERGED,1,1,1,0,1,512,True,0,0,0,1168,2,45.28805555555556,Document
TypeScript,202,107,1227.865775462963,MERGED,735,464,78,4,9,312,True,0,4,3,793,1199,163.33444444444444,Document
TypeScript,2147,14725,1558.2436921296296,MERGED,7,58,4,0,1,326,False,0,0,0,2075,65,181.49083333333334,Feature
TypeScript,85,724,402.23658564814815,MERGED,10,250,10,0,7,69,False,0,0,0,2773,260,112.49333333333334,Document
Vue,293,495,919.094224537037,MERGED,0,82,2,5,1,431,False,0,5,4,902,82,0.18416666666666667,Bug
Vue,293,495,919.0679166666667,MERGED,0,65,2,5,1,430,False,0,5,4,938,65,0.49972222222222223,Bug
Vue,293,495,919.0064467592592,MERGED,0,74,3,10,3,429,False,2,8,4,878,74,2.3141666666666665,Bug
TypeScript,261,3765,759.8914467592593,MERGED,1,7,2,0,1,236,True,0,0,0,1526,8,0.4111111111111111,Document
TypeScript,85,724,399.9040046296296,MERGED,0,198,2,0,2,121,False,0,0,0,1698,198,5.073333333333333,Document
TypeScript,85,724,399.2998611111111,MERGED,2,2,1,3,1,0,False,2,1,1,1449,4,40.42444444444445,Document
C++,2234,23696,2440.899467592593,MERGED,3,0,1,1,1,29,False,0,1,1,883,3,18.06972222222222,Bug
Vue,293,495,918.5441782407407,MERGED,6,11,2,9,2,428,False,2,7,5,799,17,13.090833333333334,Bug
PHP,1334,2960,4293.252048611111,CLOSED,1,1,1,3,1,0,False,0,3,3,1844,2,330.6691666666667,Document
Vue,293,495,918.0245833333333,MERGED,0,38,5,9,4,4,False,1,8,5,1126,38,1.1330555555555555,Bug
Vue,10811,21164,1110.1001967592592,MERGED,3,8,1,2,2,3,False,0,2,2,1216,11,114.46138888888889,Bug
TypeScript,85,724,399.04586805555556,MERGED,1,3,2,0,1,64,False,0,0,0,1333,4,23.095833333333335,Document
TypeScript,261,3765,762.8000231481482,CLOSED,1,13,3,0,1,44,False,0,0,0,2002,14,237.23777777777778,Document
TypeScript,85,724,401.94761574074073,MERGED,5,14,3,0,1,206,False,0,0,0,2032,19,73.5,Document
Go,752,2399,812.7010763888889,MERGED,0,2,1,0,1,179,False,0,0,0,744,2,0.04527777777777778,Bug
Go,752,2399,812.6808564814814,MERGED,0,2,1,0,1,177,False,0,0,0,744,2,0.7766666666666666,Bug
Go,752,2399,812.6835300925926,MERGED,0,2,1,0,1,178,False,0,0,0,744,2,0.46194444444444444,Bug
TypeScript,261,3765,761.8943518518519,MERGED,1,8,2,0,1,53,False,0,0,0,1209,9,1.4233333333333333,Document
Vue,293,495,918.0752662037038,MERGED,7,140,3,8,3,427,False,1,7,4,925,147,0.4602777777777778,Bug
Vue,10811,21164,1109.7800578703702,CLOSED,2,2,1,2,3,0,False,0,2,2,1371,4,101.40194444444444,Bug
TypeScript,85,724,399.0041087962963,MERGED,0,43,1,0,1,119,False,0,0,0,1583,43,0.2175,Document
TypeScript,261,3765,758.7342708333334,MERGED,1,33,4,0,2,43,False,0,0,0,1630,34,2.238611111111111,Document
Java,450,746,4155.045312499999,MERGED,0,1,1,1,2,94,True,0,1,1,586,1,0.05722222222222222,Bug
TypeScript,261,3765,762.7235416666667,MERGED,8,100,4,0,1,1067,True,0,0,0,1633,108,0.1775,Document
TypeScript,261,3765,762.6786689814816,MERGED,6,5,3,0,1,1065,True,0,0,0,1835,11,0.4577777777777778,Document
TypeScript,202,107,1230.983622685185,CLOSED,180,740,5,3,10,1,False,0,3,3,1687,920,467.0755555555556,Bug
Python,547,7161,2319.7663425925925,CLOSED,4,10,2,0,5,629,True,0,0,0,656,14,136.0225,Bug
TypeScript,7,6,729.880011574074,MERGED,4,4,1,0,4,304,False,0,0,0,935,8,1.5741666666666667,Feature
TypeScript,85,724,401.1140972222222,MERGED,10,31,6,0,4,68,False,0,0,0,2284,41,23.522222222222222,Document
TypeScript,7,6,730.1332175925926,MERGED,61,35,18,0,3,317,False,0,0,0,177,96,93.5111111111111,Feature
Go,395,660,1348.0411805555557,MERGED,2076,1283,64,2,39,146,False,2,0,0,164,3359,524.2613888888889,Feature
Go,30,295,432.0936111111111,MERGED,3,3,3,1,1,110,True,0,1,1,1606,6,0.12666666666666668,Feature
Vue,293,495,916.5762847222222,MERGED,1,4,1,4,1,3,False,0,4,3,1043,5,14.004166666666666,Document
Go,421,1654,1590.9008449074074,MERGED,3,0,1,0,1,14,False,0,0,0,1043,3,2.4963888888888888,Document
TypeScript,85,724,398.24922453703704,MERGED,5,11,3,0,1,118,False,0,0,0,1477,16,0.23194444444444445,Document
TypeScript,2147,14725,1559.037337962963,CLOSED,0,0,0,0,0,8,False,0,0,0,2053,0,2.2936111111111113,Bug
TypeScript,2147,14725,1554.9413078703703,MERGED,2,3,1,0,1,790,False,0,0,0,1234,5,19.819166666666668,Bug
TypeScript,12,11,1074.305,MERGED,8,9,4,0,1,82,False,0,0,0,2212,17,0.5608333333333333,Bug
Python,72,25,1721.5147569444443,MERGED,0,33,2,0,1,51,False,0,0,0,1065,33,23.7625,Feature
TypeScript,2147,14725,1554.8940624999998,MERGED,4,13,2,0,1,789,False,0,0,0,1403,17,20.919722222222223,Bug
TypeScript,85,724,397.931099537037,MERGED,2,13,1,0,2,115,False,0,0,0,1411,15,0.08833333333333333,Document
Go,30,295,430.98651620370373,MERGED,0,1,1,0,1,109,True,0,0,0,1082,1,7.619722222222222,Feature
TypeScript,7,6,728.9669675925926,MERGED,1,1,1,0,1,257,False,0,0,0,865,2,2.6625,Bug
TypeScript,7046,76150,2712.6897453703705,MERGED,2,2,1,3,1,0,False,0,3,2,792,4,24.791944444444443,Document
TypeScript,7,6,728.8538541666667,MERGED,424,6,3,0,1,241,False,0,0,0,1140,430,0.5105555555555555,Document
TypeScript,261,3765,761.7369560185185,MERGED,6,7,3,0,2,278,True,0,0,0,1754,13,5.207222222222223,Document
JavaScript,5140,7051,1287.602199074074,MERGED,79,139,6,1,10,115,False,0,1,1,1480,218,213.6925,Document
V,2097,34362,1639.212048611111,MERGED,58,31,2,0,2,67,True,0,0,0,870,89,2.930277777777778,Bug
TypeScript,202,107,1232.9893055555556,MERGED,1,1,1,4,1,2,False,1,3,3,329,2,37.356944444444444,Bug
TypeScript,2147,14725,1557.7960648148148,MERGED,14,19,6,0,2,29,False,0,0,0,2116,33,6.736666666666666,Feature
TypeScript,202,107,1226.7205324074073,MERGED,1,1,1,3,2,295,True,0,3,3,656,2,40.15027777777778,Bug
JavaScript,5140,7051,1290.6090162037037,CLOSED,16,55,1,2,1,189,False,1,1,1,1903,71,0.04055555555555555,Bug
TypeScript,7,6,728.1061921296296,MERGED,23,5,3,0,5,262,False,0,0,0,1074,28,0.9891666666666666,Feature
V,2097,34362,1634.852662037037,MERGED,0,1,1,0,1,63,True,0,0,0,895,1,4.780277777777778,Document
Python,547,7161,2320.483344907407,MERGED,2,10,1,0,4,46,False,0,0,0,2432,12,5.429444444444444,Document
TypeScript,7,6,728.010763888889,MERGED,1,1,1,0,1,261,False,0,0,0,798,2,0.29888888888888887,Feature
Go,395,660,1350.9019907407408,MERGED,39,46,1,0,2,38,False,0,0,0,303,85,436.96527777777777,Bug
Python,547,7161,2323.61375,MERGED,1,1,1,0,2,40,False,0,0,0,952,2,21.955833333333334,Bug
C++,2234,23696,2439.928865740741,MERGED,1,327,3,1,1,302,False,0,1,1,892,328,94.00333333333333,Bug
TypeScript,261,3765,760.674224537037,MERGED,5,24,3,0,2,1061,True,0,0,0,1867,29,0.2725,Document
Vue,293,495,912.8162731481481,MERGED,0,83,5,12,6,1,False,2,10,6,1000,83,30.91777777777778,Bug
PHP,1334,2960,4292.001805555556,MERGED,4,19,2,1,2,889,False,0,1,1,1567,23,2.544722222222222,Bug
TypeScript,261,3765,760.6006828703704,MERGED,51,58,3,0,1,217,False,0,0,0,1856,109,1.235,Document
Python,547,7161,2323.6028819444446,MERGED,1,1,1,0,3,248,False,0,0,0,914,2,1.8597222222222223,Document
Vue,293,495,914.8935300925926,MERGED,0,7,1,5,1,2,False,0,5,3,978,7,2.426111111111111,Bug
Vue,10811,21164,1107.777974537037,CLOSED,0,1,1,1,1,0,False,0,1,1,1241,1,63.98027777777778,Bug
Vue,10811,21164,1104.3093171296296,MERGED,2,19,1,3,2,1,False,1,2,2,1288,21,263.87666666666667,Bug
Go,2083,11770,1606.8674074074072,MERGED,1,7,1,0,1,954,True,0,0,0,1170,8,0.13972222222222222,Document
Go,2083,11770,1606.8571875,MERGED,0,2,1,0,1,953,True,0,0,0,1006,2,0.01,Document
Vue,10811,21164,1108.121087962963,MERGED,2,2,1,0,1,202,False,0,0,0,1367,4,27.609166666666667,Bug
Python,547,7161,2323.051759259259,MERGED,0,1,1,0,1,320,True,0,0,0,850,1,12.200555555555555,Bug
Python,547,7161,2322.9865972222224,MERGED,3,3,1,0,12,246,False,0,0,0,738,6,9.9325,Document
Java,450,746,4158.036689814815,MERGED,2,3,1,1,1,169,False,0,1,1,1000,5,0.9730555555555556,Bug
TypeScript,58,78,907.1040509259259,MERGED,16,33,3,1,4,122,False,0,1,1,2203,49,98.18388888888889,Feature
Go,54,355,818.8675694444445,MERGED,1,1,1,1,1,31,False,0,1,1,116,2,2.8730555555555557,Document
Vue,10811,21164,1107.2886805555556,MERGED,0,11,2,0,1,201,False,0,0,0,1296,11,23.843333333333334,Document
Go,1174,11429,1926.998275462963,CLOSED,160,622,21,1,3,507,True,0,1,1,1787,782,118.07055555555556,Document
Python,547,7161,2324.652800925926,MERGED,3,16,1,0,8,41,False,0,0,0,1621,19,239.41444444444446,Bug
TypeScript,2147,14725,1555.1659375,MERGED,5,10,2,0,1,792,False,0,0,0,1962,15,14.44111111111111,Feature
TypeScript,261,3765,758.7607407407407,MERGED,5,14,3,0,1,1055,True,0,0,0,2082,19,0.2847222222222222,Document
TypeScript,85,724,397.9874189814814,MERGED,9,30,3,0,3,116,False,0,0,0,2411,39,0.91,Document
Python,547,7161,2321.6385185185186,MERGED,3,40,3,0,4,250,False,0,0,0,864,43,0.03666666666666667,Document
Vue,293,495,918.9018402777778,MERGED,7,8,3,7,2,3,False,2,5,4,1420,15,23.56277777777778,Bug
TypeScript,85,724,402.1222916666666,MERGED,118,147,1,0,1,207,False,0,0,0,3118,265,72.47777777777777,Document
JavaScript,5140,7051,1289.8528125,MERGED,21,444,13,2,6,347,False,1,1,1,2262,465,114.61083333333333,Feature
TypeScript,7,6,730.0261111111112,MERGED,92,197,3,0,8,305,False,0,0,0,1713,289,100.93638888888889,Feature
Vue,293,495,918.9865509259258,MERGED,0,53,2,5,1,8,False,0,5,4,1099,53,2.3094444444444444,Bug
Go,752,2399,810.6395486111111,CLOSED,0,8,1,0,1,82,False,0,0,0,1160,8,19.801944444444445,Bug
Vue,293,495,918.9514351851852,MERGED,0,83,2,5,4,7,False,0,5,4,1081,83,3.131666666666667,Bug
Go,752,2399,810.702337962963,MERGED,13,38,5,0,2,83,False,0,0,0,971,51,0.4486111111111111,Bug
Go,752,2399,810.7069444444445,MERGED,2,2,1,0,1,465,False,0,0,0,808,4,0.0275,Bug
Go,752,2399,810.7008101851852,MERGED,0,7,1,0,1,173,False,0,0,0,761,7,0.07944444444444444,Bug
Go,752,2399,810.6993287037036,MERGED,0,7,1,0,1,172,False,0,0,0,870,7,0.06555555555555556,Bug
Go,752,2399,810.6730555555555,MERGED,0,5,1,0,1,171,False,0,0,0,795,5,0.012777777777777779,Bug
Vue,293,495,918.625787037037,MERGED,11,32,2,6,3,6,False,0,6,5,1288,43,11.482777777777779,Bug
TypeScript,7,6,728.3013657407408,MERGED,29,24,3,0,6,53,True,0,0,0,327,53,3.3419444444444446,Bug
TypeScript,7,6,728.3029861111112,MERGED,60,17,6,0,4,312,False,0,0,0,250,77,2.2908333333333335,Bug
Vue,293,495,918.4902662037038,MERGED,1,1,1,6,1,5,False,0,6,5,1410,2,14.719166666666666,Bug
TypeScript,7,6,728.1843634259259,MERGED,1,3,1,0,1,309,False,0,0,0,247,4,0.28055555555555556,Bug
Go,421,1654,1590.453310185185,CLOSED,5,5,2,0,1,506,True,0,0,0,1068,10,12.788055555555555,Bug
Vue,293,495,911.9630671296296,MERGED,15,33,3,5,3,422,False,0,5,5,874,48,26.099166666666665,Bug
Go,421,1654,1593.2612962962965,MERGED,19,36,2,1,1,82,False,1,0,0,2136,55,43.52472222222222,Feature
PHP,883,2338,1918.0358101851853,CLOSED,0,5,1,2,1,16,False,0,2,2,2055,5,360.2816666666667,Document
JavaScript,9664,43890,3743.8156597222223,CLOSED,1,6,1,0,1,80,True,0,0,0,322,7,150.85,Feature
Go,752,2399,809.8713773148148,MERGED,0,3,1,0,1,81,False,0,0,0,780,3,0.025,Bug
Go,752,2399,809.8580787037037,MERGED,0,3,1,0,1,79,False,0,0,0,752,3,0.2538888888888889,Bug
TypeScript,2147,14725,1556.8472569444446,MERGED,52,67,2,0,1,796,False,0,0,0,3094,119,142.04333333333332,Bug
Go,752,2399,809.7595486111112,MERGED,0,14,2,0,1,77,False,0,0,0,1003,14,0.025277777777777777,Bug
Go,752,2399,809.5221643518518,MERGED,5,13,2,0,1,76,False,0,0,0,859,18,7.888055555555556,Bug
Go,752,2399,809.4754976851851,MERGED,5,59,2,0,6,168,False,0,0,0,1108,64,6.998611111111111,Bug
TypeScript,261,3765,761.7359027777778,MERGED,53,10,6,0,1,125,True,0,0,0,2622,63,18.198611111111113,Document
TypeScript,15,34,576.5066319444444,MERGED,1,2,1,0,1,1088,False,0,0,0,236,3,0.32083333333333336,Feature
Go,1174,11429,1927.8865856481482,CLOSED,577,1057,23,1,10,509,True,0,1,1,1627,1634,113.48361111111112,Document
Go,2083,11770,1602.759409722222,MERGED,1,1,1,0,1,949,True,0,0,0,1168,2,0.02666666666666667,Document
Go,395,660,1352.037962962963,MERGED,3,4,1,0,1,100,False,0,0,0,261,7,0.135,Bug
Vue,10811,21164,1106.3072453703703,MERGED,4,31,10,6,12,3,False,3,3,3,2715,35,550.0205555555556,Bug
TypeScript,261,3765,761.7335416666666,MERGED,5,33,4,0,2,269,False,0,0,0,2555,38,5.464722222222222,Document
TypeScript,261,3765,761.6850925925927,MERGED,75,18,11,0,1,1064,True,0,0,0,3009,93,0.3,Document
Go,421,1654,1591.3946643518518,MERGED,670,1033,26,0,7,80,False,0,0,0,690,1703,17.621944444444445,Bug
TypeScript,2147,14725,1557.8363657407408,MERGED,46,116,4,0,1,325,False,0,0,0,2565,162,2.770277777777778,Document
TypeScript,7,6,729.0940393518518,MERGED,93,118,6,1,2,315,False,0,1,1,317,211,4.064444444444445,Feature
TypeScript,261,3765,760.9523842592592,MERGED,0,153,8,0,1,1062,True,0,0,0,3068,153,13.946388888888889,Document
Go,421,1654,1597.046875,MERGED,15,16,4,0,1,514,True,0,0,0,2766,31,45.11361111111111,Bug
TypeScript,202,107,1229.1673726851852,MERGED,0,4,1,3,1,133,False,0,3,3,1481,4,127.4725,Document
TypeScript,202,107,1229.1618171296298,MERGED,0,9,1,3,2,132,False,0,3,3,1397,9,127.61444444444444,Document
Go,395,660,1348.103263888889,MERGED,15,24,2,1,1,87,False,1,0,0,256,39,187.6013888888889,Feature
JavaScript,5140,7051,1287.5033680555555,MERGED,25,332,12,4,15,279,False,1,3,2,3178,357,384.7158333333333,Feature
PHP,1334,2960,4290.104155092592,MERGED,1,1,1,1,1,96,False,0,1,1,1544,2,0.6883333333333334,Document
Go,395,660,1347.8882407407407,MERGED,7,2,2,0,1,145,False,0,0,0,203,9,190.6,Feature
TypeScript,7,6,728.471701388889,MERGED,44,102,9,0,9,56,True,0,0,0,1262,146,1.515,Feature
V,2097,34362,1634.9493287037037,MERGED,4,2,2,0,2,65,True,0,0,0,1445,6,2.688888888888889,Document
TypeScript,261,3765,760.6354976851852,MERGED,60,71,7,0,1,1060,True,0,0,0,2563,131,1.895,Document
TypeScript,261,3765,760.6510995370371,MERGED,4,19,4,0,1,124,True,0,0,0,2709,23,0.1388888888888889,Document
TypeScript,41369,87415,3024.666458333333,MERGED,1,1,1,2,2,3,False,0,2,2,1449,2,44.48888888888889,Document
TypeScript,7,6,727.9772685185185,MERGED,3,37,3,0,3,260,False,0,0,0,1151,40,0.7497222222222222,Feature
TypeScript,7,6,728.2854398148148,MERGED,12,12,4,0,1,311,False,0,0,0,436,24,0.03,Bug
TypeScript,261,3765,759.4854282407408,MERGED,23,36,8,0,3,1057,True,0,0,0,3285,59,1.0119444444444445,Document
JavaScript,9664,43890,3741.0735763888893,CLOSED,1,1,1,0,1,79,True,0,0,0,407,2,330.05833333333334,Bug
Go,1174,11429,1926.0614236111112,MERGED,14,9,4,1,2,679,True,0,1,1,1986,23,279.0552777777778,Document
TypeScript,2147,14725,1556.0512962962964,CLOSED,8,39,2,1,1,63,False,0,1,1,2803,47,15.78,Feature
Go,395,660,1349.930914351852,MERGED,2,7,1,0,2,147,False,0,0,0,412,9,360.5252777777778,Bug
TypeScript,7,6,727.1950694444445,MERGED,412,498,7,3,12,256,False,2,1,1,1581,910,22.535555555555554,Bug
Go,2083,11770,1607.3172106481481,MERGED,9,0,1,0,1,956,True,0,0,0,1200,9,0.10722222222222222,Document
Vue,293,495,914.8468402777777,MERGED,7,7,14,8,2,425,False,2,6,4,1083,14,3.0980555555555553,Bug
TypeScript,261,3765,759.7240046296297,MERGED,8,27,4,0,2,123,True,0,0,0,2361,35,0.20083333333333334,Document
Go,395,660,1347.8423842592592,MERGED,83,152,8,2,4,144,False,2,0,0,580,235,198.4975,Feature
TypeScript,7,6,727.0571296296297,MERGED,20,8,3,0,3,259,False,0,0,0,1650,28,1.2438888888888888,Feature
Vue,10811,21164,1107.3501388888888,CLOSED,4,4,2,1,3,2,False,0,1,1,1495,8,65.87333333333333,Bug
Java,450,746,4156.314224537037,MERGED,3,84,2,1,2,589,False,0,1,1,265,87,122.19055555555556,Bug
TypeScript,15,34,576.9167939814814,MERGED,1,6,1,0,1,80,False,0,0,0,330,7,0.9577777777777777,Feature
Vue,10811,21164,1105.718449074074,MERGED,1,7,2,0,1,200,False,0,0,0,1792,8,155.41805555555555,Bug
TypeScript,85,724,398.2836921296296,MERGED,2,74,2,0,1,62,False,0,0,0,3647,76,0.01361111111111111,Document
TypeScript,2147,14725,1554.9858217592591,MERGED,2,113,5,0,1,791,False,0,0,0,2882,115,18.944444444444443,Document
TypeScript,12,11,1073.3184259259258,MERGED,535,707,4,0,13,194,False,0,0,0,4408,1242,364.7238888888889,Feature
Go,752,2399,812.4892824074074,MERGED,18,39,2,0,1,176,False,0,0,0,1141,57,5.0311111111111115,Bug
TypeScript,15,34,576.5258564814815,MERGED,1,13,4,0,2,1089,False,0,0,0,241,14,1.4422222222222223,Document
Kotlin,164,4297,489.71716435185186,MERGED,1,3,1,0,1,24,False,0,0,0,399,4,0.6555555555555556,Bug
JavaScript,9664,43890,3741.4791898148146,MERGED,105,105,3,3,4,0,False,1,2,1,478,210,228.9038888888889,Feature
Go,395,660,1349.0916782407407,MERGED,0,16,1,0,1,355,False,0,0,0,217,16,0.09666666666666666,Feature
JavaScript,9664,43890,3744.118900462963,MERGED,541,35,2,0,1,35,False,0,0,0,428,576,68.94916666666667,Bug
Go,752,2399,812.4870486111112,MERGED,18,39,2,0,1,175,False,0,0,0,1126,57,0.17805555555555555,Bug
Go,752,2399,812.4558333333333,MERGED,18,39,2,0,1,174,False,0,0,0,1126,57,0.7486111111111111,Bug
TypeScript,85,724,397.87841435185186,MERGED,7,52,2,0,2,114,False,0,0,0,3032,59,0.09777777777777778,Document
TypeScript,261,3765,758.8431944444445,MERGED,20,76,6,0,2,1056,True,0,0,0,2656,96,2.3225,Document
TypeScript,1297,21107,500.0594212962963,MERGED,14,7,2,1,2,1227,True,0,1,1,1438,21,0.0475,Document
TypeScript,41369,87415,3024.613946759259,CLOSED,1,1,1,2,1,646,True,0,2,2,2035,2,0.645,Document
TypeScript,7,6,729.0639814814814,CLOSED,20,180,6,0,1,314,False,0,0,0,433,200,0.7083333333333334,Feature
TypeScript,202,107,1228.7044212962962,MERGED,23,25,1,3,1,299,True,0,3,3,1385,48,20.12361111111111,Bug
TypeScript,15,34,576.2347453703704,MERGED,7,1,1,0,2,532,True,0,0,0,333,8,0.9613888888888888,Feature
TypeScript,2070,16643,1327.6773726851852,MERGED,1,1,1,2,2,0,False,1,1,1,2181,2,540.8594444444444,Document
Go,1174,11429,1927.9826967592592,MERGED,2149,4379,21,0,1,681,True,0,0,0,1742,6528,67.15944444444445,Document
Go,1174,11429,1926.0598032407406,MERGED,8,15,1,0,4,146,True,0,0,0,1766,23,181.25972222222222,Document
TypeScript,15,34,575.648449074074,MERGED,1,74,5,0,13,79,False,0,0,0,317,75,30.0425,Feature
TypeScript,261,3765,758.5117361111111,MERGED,1,41,3,0,1,1054,True,0,0,0,2478,42,0.4255555555555556,Document
Vue,293,495,910.9926851851851,MERGED,235,861,12,14,14,421,False,3,11,5,1402,1096,148.11555555555555,Bug
TypeScript,1297,21107,504.7043171296296,CLOSED,0,4,1,1,1,1,False,0,1,1,1718,4,5.9591666666666665,Document
TypeScript,1297,21107,504.6983449074074,CLOSED,0,3,1,1,1,0,False,0,1,1,1746,3,6.105555555555555,Document
Vue,293,495,912.5286342592593,MERGED,12,86,4,10,7,423,False,3,7,5,1067,98,53.48277777777778,Bug
TypeScript,202,107,1228.481863425926,MERGED,1,336,3,3,1,298,True,0,3,3,1274,337,5.873888888888889,Feature
Python,19251,70267,2543.392986111111,CLOSED,15,1,2,3,2,1650,False,3,0,0,360,16,4.321944444444444,Feature
TypeScript,202,107,1227.860138888889,CLOSED,17,39,1,3,1,19,True,1,2,2,1779,56,0.5986111111111111,Document
Go,1174,11429,1925.9526041666668,MERGED,3,3,3,1,1,473,True,1,0,0,1996,6,120.265,Document
TypeScript,2070,16643,1326.1158333333333,MERGED,3,3,1,0,2,2,False,0,0,0,2604,6,578.5780555555556,Document
TypeScript,15,34,575.474212962963,MERGED,506,12,12,0,1,164,False,0,0,0,409,518,141.34333333333333,Feature
TypeScript,7,6,730.2087152777777,MERGED,7,44,3,2,2,318,False,0,2,1,2000,51,2.323611111111111,Feature
Go,1174,11429,1925.9036458333333,MERGED,170,185,12,0,3,504,True,0,0,0,1994,355,111.93916666666667,Document
Go,1174,11429,1925.8690162037037,MERGED,284,276,15,1,4,503,True,0,1,1,1837,560,112.83777777777777,Document
Go,421,1654,1593.1022800925928,MERGED,4,5,3,0,1,121,False,0,0,0,2913,9,66.82638888888889,Document
TypeScript,307,2556,622.7198263888889,MERGED,41,32,2,1,2,25,True,0,1,1,933,73,1.801388888888889,Bug
V,2097,34362,1640.1003935185183,MERGED,12,21,1,2,1,0,False,1,1,1,2365,33,14.051111111111112,Feature
Go,395,660,1350.4762152777778,MERGED,17,54,1,0,2,98,False,0,0,0,326,71,9.740833333333333,Feature
TypeScript,15,34,574.5116203703703,MERGED,2,2,1,0,3,163,False,0,0,0,325,4,18.183611111111112,Feature
TypeScript,2070,16643,1324.8666319444444,MERGED,1,1,1,0,1,0,False,0,0,0,2456,2,610.8208333333333,Bug
TypeScript,7,6,727.1285185185185,CLOSED,4844,5268,83,2,1,307,False,0,2,1,520,10112,25.518055555555556,Bug
TypeScript,307,2556,621.8559837962963,MERGED,0,6,2,1,1,32,False,0,1,1,1274,6,19.379722222222224,Bug
TypeScript,1297,21107,503.2806944444444,CLOSED,2,2,1,2,1,0,False,0,2,2,1812,4,6.061944444444444,Document
Go,30,295,433.11730324074074,MERGED,1,110,2,0,2,111,True,0,0,0,2648,111,0.5108333333333334,Bug
TypeScript,15,34,574.0756481481482,MERGED,106,121,9,2,5,1085,False,1,1,1,384,227,14.579444444444444,Bug
Go,1174,11429,1926.0662615740741,MERGED,16,16,8,0,2,680,True,0,0,0,1909,32,43.753055555555555,Document
Go,1174,11429,1926.7137731481482,MERGED,17,3,4,1,1,399,True,1,0,0,1883,20,0.17916666666666667,Document
Go,1174,11429,1926.6465162037036,CLOSED,51,512,12,0,3,398,True,0,0,0,1909,563,0.21666666666666667,Document
Go,752,2399,809.8592129629629,MERGED,5,13,2,0,1,80,False,0,0,0,1160,18,0.009444444444444445,Bug
JavaScript,9664,43890,3739.852638888889,MERGED,11,11,2,0,1,77,True,0,0,0,368,22,0.2575,Bug
Go,752,2399,809.7475231481482,MERGED,13,8,1,0,1,169,False,0,0,0,1192,21,0.06194444444444445,Bug
Vue,10811,21164,1108.8427199074074,CLOSED,14,14,2,3,3,0,False,1,2,2,1072,28,174.96027777777778,Document
TypeScript,15,34,573.7882638888889,CLOSED,4,10,1,0,1,378,False,0,0,0,314,14,0.6994444444444444,Bug
TypeScript,15,34,573.2890046296296,MERGED,37,51,6,2,5,530,True,0,2,2,420,88,25.85361111111111,Feature
Go,395,660,1349.212638888889,MERGED,24,35,1,0,2,97,False,0,0,0,243,59,0.3333333333333333,Bug
Go,421,1654,1591.0816782407408,CLOSED,14,72,3,0,2,507,True,0,0,0,3498,86,571.8077777777778,Bug
TypeScript,7,6,728.4759259259259,MERGED,10,16,2,0,7,303,False,0,0,0,1953,26,1.646388888888889,Feature
TypeScript,7,6,728.4305671296296,MERGED,19,71,7,0,7,302,False,0,0,0,2100,90,1.3066666666666666,Feature
Go,1174,11429,1925.9432986111112,MERGED,4,4,1,1,1,472,True,1,0,0,1693,8,0.13694444444444445,Document
TypeScript,7,6,728.4052777777778,MERGED,7,42,5,0,7,54,True,0,0,0,2478,49,1.5138888888888888,Feature
Go,1174,11429,1925.8817824074074,MERGED,237,1347,4,2,2,396,True,2,0,0,1934,1584,1.9136111111111112,Document
TypeScript,15,34,575.4974884259259,MERGED,1,1,1,0,1,165,False,0,0,0,441,2,22.595277777777778,Feature
Go,1174,11429,1925.866527777778,MERGED,1,1,1,0,1,90,False,0,0,0,1793,2,0.07944444444444444,Document
TypeScript,202,107,1230.7860300925925,MERGED,4,15,2,2,1,315,True,0,2,2,2199,19,1.84,Document
Go,1174,11429,1925.8466087962963,MERGED,1,5,2,1,1,148,True,1,0,0,1821,6,0.04083333333333333,Document
JavaScript,9664,43890,3742.4824652777775,MERGED,4,4,2,0,4,0,False,0,0,0,576,8,180.72833333333332,Feature
TypeScript,41369,87415,3024.935127314815,MERGED,5,9,3,1,1,147,True,0,1,1,2339,14,37.35527777777778,Document
Go,1174,11429,1925.8030439814813,MERGED,0,2,1,1,1,0,False,1,0,0,1661,2,0.20305555555555554,Document
TypeScript,15,34,572.4177199074074,MERGED,88,97,12,0,1,376,False,0,0,0,339,185,46.19722222222222,Feature
Go,1174,11429,1925.7298148148147,MERGED,97,118,4,4,1,395,True,2,2,1,1939,215,0.4938888888888889,Document
Vue,10811,21164,1103.7536921296296,MERGED,27,27,2,2,2,198,False,1,1,1,2192,54,33.41777777777778,Document
TypeScript,41369,87415,3025.4044675925925,MERGED,2592,4842,136,1,26,148,True,0,1,1,1914,7434,0.5330555555555555,Document
Python,547,7161,2321.4997916666666,MERGED,2,5,1,1,8,107,False,1,0,0,1929,7,147.50694444444446,Bug
TypeScript,7,6,728.1430555555556,MERGED,10,30,6,1,6,52,True,0,1,1,2266,40,1.2241666666666666,Feature
JavaScript,5140,7051,1287.7496296296297,MERGED,84,569,10,2,16,108,False,1,1,1,3202,653,46.9975,Feature
TypeScript,41369,87415,3025.9287268518515,MERGED,3,3,2,2,1,1,False,0,2,2,2382,6,20.17972222222222,Document
TypeScript,15,34,572.582349537037,MERGED,1,9,1,0,1,1080,False,0,0,0,450,10,20.938333333333333,Bug
JavaScript,9664,43890,3741.3209606481482,MERGED,8,67,5,0,1,652,False,0,0,0,404,75,0.05472222222222222,Feature
JavaScript,5140,7051,1286.8304976851853,MERGED,40,301,29,2,10,111,False,1,1,1,2884,341,91.22166666666666,Feature
TypeScript,85,724,400.98304398148144,MERGED,33,75,3,0,5,122,False,0,0,0,5420,108,121.50361111111111,Document
V,2097,34362,1633.7117592592592,MERGED,4,0,1,5,1,62,True,1,4,2,1916,4,18.60638888888889,Document
TypeScript,15,34,575.0988425925926,MERGED,407,227,36,0,1,1086,False,0,0,0,458,634,8.22861111111111,Document
JavaScript,9664,43890,3740.828518518518,MERGED,16,0,3,0,1,336,True,0,0,0,494,16,0.18305555555555555,Feature
Go,1174,11429,1924.7767361111112,MERGED,13,28,2,1,2,382,True,0,1,1,1750,41,3.700833333333333,Document
TypeScript,58,78,906.2329166666667,MERGED,4,16,2,1,1,121,False,0,1,1,3461,20,2.7688888888888887,Feature
C++,2234,23696,2442.3601388888887,MERGED,3,5,2,1,2,11,False,0,1,1,796,8,4.279722222222222,Feature
PHP,883,2338,1913.1356828703704,CLOSED,1,21,3,5,1,6,False,2,3,2,2245,22,207.42944444444444,Document
TypeScript,3706,54077,1442.8884722222222,MERGED,1,0,1,0,1,183,True,0,0,0,509,1,55.63722222222222,Feature
TypeScript,202,107,1229.0037731481482,MERGED,1,14,1,3,1,313,True,0,3,3,2507,15,12.915555555555555,Document
TypeScript,202,107,1228.8355671296297,MERGED,26,63,1,3,3,17,True,0,3,3,2381,89,16.965,Document
TypeScript,15,34,576.3715972222222,MERGED,3554,10638,8,0,1,205,False,0,0,0,571,14192,86.84333333333333,Feature
TypeScript,15,34,573.4306018518519,MERGED,57,331,11,0,7,531,True,0,0,0,525,388,31.936944444444446,Feature
TypeScript,41369,87415,3023.626793981481,MERGED,0,1,1,2,2,55,False,0,2,2,2111,1,3.4744444444444444,Document
V,2097,34362,1636.267025462963,MERGED,1,1,1,0,1,4,False,0,0,0,1799,2,21.945833333333333,Document
TypeScript,15,34,573.814699074074,MERGED,2,15,2,0,1,1084,False,0,0,0,364,17,0.37916666666666665,Bug
Go,1174,11429,1923.799050925926,MERGED,1,3,1,1,1,393,True,1,0,0,1860,4,0.13166666666666665,Document
Go,395,660,1349.243912037037,CLOSED,2426,951,48,0,15,1,False,0,0,0,630,3377,239.94916666666666,Feature
Go,1174,11429,1923.6844444444444,MERGED,46,0,2,1,1,1049,True,1,0,0,1729,46,1.6322222222222222,Document
TypeScript,15,34,573.6339351851851,MERGED,50,47,1,0,8,1083,False,0,0,0,442,97,1.3644444444444443,Document
TypeScript,41369,87415,3022.95275462963,MERGED,93,96,3,5,6,145,True,2,3,2,2116,189,18.48638888888889,Document
TypeScript,15,34,572.3163541666667,MERGED,17,114,3,1,7,529,True,0,1,1,458,131,65.29138888888889,Feature
TypeScript,85,724,400.04356481481483,MERGED,3,179,8,1,11,67,False,1,0,0,4401,182,49.28944444444444,Document
TypeScript,202,107,1227.8059837962962,MERGED,43,35,5,3,2,74,True,0,3,3,2611,78,22.116944444444446,Document
TypeScript,15,34,572.6044791666667,CLOSED,4,169,3,0,2,1081,False,0,0,0,734,173,603.1291666666667,Bug
TypeScript,41369,87415,3022.677025462963,MERGED,19,11,2,2,1,1660,True,0,2,2,2291,30,0.6436111111111111,Document
TypeScript,85,724,400.37042824074075,MERGED,12,157,3,0,1,19,False,0,0,0,4208,169,12.104166666666666,Document
Python,14534,41196,1171.834224537037,MERGED,1,1,1,0,1,1438,True,0,0,0,783,2,0.10472222222222222,Document
Go,1174,11429,1927.1064930555556,CLOSED,1,1,1,0,1,231,False,0,0,0,2073,2,162.055,Document
Vue,10811,21164,1105.8833796296296,CLOSED,0,0,0,4,0,1,False,2,2,2,2018,0,35.08361111111111,Bug
C#,80,125,904.8763888888889,MERGED,4,3,1,0,1,212,True,0,0,0,657,7,38.42,Document
TypeScript,261,3765,761.5168287037037,MERGED,37,153,6,0,1,1063,True,0,0,0,3368,190,0.31222222222222223,Document
TypeScript,261,3765,761.4994328703705,MERGED,73,262,17,0,1,218,False,0,0,0,4084,335,0.6702777777777778,Document
TypeScript,307,2556,622.6842708333334,MERGED,5,17,3,1,2,33,False,0,1,1,1960,22,0.7741666666666667,Bug
TypeScript,41369,87415,3021.9438541666664,MERGED,144,671,11,2,24,1656,True,0,2,2,1922,815,12.701666666666666,Document
TypeScript,85,724,399.9936111111111,MERGED,139,0,6,0,1,66,False,0,0,0,4152,139,0.015,Document
TypeScript,261,3765,760.839849537037,MERGED,5,68,5,3,6,0,False,1,2,1,3154,73,20.254444444444445,Document
Go,752,2399,810.5325231481482,MERGED,0,5,1,0,4,170,False,0,0,0,1744,5,3.3455555555555554,Bug
Go,1174,11429,1927.7621990740743,MERGED,9,27,2,7,1,476,True,3,4,2,2541,36,1.183888888888889,Document
TypeScript,7,6,730.0261574074075,MERGED,54,55,11,0,3,316,False,0,0,0,773,109,101.0411111111111,Feature
Go,421,1654,1595.9567476851853,CLOSED,1,42,4,0,2,511,True,0,0,0,3854,43,26.18611111111111,Bug
Go,1174,11429,1926.9967824074074,MERGED,145,99,9,0,1,506,True,0,0,0,2289,244,85.69972222222222,Document
TypeScript,85,724,398.96256944444445,MERGED,3,39,3,0,1,63,False,0,0,0,3761,42,0.2677777777777778,Document
TypeScript,41369,87415,3020.8195833333334,MERGED,572,1071,61,3,2,525,True,1,2,2,2203,1643,6.957222222222223,Document
HTML,11813,87660,240.87146990740743,CLOSED,0,2,1,1,1,0,False,0,1,1,993,2,663.3772222222223,Feature
JavaScript,5140,7051,1290.5764814814816,MERGED,34,570,14,2,7,281,False,1,1,1,4194,604,100.15694444444445,Feature
TypeScript,261,3765,759.5573726851852,MERGED,0,50,5,0,2,267,False,0,0,0,3725,50,3.2,Document
C#,80,125,902.5898263888889,MERGED,4,34,2,0,4,210,True,0,0,0,620,38,49.375,Document
TypeScript,261,3765,759.5237962962964,MERGED,12,36,9,0,3,1058,True,0,0,0,3904,48,0.7794444444444445,Document
TypeScript,7,6,730.0960300925926,CLOSED,3,13,3,1,3,57,True,0,1,1,2941,16,2.7288888888888887,Feature
Go,1174,11429,1927.7323495370372,MERGED,0,4,1,1,1,508,True,1,0,0,2124,4,3.3669444444444445,Document
Go,1174,11429,1927.680636574074,CLOSED,1,3,1,0,1,400,True,0,0,0,2165,4,3.17,Document
Go,752,2399,810.4901273148148,MERGED,6,8,1,0,4,464,False,0,0,0,587,14,3.3080555555555557,Bug
TypeScript,15,34,574.3136689814816,MERGED,15,340,18,0,7,204,False,0,0,0,923,355,334.0802777777778,Feature
TypeScript,41369,87415,3022.725,MERGED,1163,1353,12,27,7,0,False,11,16,7,2323,2516,266.22277777777776,Document
JavaScript,9664,43890,3740.011157407407,MERGED,0,1,1,0,1,78,True,0,0,0,625,1,0.12805555555555556,Bug
TypeScript,15,34,573.3246527777777,MERGED,21,124,9,0,7,377,False,0,0,0,611,145,30.7475,Feature
Go,1174,11429,1926.9788425925926,MERGED,22,64,5,2,1,475,True,2,0,0,2755,86,0.4841666666666667,Document
Go,1174,11429,1926.8388888888887,MERGED,1,2,2,1,1,149,True,0,1,1,2639,3,4.093055555555556,Document
TypeScript,261,3765,758.4942361111111,MERGED,29,44,6,0,4,121,True,0,0,0,3222,73,4.0472222222222225,Document
Go,1174,11429,1926.6765046296296,CLOSED,2,2,1,0,1,505,True,0,0,0,2193,4,3.154166666666667,Document
TypeScript,1297,21107,503.0144675925926,MERGED,25,220,7,1,2,1242,True,0,1,1,3061,245,0.02666666666666667,Document
TypeScript,1297,21107,502.95837962962963,MERGED,53,21,9,3,3,1241,True,0,3,1,2548,74,0.38305555555555554,Document
Go,1174,11429,1926.5621296296297,CLOSED,114,133,7,0,2,383,True,0,0,0,2145,247,3.7080555555555557,Document
Java,450,746,4159.331041666667,CLOSED,1,1,1,0,1,22,False,0,0,0,940,2,63.84388888888889,Bug
TypeScript,41369,87415,3025.684201388889,MERGED,6,15,3,1,3,154,True,0,1,1,3151,21,26.03472222222222,Document
TypeScript,41369,87415,3025.675625,MERGED,0,1,1,1,2,153,True,0,1,1,2899,1,26.246666666666666,Document
Go,1174,11429,1926.0219328703704,MERGED,134,138,9,2,1,474,True,1,1,1,2435,272,16.05,Document
JavaScript,5140,7051,1288.6244791666666,MERGED,30,71,30,4,5,280,False,2,2,2,4111,101,120.86527777777778,Bug
TypeScript,7,6,728.4315972222222,MERGED,4,34,4,0,4,55,True,0,0,0,2850,38,0.9552777777777778,Feature
TypeScript,41369,87415,3023.7519907407404,MERGED,1,4,4,4,3,43,False,0,4,4,2925,5,114.27916666666667,Document
TypeScript,41369,87415,3025.012407407407,MERGED,0,150,2,2,1,1666,True,0,2,2,2441,150,33.78138888888889,Document
Go,1174,11429,1925.6844097222222,MERGED,1,70980,15,1,1,394,True,1,0,0,2046,70981,0.20027777777777778,Document
TypeScript,3393,2334,1054.0806597222222,MERGED,3,3,1,1,2,387,False,0,1,1,1030,6,0.11277777777777778,Feature
TypeScript,41369,87415,3024.6375810185186,MERGED,0,1,1,2,1,46,False,0,2,2,2336,1,44.79944444444445,Document
Go,752,2399,813.7163657407408,MERGED,33,69,2,0,1,310,False,0,0,0,2851,102,2.417222222222222,Bug
Go,1174,11429,1924.9547337962965,MERGED,14,37,4,1,2,147,True,1,0,0,2053,51,18.745833333333334,Document
TypeScript,202,107,1230.6619328703703,MERGED,2,2,2,2,1,0,False,0,2,2,1016,4,4.832222222222223,Document
Go,1174,11429,1924.970798611111,MERGED,328,347,5,0,1,134,True,0,0,0,2770,675,6.093333333333334,Document
TypeScript,41369,87415,3023.7597453703706,MERGED,0,57,3,2,5,1665,True,0,2,2,2776,57,64.84694444444445,Document
JavaScript,5140,7051,1288.5459027777777,MERGED,184,102,8,3,4,94,False,2,1,1,4863,286,47.98361111111111,Feature
TypeScript,2070,16643,1325.3018518518518,MERGED,0,38,1,0,2,7,False,0,0,0,2591,38,21.676388888888887,Document
Go,1174,11429,1924.696458333333,CLOSED,0,1,1,1,1,381,True,1,0,0,2148,1,6.3875,Document
V,2097,34362,1637.373101851852,MERGED,8,67,2,0,11,1,False,0,0,0,2634,75,10.636666666666667,Document
Go,1174,11429,1923.8086342592594,MERGED,54,30,7,1,1,468,True,1,0,0,2209,84,45.73555555555556,Document
JavaScript,5140,7051,1287.630173611111,MERGED,21,926,11,2,11,344,False,1,1,1,3751,947,71.12416666666667,Bug
TypeScript,2070,16643,1325.1967476851853,MERGED,2,2,2,0,1,0,False,0,0,0,2793,4,0.095,Document
TypeScript,41369,87415,3023.734398148148,MERGED,2,1,1,4,1,1962,True,1,3,3,2401,3,3.6905555555555556,Document
TypeScript,41369,87415,3023.7203125,MERGED,11,18,1,2,2,526,True,0,2,2,2743,29,0.625,Document
V,2097,34362,1636.460300925926,MERGED,3,24,7,0,1,233,True,0,0,0,2798,27,18.709722222222222,Document
Go,1174,11429,1923.8214699074076,MERGED,106,47,15,5,1,469,True,2,3,2,2276,153,1.793611111111111,Document
Go,1174,11429,1923.7469444444444,MERGED,6,9,2,1,1,392,True,1,0,0,2536,15,4.115555555555556,Document
Go,1174,11429,1923.7659490740741,MERGED,5,2,1,1,1,184,True,1,0,0,2351,7,1.4761111111111112,Document
Go,1174,11429,1923.709525462963,MERGED,0,35,1,1,2,146,True,1,0,0,2506,35,2.930277777777778,Document
Go,421,1654,1591.091087962963,MERGED,17,26,6,0,3,508,True,0,0,0,3702,43,20.67888888888889,Bug
Erlang,2054,12122,3882.1430555555557,MERGED,3,5,4,0,2,1041,True,0,0,0,1318,8,378.675,Document
TypeScript,2070,16643,1324.3130324074075,MERGED,1,6,2,0,2,2,False,0,0,0,2336,7,1.1244444444444444,Bug
Rust,433,2229,320.6059375,MERGED,62,122,4,1,1,1151,False,1,0,0,797,184,3.14,Feature
TypeScript,2070,16643,1324.288310185185,CLOSED,1,1,1,0,5,1,False,0,0,0,2376,2,0.5075,Bug
TypeScript,2070,16643,1324.2816319444444,CLOSED,1,1,1,0,2,0,False,0,0,0,2366,2,0.06666666666666667,Bug
TypeScript,2147,14725,1556.0562268518518,MERGED,62,271,15,0,1,794,False,0,0,0,8011,333,163.95555555555555,Document
TypeScript,41369,87415,3022.751111111111,MERGED,0,2,2,6,3,54,False,2,4,4,2675,2,24.750833333333333,Document
Python,137,75,769.3958449074074,MERGED,0,656,9,0,26,6,False,0,0,0,1480,656,455.1791666666667,Document
TypeScript,4,33,847.0941550925926,MERGED,1,1,1,2,1,278,True,1,1,1,977,2,0.05611111111111111,Bug
TypeScript,41369,87415,3022.9598958333336,MERGED,1,1,1,1,1,146,True,0,1,1,2207,2,0.8222222222222222,Document
Go,2083,11770,1605.3263773148149,MERGED,61,101,10,2,5,952,True,1,1,1,2469,162,20.84111111111111,Document
Vue,10811,21164,1106.0260532407408,MERGED,5,228,5,0,4,151,True,0,0,0,2957,233,49.43694444444444,Document
TypeScript,41369,87415,3022.6658449074075,CLOSED,0,3,1,5,1,53,False,1,4,3,2135,3,4.2925,Document
TypeScript,41369,87415,3022.650891203704,MERGED,4,7,1,2,2,43,False,0,2,2,2901,11,5.047777777777778,Document
TypeScript,41369,87415,3022.6955902777777,MERGED,3,2,1,2,2,1661,True,0,2,2,2251,5,0.8972222222222223,Document
TypeScript,41369,87415,3022.664560185185,MERGED,1,3,1,2,1,1961,True,0,2,2,2342,4,1.7083333333333333,Document
TypeScript,41369,87415,3022.6677430555555,MERGED,8,8,2,2,2,0,False,0,2,2,2711,16,1.4402777777777778,Document
TypeScript,41369,87415,3022.666087962963,MERGED,5,0,1,2,1,644,True,0,2,2,2136,5,1.5027777777777778,Document
TypeScript,41369,87415,3022.615868055556,MERGED,1,9,1,2,3,1960,True,0,2,2,2844,10,3.3594444444444442,Document
TypeScript,41369,87415,3022.4764699074076,MERGED,0,8,2,2,3,1657,True,0,2,2,2284,8,0.6205555555555555,Document
TypeScript,41369,87415,3022.431261574074,MERGED,0,5,1,2,3,642,True,0,2,2,2073,5,0.6808333333333333,Document
TypeScript,4,33,846.4044675925926,MERGED,1,1,1,1,1,685,True,0,1,1,1047,2,0.04138888888888889,Feature
C#,655,7879,1915.7800347222221,MERGED,51,107,9,0,6,697,True,0,0,0,2393,158,414.30333333333334,Document
Erlang,2054,12122,3882.2285069444442,MERGED,22,624,7,1,12,95,False,1,0,0,1166,646,313.1063888888889,Document
TypeScript,41369,87415,3019.7604976851853,MERGED,3,3,3,3,2,0,False,0,3,3,2799,6,6.048611111111111,Document
Vue,10811,21164,1105.2643518518519,CLOSED,4,153,4,0,1,199,False,0,0,0,2665,157,48.10138888888889,Document
TypeScript,15,34,576.7833101851852,MERGED,728,1595,54,0,30,379,False,0,0,0,1217,2323,475.7752777777778,Bug
TypeScript,85,724,401.96997685185187,MERGED,202,1289,27,0,15,27,False,0,0,0,5552,1491,241.00222222222223,Document
C#,655,7879,1913.0729976851853,CLOSED,0,82,4,1,2,620,True,1,0,0,1706,82,143.52166666666668,Document
TypeScript,3393,2334,1050.2650347222223,MERGED,3,3,1,2,1,508,False,0,2,1,1086,6,15.204722222222221,Feature
TypeScript,41369,87415,3021.6685185185183,MERGED,1,17,3,3,2,640,True,0,3,3,2746,18,1.3166666666666667,Document
TypeScript,3393,2334,1053.043726851852,CLOSED,1,3,2,2,1,285,False,0,2,1,1764,4,425.9825,Feature
Go,2083,11770,1604.2663425925928,MERGED,22,39,5,0,2,950,True,0,0,0,3392,61,0.5888888888888889,Document
TypeScript,41369,87415,3021.434016203704,MERGED,3,3,2,2,1,637,True,0,2,2,2292,6,0.8677777777777778,Document
TypeScript,41369,87415,3021.005011574074,MERGED,4,2347,70,1,12,1655,True,0,1,1,2901,2351,14.593333333333334,Document
TypeScript,41369,87415,3020.652349537037,MERGED,1,2,1,2,3,42,False,0,2,2,2451,3,45.03611111111111,Document
TypeScript,41369,87415,3020.9076620370374,MERGED,1,3,2,4,4,81,True,1,3,3,2743,4,16.80361111111111,Document
TypeScript,3393,2334,1054.2178935185186,MERGED,5,5,1,2,1,0,False,0,2,1,1561,10,136.96305555555554,Feature
C#,655,7879,1915.6275462962965,MERGED,189,486,5,4,3,89,False,0,4,3,1613,675,250.5197222222222,Document
TypeScript,15,34,572.463587962963,MERGED,106,155,18,0,9,162,False,0,0,0,930,261,64.74,Feature
Go,752,2399,809.7125578703703,MERGED,8,41,2,0,6,463,False,0,0,0,1160,49,0.5925,Bug
V,2097,34362,1633.4622685185186,MERGED,3,14,1,2,2,17,True,1,1,1,2138,17,24.625,Document
C#,655,7879,1909.8941666666667,MERGED,16,1,2,4,3,674,True,0,4,4,2200,17,626.2086111111112,Document
V,2097,34362,1632.6451388888888,MERGED,6,2,1,1,1,1,False,0,1,1,2054,8,47.95777777777778,Document
TypeScript,15,34,572.6817476851852,MERGED,18,19,5,0,2,1082,False,0,0,0,994,37,18.55027777777778,Document
TypeScript,12,11,1073.5761921296296,CLOSED,1444,7853,61,0,38,195,False,0,0,0,5892,9297,212.20944444444444,Bug
Starlark,440,286,578.3019328703704,MERGED,0,592,4,7,1,0,False,4,3,3,1383,592,83.14416666666666,Document
TypeScript,12,11,1073.0737152777776,MERGED,18,355,8,1,41,49,False,1,0,0,6638,373,222.4413888888889,Feature
C#,655,7879,1909.0649768518517,MERGED,1,1,1,0,1,673,True,0,0,0,2203,2,637.69,Document
V,2097,34362,1632.5947916666667,MERGED,1,23,3,0,1,232,True,0,0,0,2368,24,9.96,Document
Python,2409,12194,324.9261921296296,MERGED,12,11,1,6,5,0,False,2,4,2,1587,23,25.352777777777778,Feature
TypeScript,41369,87415,3019.4608680555557,MERGED,8,9,1,2,7,40,False,0,2,2,2507,17,4.471666666666667,Document
TypeScript,41369,87415,3019.4351620370367,MERGED,4,14,2,5,2,52,True,0,5,4,2144,18,1.2333333333333334,Document
TypeScript,3393,2334,1051.5236574074074,MERGED,4,4,1,2,1,0,False,0,2,1,1587,8,7.900833333333333,Feature
Go,789,5551,1127.0029166666666,MERGED,0,1,1,0,1,198,True,0,0,0,1685,1,74.88833333333334,Document
Python,2409,12194,328.0152199074074,MERGED,2,5,1,6,1,1,False,3,3,1,1427,7,22.65861111111111,Feature
JavaScript,22,26,1003.0120717592594,MERGED,3,14,2,0,1,34,True,0,0,0,1053,17,0.4338888888888889,Document
C#,655,7879,1915.2680439814815,MERGED,0,2,1,5,3,19,False,0,5,4,2233,2,159.47305555555556,Document
Python,137,75,772.0775,MERGED,4630,6,4,0,4,109,False,0,0,0,1232,4636,1.6602777777777777,Bug
TypeScript,4,33,844.436875,MERGED,454,586,61,1,25,413,True,0,1,1,1395,1040,45.57138888888889,Document
C#,655,7879,1914.7708217592592,MERGED,2,2,1,0,1,694,True,0,0,0,2265,4,253.71055555555554,Document
C#,655,7879,1914.7458796296296,MERGED,1,5,1,0,1,692,True,0,0,0,2354,6,5.913333333333333,Document
TypeScript,7,6,730.1831365740741,MERGED,138,71,9,0,2,58,True,0,0,0,5474,209,92.73944444444444,Feature
Erlang,2054,12122,3882.4020949074074,MERGED,1,1,1,1,1,434,False,0,1,1,1186,2,64.57166666666667,Document
TypeScript,261,3765,762.7881018518518,MERGED,2,1191,42,0,12,219,False,0,0,0,5591,1193,97.63333333333334,Document
Erlang,2054,12122,3881.8669328703704,MERGED,34,477,22,0,3,404,True,0,0,0,1484,511,68.26638888888888,Document
Python,137,75,770.2473263888888,MERGED,2,298,11,1,22,3,False,1,0,0,1955,300,523.8638888888889,Document
TypeScript,261,3765,762.7916782407407,MERGED,208,431,38,0,9,1068,True,0,0,0,5396,639,65.69916666666667,Document
TypeScript,3393,2334,1052.942800925926,MERGED,11,17,1,2,1,513,False,0,2,1,1589,28,167.8175,Feature
C#,655,7879,1913.9381018518518,MERGED,7,86,3,3,7,18,False,0,3,2,2287,93,205.38333333333333,Document
Erlang,2054,12122,3881.015023148148,MERGED,9,25,4,0,2,33,False,0,0,0,1492,34,68.18638888888889,Document
JavaScript,5140,7051,1290.935625,MERGED,21,498,14,2,5,0,False,1,1,1,4477,519,311.2894444444444,Feature
TypeScript,4,33,849.2768981481481,CLOSED,13,55,3,3,4,67,False,1,2,2,1128,68,90.98722222222223,Bug
Java,450,746,4154.991909722222,MERGED,721,1048,57,1,11,424,False,0,1,1,10590,1769,220.36388888888888,Bug
C#,655,7879,1913.7375694444445,MERGED,41,47,1,0,2,101,False,0,0,0,1999,88,190.28472222222223,Document
Erlang,2054,12122,3881.2662847222223,MERGED,5,73,9,0,2,34,False,0,0,0,1382,78,21.16611111111111,Document
V,2097,34362,1639.6405671296297,MERGED,3,3,1,0,1,0,False,0,0,0,1190,6,9.829166666666667,Feature
TypeScript,4,33,846.4480324074075,MERGED,1,1,1,1,2,688,True,0,1,1,1088,2,235.48361111111112,Document
C#,655,7879,1915.0255902777778,MERGED,9,477,6,2,1,695,True,0,2,2,2361,486,98.04305555555555,Document
Go,421,1654,1597.045138888889,MERGED,10,49,12,0,1,513,True,0,0,0,6664,59,45.15888888888889,Bug
C#,80,125,906.7750578703703,CLOSED,15252,18829,77,0,35,198,False,0,0,0,1273,34081,69.45861111111111,Document
C#,655,7879,1916.3938541666666,MERGED,3,1,1,1,1,698,True,0,1,1,2198,4,10.131944444444445,Document
C#,655,7879,1914.9655439814815,CLOSED,0,126,7,1,5,622,True,1,0,0,2052,126,98.125,Document
TypeScript,1297,21107,503.64578703703705,MERGED,32,198,10,1,3,1246,True,0,1,1,4460,230,1.6913888888888888,Document
Python,137,75,769.3122337962964,CLOSED,0,96,4,0,4,1,False,0,0,0,1403,96,47.63111111111111,Bug
C#,655,7879,1914.9300925925927,MERGED,26,35,6,3,4,621,True,1,2,2,2019,61,85.91638888888889,Document
Go,1174,11429,1925.9585416666666,MERGED,41,421,5,5,1,397,True,3,2,1,3206,462,47.58833333333333,Document
TypeScript,261,3765,762.4896412037037,MERGED,1,8,2,0,7,270,False,0,0,0,7138,9,0.2563888888888889,Document
Erlang,2054,12122,3880.8734375,MERGED,480,702,25,0,4,403,True,0,0,0,1470,1182,18.535833333333333,Document
Erlang,2054,12122,3881.0620138888885,MERGED,10,31,6,0,5,94,False,0,0,0,1039,41,5.917222222222223,Document
Erlang,2054,12122,3880.23662037037,MERGED,1,2,1,0,1,433,False,0,0,0,1294,3,45.665277777777774,Document
V,2097,34362,1639.5802430555557,MERGED,10,91,3,1,4,61,True,0,1,1,3836,101,3.133888888888889,Document
Erlang,2054,12122,3880.4928703703704,MERGED,1,10,2,0,1,29,False,0,0,0,1208,11,19.538611111111113,Document
TypeScript,261,3765,761.797662037037,MERGED,56,206,6,0,1,126,True,0,0,0,4871,262,16.73777777777778,Document
TypeScript,1297,21107,503.08061342592595,MERGED,24,163,7,1,2,1243,True,0,1,1,4079,187,0.025555555555555557,Document
TypeScript,85,724,399.2138657407407,MERGED,0,139,6,0,1,65,False,0,0,0,5683,139,17.279166666666665,Document
Go,1174,11429,1925.0102893518517,MERGED,115,583,19,2,6,502,True,2,0,0,3628,698,69.61305555555556,Document
TypeScript,41369,87415,3025.5632523148147,MERGED,4,16,4,1,11,149,True,0,1,1,3564,20,45.701388888888886,Document
TypeScript,3393,2334,1054.0537962962962,MERGED,0,15,2,1,2,386,False,0,1,1,1566,15,0.1836111111111111,Feature
TypeScript,178,1359,404.94902777777776,MERGED,96,67,2,1,1,38,True,0,1,1,6527,163,0.3622222222222222,Bug
C#,655,7879,1909.1866435185184,MERGED,26,152,5,3,6,617,True,1,2,2,2380,178,383.04333333333335,Document
Java,450,746,4157.3329745370365,MERGED,112,440,20,1,23,43,False,0,1,1,1277,552,118.9675,Bug
TypeScript,41369,87415,3025.6496643518517,MERGED,0,8,2,3,4,152,True,1,2,2,3679,8,26.886388888888888,Document
TypeScript,41369,87415,3025.628090277778,MERGED,2,14,2,1,4,151,True,0,1,1,3539,16,27.39527777777778,Document
TypeScript,41369,87415,3025.6127546296298,MERGED,4,11,4,1,4,150,True,0,1,1,3174,15,27.783055555555556,Document
Python,2409,12194,324.97150462962964,CLOSED,1,1,1,0,1,0,False,0,0,0,1171,2,3.6658333333333335,Document
TypeScript,4,33,849.0912037037037,MERGED,41,40,9,1,1,66,False,0,1,1,1272,81,0.1925,Bug
C#,655,7879,1914.3076851851854,MERGED,80,4,4,0,1,686,True,0,0,0,2360,84,60.35722222222222,Document
C#,80,125,906.8084606481481,MERGED,8,8,2,0,1,12,False,0,0,0,1068,16,1.303611111111111,Document
Erlang,2054,12122,3880.212951388889,CLOSED,1,6,1,1,1,28,False,1,0,0,1172,7,0.9819444444444444,Document
JavaScript,34,25,284.22667824074074,MERGED,4,4,1,0,1,39,False,0,0,0,1323,8,0.13111111111111112,Bug
C#,80,125,904.8510069444445,MERGED,22,76,6,0,13,2,False,0,0,0,2911,98,145.1236111111111,Document
C++,2234,23696,2444.6143055555553,MERGED,14,24,2,1,5,183,False,0,1,1,2546,38,260.7294444444444,Bug
TypeScript,7,6,728.0839120370371,MERGED,64,164,6,0,9,308,False,0,0,0,5055,228,2.6725,Feature
C++,363,552,622.5840972222222,MERGED,3,1,1,0,2,45,False,0,0,0,1702,4,16.20277777777778,Document
Erlang,2054,12122,3879.383136574074,MERGED,0,3,1,0,1,27,False,0,0,0,1342,3,19.859166666666667,Document
C#,655,7879,1914.712673611111,MERGED,9,9,1,2,3,690,True,1,1,1,2424,18,11.86,Document
C#,655,7879,1914.757523148148,MERGED,9,13,1,0,1,693,True,0,0,0,2394,22,8.168888888888889,Document
Go,1174,11429,1923.9734953703703,MERGED,85,454,9,5,1,470,True,3,2,2,3106,539,72.47916666666667,Document
C#,655,7879,1914.7430092592592,MERGED,1,4,1,0,1,691,True,0,0,0,2321,5,3.3630555555555555,Document
TypeScript,4,33,848.2914699074073,MERGED,5,0,1,2,1,280,True,1,1,1,1015,5,0.059166666666666666,Feature
C#,655,7879,1909.758958333333,MERGED,41,165,11,5,20,13,False,2,3,2,2310,206,244.51361111111112,Document
TypeScript,3393,2334,1052.8731712962963,MERGED,0,2,1,2,1,512,False,0,2,1,1531,2,0.055,Feature
TypeScript,41369,87415,3023.503796296296,MERGED,0,73,3,3,4,45,False,1,2,2,3160,73,94.24055555555556,Document
Erlang,2054,12122,3879.02974537037,MERGED,11,1199,17,0,5,402,True,0,0,0,1284,1210,17.256666666666668,Document
C#,80,125,905.5215625000001,MERGED,0,1,1,0,2,192,True,0,0,0,1044,1,22.86722222222222,Document
JavaScript,9664,43890,3742.1083912037034,MERGED,893,865,47,0,2,34,False,0,0,0,1273,1758,46.8475,Feature
TypeScript,85,724,397.99090277777776,MERGED,56,108,11,0,6,117,False,0,0,0,6477,164,1.6297222222222223,Document
TypeScript,4,33,847.8153935185186,MERGED,148,343,32,1,24,418,True,0,1,1,1099,491,8.471944444444444,Feature
Python,2409,12194,323.38025462962963,CLOSED,1,1,1,6,1,11,False,2,4,1,1610,2,23.40972222222222,Document
TypeScript,41369,87415,3023.737303240741,MERGED,8,86,9,2,5,1664,True,0,2,2,4520,94,65.4161111111111,Document
C#,655,7879,1913.7195949074076,MERGED,30,164,2,2,1,685,True,0,2,2,2398,194,8.18,Document
TypeScript,4,33,847.2107291666666,MERGED,121,230,13,1,10,416,True,0,1,1,1488,351,12.700833333333334,Bug
C#,80,125,904.8897453703704,MERGED,19,8,5,1,1,213,True,1,0,0,1048,27,16.59111111111111,Document
JavaScript,34,25,282.50587962962965,MERGED,0,77,3,0,1,38,False,0,0,0,1441,77,0.0775,Bug
Go,2083,11770,1607.1044212962963,MERGED,58,42,5,0,3,955,True,0,0,0,3574,100,0.1425,Document
Go,421,1654,1594.2166666666665,MERGED,122,132,13,3,7,83,False,1,2,2,5463,254,43.062222222222225,Bug
TypeScript,261,3765,759.7884837962962,MERGED,1095,216,123,0,11,1059,True,0,0,0,5481,1311,0.2075,Document
TypeScript,4,33,846.8888888888888,MERGED,5,4,1,1,1,255,False,0,1,1,1266,9,0.020555555555555556,Bug
C#,655,7879,1912.9925347222222,MERGED,4,1,2,0,2,682,True,0,0,0,2342,5,25.22138888888889,Document
Starlark,440,286,572.7525925925926,MERGED,1,1,1,1,1,79,False,0,1,1,1070,2,0.07222222222222222,Bug
C#,655,7879,1912.968587962963,MERGED,18,17,1,0,4,681,True,0,0,0,2228,35,25.799166666666668,Document
C#,655,7879,1912.2271759259258,MERGED,9,5,1,1,3,16,False,1,0,0,2224,14,65.16555555555556,Document
C#,655,7879,1913.0591550925926,MERGED,0,1,1,0,1,683,True,0,0,0,2251,1,15.483333333333333,Document
C#,655,7879,1912.8380092592595,MERGED,5,12,2,0,1,680,True,0,0,0,2329,17,28.93888888888889,Document
Erlang,2054,12122,3878.1913078703706,MERGED,9,67,6,0,1,432,False,0,0,0,1343,76,6.288333333333333,Document
C#,655,7879,1912.7310069444445,MERGED,9,0,1,1,1,679,True,0,1,1,2219,9,31.510277777777777,Document
C#,655,7879,1912.7259490740742,MERGED,7,0,1,1,1,678,True,0,1,1,2271,7,31.634444444444444,Document
TypeScript,3393,2334,1054.1581944444445,MERGED,26,38,1,2,1,0,False,0,2,1,2126,64,138.48583333333335,Bug
Erlang,2054,12122,3878.1421412037034,MERGED,47,5,6,2,1,431,False,2,0,0,1270,52,1.228611111111111,Document
TypeScript,3393,2334,1051.8496759259258,MERGED,2,2,2,2,2,511,False,0,2,1,1400,4,0.9072222222222223,Document
JavaScript,34,25,282.0594212962963,MERGED,1,1,1,0,1,90,False,0,0,0,1584,2,0.10138888888888889,Bug
TypeScript,41369,87415,3023.4827662037037,MERGED,4,4,1,2,2,44,False,0,2,2,4014,8,3.529166666666667,Document
Erlang,2054,12122,3877.9725578703706,CLOSED,3,3,2,0,1,195,False,0,0,0,1096,6,4.155,Document
TypeScript,261,3764,758.528287037037,MERGED,27,239,21,0,15,122,True,0,0,0,6251,266,26.906666666666666,Document
Starlark,440,286,577.9528703703703,MERGED,0,97,2,2,3,0,False,1,1,1,2114,97,120.03944444444444,Document
TypeScript,261,3764,758.7971527777778,MERGED,1,497,25,0,3,216,False,0,0,0,5525,498,3.4244444444444446,Document
TypeScript,3393,2334,1051.3647685185185,MERGED,2,2,2,1,1,382,False,0,1,1,1640,4,3.573888888888889,Bug
TypeScript,3393,2334,1051.3782407407407,MERGED,0,24,3,1,1,384,False,0,1,1,1670,24,0.18916666666666668,Feature
TypeScript,3393,2334,1051.3767476851851,MERGED,0,1,1,1,1,383,False,0,1,1,1302,1,0.11638888888888889,Feature
TypeScript,3393,2334,1051.3444328703704,MERGED,145,145,2,2,1,509,False,0,2,1,1663,290,0.28805555555555556,Feature
TypeScript,261,3764,758.5960648148148,MERGED,13,98,13,0,3,266,False,0,0,0,7092,111,4.8502777777777775,Document
TypeScript,3393,2334,1051.062789351852,MERGED,41,30,3,1,3,381,False,0,1,1,1754,71,1.6622222222222223,Feature
C#,80,125,903.7317013888888,MERGED,18,49,5,0,2,211,True,0,0,0,1094,67,1.181111111111111,Document
C#,655,7879,1912.040798611111,MERGED,14,14,2,3,2,619,True,1,2,2,2075,28,7.54,Document
TypeScript,41369,87415,3022.5953472222222,MERGED,19,37,3,2,2,1658,True,0,2,2,4305,56,0.9977777777777778,Document
TypeScript,41369,87415,3022.5057291666667,MERGED,42,83,8,2,6,643,True,0,2,2,3155,125,3.0033333333333334,Document
C#,655,7879,1913.135335648148,MERGED,50,155,2,1,10,15,False,0,1,1,2740,205,505.0541666666667,Document
TypeScript,1073,11366,1177.5875462962963,MERGED,3,3,1,1,1,151,True,0,1,1,1066,6,2.811111111111111,Bug
Vue,10811,21164,1106.2497800925926,CLOSED,1,27,11,1,3,1,False,0,1,1,4613,28,0.1786111111111111,Document
JavaScript,5140,7051,1289.651701388889,MERGED,8,63,6,2,3,346,False,1,1,1,6991,71,22.808611111111112,Document
C++,363,552,618.9067592592593,MERGED,32,24,15,1,1,302,False,1,0,0,1747,56,26.434166666666666,Document
TypeScript,41369,87415,3021.9926736111115,MERGED,0,6,1,2,1,74,False,0,2,2,2534,6,13.067777777777778,Document
TypeScript,261,3764,756.9983217592593,MERGED,112,145,19,0,4,1053,True,0,0,0,5393,257,42.485277777777775,Document
TypeScript,3393,2334,1050.2405555555556,MERGED,0,5,1,1,1,179,False,0,1,1,1290,5,0.8747222222222222,Document
TypeScript,3393,2334,1050.2162847222223,MERGED,1,1,1,1,1,178,False,0,1,1,1275,2,0.12527777777777777,Feature
TypeScript,41369,87415,3021.8859722222223,MERGED,49,1210,5,2,3,641,True,0,2,2,4279,1259,1.18,Document
TypeScript,3393,2334,1050.1398148148148,MERGED,0,12,1,1,1,177,False,0,1,1,1606,12,0.18777777777777777,Feature
TypeScript,3393,2334,1049.8717592592593,MERGED,1,1,1,2,1,507,False,0,2,1,1199,2,0.057777777777777775,Bug
Go,752,2399,809.773425925926,MERGED,0,118,6,0,1,78,False,0,0,0,4171,118,0.26722222222222225,Document
Python,2409,12194,327.86836805555555,MERGED,38,50,7,1,7,430,True,1,0,0,1912,88,0.7216666666666667,Document
Starlark,440,286,573.7941319444444,MERGED,0,36,2,2,4,0,False,1,1,1,1673,36,219.92194444444445,Feature
TypeScript,3393,2334,1048.5142592592592,MERGED,1,1,1,1,3,768,False,0,1,1,1274,2,32.61944444444445,Bug
TypeScript,4,33,850.4981481481482,MERGED,448,552,35,1,18,422,True,0,1,1,1974,1000,27.08888888888889,Feature
C#,655,7879,1909.8731944444444,MERGED,299,284,19,1,3,618,True,0,1,1,2040,583,4.736111111111111,Document
TypeScript,41369,87415,3020.0224305555553,MERGED,21,21,13,2,1,41,False,0,2,2,3272,42,1.2830555555555556,Document
JavaScript,5140,7052,1287.621099537037,MERGED,20,885,11,2,5,93,False,0,2,1,5094,905,21.73138888888889,Feature
TypeScript,3393,2334,1048.4874652777778,MERGED,1,1,1,1,1,767,False,0,1,1,1559,2,0.13083333333333333,Feature
TypeScript,41369,87415,3019.7634375,MERGED,7,27,4,2,2,1652,True,0,2,2,3814,34,0.49666666666666665,Document
V,2097,34362,1632.616516203704,MERGED,33,20,12,0,5,61,True,0,0,0,3543,53,9.265555555555556,Document
TypeScript,41369,87415,3019.792210648148,MERGED,44,60,15,1,2,1653,True,0,1,1,4076,104,3.419722222222222,Document
TypeScript,202,107,1230.9507407407407,CLOSED,437,269,13,4,3,18,True,0,4,4,8389,706,635.8738888888889,Document
C++,363,552,623.113900462963,MERGED,229,392,10,0,5,304,False,0,0,0,1977,621,73.08333333333333,Document
TypeScript,1297,21107,502.09497685185187,CLOSED,963,2453,36,12,30,5,False,6,6,2,6328,3416,467.75416666666666,Bug
JavaScript,34,25,285.6922337962963,MERGED,3,3,1,0,1,40,False,0,0,0,1553,6,0.10611111111111111,Bug
TypeScript,58,78,905.1691898148148,MERGED,145,139,26,1,3,198,False,0,1,1,9286,284,8.306111111111111,Feature
TypeScript,12,11,1071.0404861111112,MERGED,43,676,26,0,33,48,False,0,0,0,8513,719,271.07666666666665,Feature
TypeScript,149,2900,461.7627430555556,MERGED,87,44,4,8,1,126,False,3,5,3,2051,131,209.20805555555555,Feature
Python,2409,12194,325.9961574074074,MERGED,33,41,4,0,9,425,True,0,0,0,1867,74,0.6602777777777777,Document
TypeScript,41369,87415,3018.9564120370374,MERGED,26,31,5,3,1,210,False,1,2,2,4696,57,0.5616666666666666,Document
TypeScript,41369,87415,3018.6905787037035,MERGED,26,31,5,2,2,523,True,0,2,2,4604,57,3.077777777777778,Document
Python,137,75,769.8426041666667,MERGED,1,16,3,0,3,242,False,0,0,0,1684,17,1.1502777777777777,Document
TypeScript,4,33,848.7607407407407,MERGED,193,228,5,1,10,420,True,0,1,1,1884,421,11.382777777777777,Feature
Python,2409,12194,325.16055555555556,MERGED,0,0,0,1,4,2,False,0,1,1,1629,0,2.953333333333333,Document
TypeScript,3393,2334,1054.1441435185186,MERGED,0,2,1,1,1,388,False,0,1,1,2328,2,0.7952777777777778,Feature
Python,2409,12194,325.1469212962963,CLOSED,1,1,1,0,2,1,False,0,0,0,1637,2,0.2063888888888889,Document
Python,2409,12194,324.3568055555556,MERGED,0,0,0,1,2,12,False,0,1,1,1633,0,8.19,Document
TypeScript,3393,2334,1053.1619907407407,MERGED,3,78,7,3,3,514,False,1,2,1,2149,81,6.533611111111111,Bug
Java,450,746,4156.080694444444,CLOSED,2,216,18,1,3,168,False,0,1,1,5908,218,694.0072222222223,Bug
Python,137,75,768.2424074074074,MERGED,16,20,3,0,2,231,False,0,0,0,1947,36,0.23027777777777778,Document
Python,137,75,768.0275810185185,MERGED,5,33,2,0,1,230,False,0,0,0,1822,38,0.16027777777777777,Bug
Python,2409,12194,323.5992013888889,MERGED,6,6,1,2,3,0,False,1,1,1,1548,12,6.634722222222222,Document
Python,2409,12194,323.6138310185185,MERGED,1,1,1,6,7,0,False,3,3,1,2034,2,1.4836111111111112,Document
TypeScript,4803,40786,3842.5597685185185,MERGED,34,82,3,1,1,161,True,0,1,1,2258,116,27.086111111111112,Bug
Python,2409,12194,322.92966435185184,MERGED,4,4,4,0,3,417,True,0,0,0,2063,8,0.015,Document
TypeScript,4,33,846.4073148148149,MERGED,52,72,8,1,1,686,True,0,1,1,2106,124,0.8094444444444444,Feature
TypeScript,2442,17076,2646.930150462963,MERGED,17,16,1,0,1,78,True,0,0,0,1852,33,0.08527777777777777,Document
TypeScript,3706,54077,1440.772210648148,MERGED,0,3,3,0,1,181,True,0,0,0,1813,3,31.50861111111111,Bug
Python,2409,12194,322.5877546296296,MERGED,4,5,1,5,3,0,False,3,2,1,1766,9,8.17,Document
C#,655,7879,1914.688148148148,MERGED,16,0,1,0,1,689,True,0,0,0,2453,16,10.863333333333333,Document
Starlark,440,286,574.0043634259259,MERGED,0,611,4,4,60,0,False,2,2,2,2982,611,522.3558333333333,Feature
Go,1835,11246,1812.786875,MERGED,10,9,4,0,4,11,False,0,0,0,2269,19,0.8102777777777778,Bug
TypeScript,307,2556,620.7758449074074,CLOSED,18,159,13,2,8,2,False,0,2,2,5275,177,689.3461111111111,Document
TypeScript,61,71,1756.0241319444447,MERGED,13,15,7,0,3,176,True,0,0,0,1867,28,0.41055555555555556,Bug
Python,2409,12194,322.1401736111111,MERGED,8,7,1,0,3,416,True,0,0,0,1915,15,0.3811111111111111,Document
Python,2409,12194,322.01234953703704,MERGED,50,48,1,3,3,3,False,1,2,1,1930,98,1.9902777777777778,Document
Python,137,75,774.0093171296297,MERGED,14,23,3,0,3,112,False,0,0,0,2455,37,0.22194444444444444,Document
TypeScript,3393,2334,1050.4648726851851,MERGED,12,19,4,2,1,0,False,0,2,1,2272,31,9.463611111111112,Bug
TypeScript,1073,11366,1177.5719907407408,MERGED,25,10,2,1,2,150,True,0,1,1,2231,35,3.1958333333333333,Bug
Python,14534,41196,1167.9252662037036,MERGED,3,3,3,4,1,1433,True,2,2,1,2335,6,9.689166666666667,Document
Python,2409,12194,321.1321527777778,MERGED,1,1,1,2,1,412,True,1,1,1,1876,2,1.0569444444444445,Document
TypeScript,3393,2334,1050.0415856481482,MERGED,1,21,3,1,1,379,False,0,1,1,2445,22,31.75861111111111,Feature
TypeScript,3393,2334,1050.1006944444446,MERGED,0,24,3,1,1,380,False,0,1,1,1863,24,0.11472222222222223,Feature
Python,2409,12194,321.2805324074074,MERGED,18,30,9,0,9,413,True,0,0,0,1945,48,2.185,Document
Go,1835,11246,1814.5485532407408,MERGED,2,3,1,0,1,54,False,0,0,0,1715,5,0.5891666666666666,Document
Go,1835,11246,1813.801099537037,MERGED,5,8,2,0,3,52,False,0,0,0,1945,13,0.39055555555555554,Document
Go,1835,11246,1813.8058564814817,MERGED,2,2,1,0,1,122,False,0,0,0,1711,4,0.013333333333333334,Document
Go,1835,11246,1813.7012731481482,MERGED,1,1,1,0,1,26,False,0,0,0,1836,2,1.3683333333333334,Document
C#,655,7879,1912.8881134259261,MERGED,2,2,1,0,1,14,False,0,0,0,2666,4,6.1466666666666665,Document
JavaScript,5140,7052,1288.7997569444444,MERGED,21,1443,10,2,7,112,False,1,1,1,9511,1464,160.99555555555557,Bug
Python,137,75,770.0721180555556,CLOSED,0,28,3,1,9,5,False,0,1,1,3137,28,287.415,Document
TypeScript,4,33,843.4410532407406,CLOSED,142,236,27,1,7,412,True,0,1,1,1807,378,23.858888888888888,Bug
TypeScript,4,33,848.519525462963,CLOSED,79,68,3,2,1,281,True,1,1,1,2626,147,349.25944444444445,Bug
Python,137,75,773.1089814814815,MERGED,27,60,5,0,3,110,False,0,0,0,3020,87,1.41,Document
Python,2409,12194,329.0731597222222,MERGED,4,9,3,0,2,433,True,0,0,0,2718,13,0.014444444444444444,Document
Python,2409,12194,328.90886574074074,MERGED,18,113,2,0,21,432,True,0,0,0,3042,131,3.712222222222222,Document
Go,1835,11246,1811.6219444444444,MERGED,2,14,1,0,1,48,True,0,0,0,1696,16,2.2819444444444446,Document
V,2097,34362,1634.871875,MERGED,829,814,11,3,6,64,True,1,2,1,7291,1643,31.895,Document
Python,2409,12194,328.5659837962963,MERGED,4,9,3,5,3,0,False,2,3,1,2477,13,12.136388888888888,Document
Go,1835,11246,1811.0096759259259,MERGED,5,5,3,0,3,20,False,0,0,0,1984,10,13.793888888888889,Document
TypeScript,4,33,847.7725115740741,MERGED,5,57,7,1,7,417,True,0,1,1,2412,62,280.2344444444444,Bug
Go,1835,11246,1810.9767708333331,MERGED,2,7,1,0,1,47,True,0,0,0,1882,9,0.1663888888888889,Document
JavaScript,5140,7052,1287.6838194444445,MERGED,123,255,21,4,27,69,False,3,1,1,8932,378,70.44472222222223,Document
Starlark,440,286,577.7668402777778,MERGED,10,23,4,2,3,1,False,1,1,1,2666,33,0.12694444444444444,Document
Python,2409,12194,327.9348726851852,MERGED,46,57,4,0,5,431,True,0,0,0,2477,103,1.2980555555555555,Document
C#,80,125,903.8478587962964,MERGED,10177,19291,201,1,146,103,False,0,1,1,2440,29468,234.42361111111111,Document
Python,2409,12194,327.83019675925925,MERGED,9,46,2,0,10,429,True,0,0,0,2591,55,0.6313888888888889,Document
Python,2409,12194,327.6844675925926,MERGED,5,0,5,3,1,0,False,2,1,1,2579,5,3.906388888888889,Document
TypeScript,3393,2334,1054.6867824074075,CLOSED,158,10,6,1,1,13,False,0,1,1,3035,168,102.92333333333333,Bug
Python,2409,12194,327.0961226851852,MERGED,3,72,3,0,6,427,True,0,0,0,2592,75,18.62638888888889,Document
TypeScript,1073,11366,1182.8466666666666,MERGED,1,16,1,1,2,777,True,0,1,1,2892,17,17.586111111111112,Bug
TypeScript,1297,21107,500.61390046296293,MERGED,105,146,24,3,1,1228,True,0,3,2,6990,251,0.19444444444444445,Document
TypeScript,202,107,1229.8507291666667,MERGED,21,116,16,3,5,314,True,0,3,3,7504,137,121.50305555555556,Document
Python,2409,12194,326.1810532407407,MERGED,6,9,1,1,7,2,False,0,1,1,2720,15,21.043333333333333,Document
TypeScript,1297,21107,502.8892476851852,MERGED,89,124,22,2,3,1240,True,0,2,2,8728,213,0.6825,Document
JavaScript,34,25,284.1680671296296,MERGED,13,74,3,6,4,2,False,2,4,1,3085,87,49.78333333333333,Bug
TypeScript,7,6,727.9818518518518,MERGED,9,88,10,1,10,300,False,0,1,1,7719,97,6.206666666666667,Feature
C++,2234,23696,2440.7199305555555,MERGED,52,76,1,2,4,17,True,0,2,2,4836,128,46.580555555555556,Feature
Vue,10811,21164,1109.0296527777778,MERGED,254,1001,63,1,38,160,False,0,1,1,7267,1255,1.3155555555555556,Document
TypeScript,12,11,1072.215798611111,CLOSED,24616,13098,55,0,19,4,True,0,0,0,12464,37714,359.5227777777778,Bug
TypeScript,3393,2334,1054.051076388889,MERGED,25,28,2,2,3,515,False,0,2,1,3240,53,0.24083333333333334,Bug
TypeScript,1297,21107,501.80902777777777,MERGED,55,55,42,1,1,1235,True,0,1,1,7036,110,0.11083333333333334,Document
Python,2409,12194,325.2830787037037,MERGED,6,57,2,0,5,423,True,0,0,0,2527,63,0.24305555555555555,Document
TypeScript,58,78,905.9605555555555,MERGED,27,722,18,2,7,136,False,0,2,2,15496,749,152.5586111111111,Feature
TypeScript,1297,21107,501.5417013888889,CLOSED,561,638,35,2,3,1231,True,1,1,1,5631,1199,2.3505555555555557,Document
Starlark,440,286,574.9318402777777,MERGED,0,118,2,1,1,80,False,0,1,1,2085,118,0.2461111111111111,Feature
TypeScript,12,11,1072.1767708333334,CLOSED,107,124,17,0,1,3,True,0,0,0,13053,231,315.8358333333333,Bug
Python,72,25,1718.717789351852,MERGED,223,544,9,0,18,50,False,0,0,0,7367,767,19.7325,Bug
Python,2409,12194,324.69840277777774,MERGED,19,14,12,0,5,422,True,0,0,0,3022,33,6.11,Document
Vue,293,495,912.6748726851852,MERGED,622,1540,52,32,55,81,False,8,24,6,4778,2162,107.68111111111111,Bug
Java,450,746,4158.110393518518,MERGED,12,35,4,1,1,79,False,0,1,1,3099,47,23.79888888888889,Feature
TypeScript,202,107,1228.4429629629628,MERGED,37,170,2,3,2,297,True,0,3,3,7884,207,27.824166666666667,Bug
Go,1835,11246,1817.1725694444447,MERGED,14,48,3,0,1,596,False,0,0,0,3075,62,9.462777777777777,Document
Python,2409,12194,324.06121527777776,MERGED,28,5,3,0,5,421,True,0,0,0,2586,33,0.30444444444444446,Document
Go,1835,11246,1816.7202314814815,MERGED,12,46,3,0,1,49,True,0,0,0,2951,58,10.7725,Document
TypeScript,41369,87415,3023.166412037037,MERGED,35,111,7,5,6,1,False,2,3,3,5959,146,12.631666666666666,Document
Python,2409,12194,323.6748611111111,MERGED,17,17,10,3,5,418,True,2,1,1,2994,34,4.826944444444444,Document
TypeScript,4,33,846.4423842592593,MERGED,7,10,4,1,1,687,True,0,1,1,2774,17,0.06888888888888889,Feature
JavaScript,34,25,282.0904976851852,CLOSED,16,17,3,0,1,13,False,0,0,0,2730,33,1.1058333333333332,Feature
Java,450,746,4156.244803240741,MERGED,4,5,2,1,1,587,False,0,1,1,2953,9,43.39361111111111,Bug
TypeScript,4,33,846.3362384259259,MERGED,300,324,37,1,6,684,True,0,1,1,2283,624,1.4344444444444444,Bug
V,2097,34362,1634.8079050925926,MERGED,1,382,9,2,5,0,False,1,1,1,4708,383,19.4225,Document
TypeScript,4,33,845.7075,MERGED,209,536,25,1,10,253,False,0,1,1,2253,745,27.98472222222222,Feature
Java,450,746,4156.285648148148,MERGED,23,43,3,1,1,588,False,0,1,1,2683,66,21.82138888888889,Bug
TypeScript,4,33,845.6668055555556,MERGED,0,199,10,1,3,252,False,0,1,1,2812,199,0.3458333333333333,Feature
TypeScript,41369,87415,3021.518842592593,MERGED,9,35,4,2,1,638,True,0,2,2,4427,44,1.9991666666666668,Document
TypeScript,1073,11366,1177.7954861111111,MERGED,27,37,3,1,1,317,True,0,1,1,2557,64,0.6541666666666667,Bug
TypeScript,41369,87415,3020.9317708333333,MERGED,10,56,8,2,6,143,True,0,2,2,5059,66,16.36722222222222,Document
TypeScript,41369,87415,3020.796574074074,MERGED,660,3229,150,5,16,524,True,1,4,4,7765,3889,22.781666666666666,Document
Go,1835,11246,1814.8790277777778,MERGED,9,8,4,0,1,76,False,0,0,0,2334,17,0.7777777777777778,Document
Java,450,746,4154.9674537037035,MERGED,218,0,6,1,2,20,False,0,1,1,2717,218,30.058888888888887,Feature
TypeScript,1297,21107,497.62180555555557,MERGED,86,22,26,1,1,1224,True,0,1,1,6520,108,0.18333333333333332,Document
Python,2409,12194,320.95180555555555,MERGED,6,6,3,0,4,411,True,0,0,0,2393,12,0.05611111111111111,Document
TypeScript,1073,11366,1176.657986111111,MERGED,0,2,1,1,1,89,True,0,1,1,2178,2,0.765,Document
Go,1835,11246,1813.8275462962963,MERGED,3,10,2,0,5,124,False,0,0,0,2499,13,0.01861111111111111,Document
Go,1835,11246,1813.8192361111112,MERGED,1,1,1,0,3,123,False,0,0,0,2327,2,0.023333333333333334,Document
Python,4517,54993,1010.7763425925926,MERGED,27,82,1,8,3,0,False,2,6,2,3781,109,625.8105555555555,Document
TypeScript,1073,11366,1174.8389930555556,MERGED,25,588,3,2,10,315,True,1,1,1,3067,613,65.78888888888889,Bug
TypeScript,1073,11366,1175.7176041666667,MERGED,9,4,1,1,2,148,True,0,1,1,2575,13,0.9419444444444445,Document
TypeScript,1073,11366,1175.5267939814814,MERGED,1,1,1,1,1,36,True,0,1,1,2109,2,7.417777777777777,Document
TypeScript,41369,87415,3018.9308333333333,MERGED,29,37,6,2,2,209,False,0,2,2,4885,66,0.4175,Document
Go,1835,11246,1812.6265277777777,MERGED,24,19,3,0,2,25,False,0,0,0,3026,43,0.15583333333333332,Document
TypeScript,7,6,730.192361111111,MERGED,391,738,165,0,22,306,False,0,0,0,9820,1129,117.98361111111112,Feature
Java,450,746,4155.787893518519,MERGED,190,923,45,0,52,6,False,0,0,0,9284,1113,408.18416666666667,Document
Erlang,2054,12122,3879.4337152777775,MERGED,489,1199,57,1,14,148,False,0,1,1,3051,1688,456.8663888888889,Bug
JavaScript,5140,7052,1289.249074074074,MERGED,13,732,14,4,34,70,False,2,2,2,14493,745,106.72805555555556,Bug
Python,547,7161,2324.757685185185,MERGED,5,2,2,0,4,47,False,0,0,0,3116,7,330.04777777777775,Bug
Java,450,746,4158.241018518519,MERGED,2490,9,23,1,3,21,False,0,1,1,4998,2499,425.9113888888889,Feature
Go,421,1654,1592.3022106481483,MERGED,10,472,54,0,1,81,False,0,0,0,15827,482,13.984722222222222,Bug
JavaScript,5140,7052,1288.706400462963,MERGED,12,90,14,4,6,345,False,3,1,1,14600,102,45.37972222222222,Bug
TypeScript,1297,21107,503.7775578703704,MERGED,0,170,11,1,2,1247,True,0,1,1,7767,170,0.2086111111111111,Document
C++,2234,23696,2442.1497685185186,CLOSED,99,155,4,1,1,30,False,0,1,1,8576,254,44.97944444444445,Bug
TypeScript,41369,87415,3025.690439814815,MERGED,7,287,132,1,3,155,True,0,1,1,9179,294,50.269444444444446,Document
Python,137,75,773.9382523148148,MERGED,20,37,5,0,4,111,False,0,0,0,4813,57,0.5663888888888889,Bug
TypeScript,184,377,1994.1464699074074,MERGED,24,23,1,5,9,53,False,4,1,1,4082,47,259.12944444444446,Document
TypeScript,3393,2334,1051.981423611111,MERGED,235,328,26,6,56,11,False,2,4,2,3497,563,364.3808333333333,Feature
Python,4517,54993,1012.8096527777778,MERGED,10,4,1,0,3,159,False,0,0,0,3486,14,172.62194444444444,Document
Starlark,440,286,574.6379398148148,CLOSED,0,374,6,2,10,4,False,1,1,1,4251,374,206.42138888888888,Document
Starlark,440,286,574.7918402777779,MERGED,87,224,1,1,8,3,False,0,1,1,4432,311,195.9338888888889,Feature
Python,2409,12194,327.03451388888885,MERGED,107,113,100,0,3,426,True,0,0,0,3567,220,0.5652777777777778,Document
TypeScript,41369,87415,3023.0616087962967,MERGED,1204,1256,56,2,9,1662,True,0,2,2,9535,2460,10.274166666666666,Document
TypeScript,202,107,1227.7700347222224,MERGED,117,164,11,3,3,311,True,0,3,3,10173,281,15.034444444444444,Document
Python,2409,12194,325.7639351851852,MERGED,1317,1451,107,0,27,424,True,0,0,0,4018,2768,5.747777777777777,Document
JavaScript,34,25,282.9495138888889,CLOSED,21,1249,13,0,7,91,False,0,0,0,3670,1270,122.43083333333334,Bug
Python,2409,12194,321.8779861111111,MERGED,59,95,22,8,52,414,True,7,1,1,4102,154,217.2775,Document
TypeScript,1073,11366,1180.7213194444446,MERGED,16,304,2,1,6,319,True,0,1,1,4304,320,19.135555555555555,Bug
Python,137,75,769.4459027777779,MERGED,28,42,39,0,1,232,False,0,0,0,4777,70,0.27416666666666667,Document
Python,137,75,769.350763888889,CLOSED,0,506,18,0,36,5,False,0,0,0,3765,506,0.34194444444444444,Document
TypeScript,184,377,1994.085914351852,MERGED,1,1,1,0,1,52,False,0,0,0,4036,2,1.6588888888888889,Document
TypeScript,4,33,848.2002662037038,MERGED,268,293,26,1,26,419,True,0,1,1,4657,561,11.966388888888888,Bug
TypeScript,4,33,847.8889699074074,MERGED,36,41,14,2,6,279,True,1,1,1,4664,77,0.1175,Bug
Python,137,75,768.0052777777778,MERGED,33,61,57,0,3,229,False,0,0,0,4096,94,0.195,Document
Python,137,75,767.9675231481482,MERGED,50,67,8,0,2,228,False,0,0,0,4594,117,0.1663888888888889,Bug
Python,4517,54993,1009.3514004629629,MERGED,1,2,1,0,2,1,False,0,0,0,3274,3,1.416111111111111,Document
Python,14534,41196,1170.581388888889,MERGED,129,15,8,0,5,1436,True,0,0,0,4107,144,1.2369444444444444,Document
Python,4517,54993,1007.5262152777777,MERGED,0,63,2,0,4,0,False,0,0,0,3746,63,49.02194444444444,Document
TypeScript,4,33,845.2869560185185,MERGED,107,245,14,1,4,414,True,0,1,1,4308,352,6.393055555555556,Document
TypeScript,1073,11366,1176.8225462962962,MERGED,17,37,15,1,6,149,True,0,1,1,4654,54,18.447222222222223,Document
Go,1835,11246,1814.6478356481482,MERGED,4,13,7,0,1,55,False,0,0,0,3962,17,1.4605555555555556,Document
Python,4517,54993,1006.5676041666667,MERGED,1,5,1,2,2,10,False,1,1,1,3325,6,61.39694444444444,Document
Go,1835,11246,1813.594224537037,MERGED,14,219,29,0,3,75,False,0,0,0,3362,233,29.47222222222222,Document
Go,1835,11246,1813.773912037037,MERGED,3,17,3,1,1,121,False,1,0,0,4202,20,0.17472222222222222,Document
Go,1835,11246,1813.5915972222222,MERGED,3,37,4,0,7,21,False,0,0,0,3902,40,1.1002777777777777,Document
Go,1835,11246,1810.788587962963,MERGED,53,116,6,0,5,46,True,0,0,0,4398,169,3.1144444444444446,Document
TypeScript,7,6,728.2250578703703,MERGED,205,673,34,0,30,301,False,0,0,0,10592,878,4.730277777777777,Feature
Go,752,2399,813.4673148148148,MERGED,86,1212,19,0,33,180,False,0,0,0,11371,1298,9.172777777777778,Bug
TypeScript,41369,87415,3023.728032407407,MERGED,993,1315,38,4,8,645,True,1,3,3,10680,2308,2.3644444444444446,Document
Python,137,75,770.2132638888888,MERGED,12,1096,50,1,48,9,False,0,1,1,5445,1108,386.04527777777776,Bug
TypeScript,307,2556,621.4312152777778,MERGED,292,368,79,0,12,595,True,0,0,0,11812,660,2.8733333333333335,Bug
TypeScript,3393,2334,1055.3994444444445,MERGED,524,1786,27,2,27,516,False,0,2,1,5629,2310,235.8827777777778,Feature
TypeScript,149,2900,468.7742824074074,MERGED,5532,3656,423,2,99,127,False,1,1,1,6442,9188,28.314722222222223,Document
Python,4517,54993,1011.6085300925926,MERGED,0,157,2,0,12,4,False,0,0,0,4701,157,263.49805555555554,Document
Python,137,75,771.1216435185185,CLOSED,0,231,17,0,5,1,False,0,0,0,5406,231,167.53944444444446,Document
Python,2409,12194,327.79157407407405,MERGED,144,969,110,3,58,428,True,3,0,0,6470,1113,35.67055555555555,Document
Python,2409,12194,327.5073726851852,MERGED,3,4,2,1,3,3,False,0,1,1,4354,7,8.747777777777777,Document
Java,450,746,4156.1915625,MERGED,162,212,15,2,29,78,False,1,1,1,4898,374,312.4838888888889,Feature
TypeScript,3393,2334,1052.9756597222222,CLOSED,324,2151,32,1,27,12,False,0,1,1,8510,2475,143.3527777777778,Bug
TypeScript,4803,40786,3845.6502430555556,MERGED,49,269,20,1,21,162,True,0,1,1,5604,318,20.26,Bug
Python,137,75,770.0039467592593,MERGED,57,64,11,0,5,42,False,0,0,0,4861,121,12.646666666666667,Document
TypeScript,4,33,847.930775462963,MERGED,584,662,33,1,12,257,False,0,1,1,7541,1246,43.63777777777778,Feature
TypeScript,1073,11366,1179.7622222222224,MERGED,6,412,5,1,10,318,True,0,1,1,4831,418,3.091666666666667,Bug
TypeScript,4,33,847.1916435185185,MERGED,262,218,14,1,32,415,True,0,1,1,6238,480,0.33111111111111113,Bug
Python,2409,12194,321.91436342592596,MERGED,363,349,9,0,8,415,True,0,0,0,7383,712,4.896944444444444,Document
TypeScript,1073,11366,1177.5836574074074,CLOSED,105,191,5,1,6,316,True,0,1,1,8501,296,5.025,Bug
Python,4517,54993,1007.2062615740741,MERGED,13,43,1,0,6,0,False,0,0,0,5616,56,57.022222222222226,Document
Go,1835,11246,1813.8544444444444,MERGED,4,8,3,0,1,53,False,0,0,0,4650,12,0.8866666666666667,Document
Go,1835,11246,1811.6473958333333,MERGED,20,223,9,0,4,10,False,0,0,0,8049,243,5.583055555555555,Bug
Go,1835,11246,1810.8060648148148,MERGED,29,2694,37,1,4,73,False,0,1,1,5096,2723,26.293055555555554,Document
Go,1835,11246,1809.8532175925927,MERGED,7,2790,32,4,3,17,False,1,3,3,5694,2797,45.010555555555555,Document
C++,2234,23696,2440.7138310185187,MERGED,210,415,19,1,19,28,False,0,1,1,19081,625,2.54,Bug
Python,137,75,769.9272337962963,MERGED,112,126,12,0,11,108,False,0,0,0,9164,238,3.1975,Document
TypeScript,4,33,850.4458217592593,MERGED,313,667,25,0,10,421,True,0,0,0,9459,980,0.03666666666666667,Bug
JavaScript,5140,7052,1287.960763888889,MERGED,86,873,16,1,5,0,False,0,1,1,18325,959,62.35388888888889,Bug
Python,137,75,766.983425925926,MERGED,31,190,17,0,2,227,False,0,0,0,9185,221,0.30944444444444447,Document
TypeScript,61,71,1755.119375,MERGED,459,532,7,0,12,19,True,0,0,0,9561,991,2.221388888888889,Feature
Go,1835,11246,1812.6430902777777,MERGED,29,96,12,0,2,74,False,0,0,0,7396,125,4.0344444444444445,Document
Go,1835,11246,1811.6372453703705,MERGED,43,67,4,0,6,24,False,0,0,0,9292,110,4.804166666666666,Document
JavaScript,34,25,286.3386689814815,MERGED,5935,6455,105,3,4,0,False,2,1,1,11608,12390,61.74527777777778,Document
TypeScript,3393,2334,1053.1634375,MERGED,14,38,12,1,4,769,False,0,1,1,11563,52,170.92277777777778,Feature
JavaScript,22,26,1000.0446412037037,MERGED,64,180,10,0,2,33,True,0,0,0,13712,244,179.66861111111112,Bug
TypeScript,3393,2334,1052.0236921296296,MERGED,3,75,17,1,3,385,False,0,1,1,12528,78,1.5205555555555557,Feature
V,2097,34362,1639.412175925926,MERGED,198,264,17,3,7,502,True,2,1,1,22493,462,7.846111111111111,Document
Go,1835,11246,1810.6676851851853,MERGED,243,309,32,0,3,23,False,0,0,0,10685,552,21.636388888888888,Document
TypeScript,2147,14725,1557.2591435185186,MERGED,251,547,10,0,1,39,False,0,0,0,15751,798,276.2294444444444,Feature
Go,1835,11246,1812.6529282407407,MERGED,1299,2046,44,1,23,51,False,0,1,1,15464,3345,6.872777777777777,Document
TypeScript,2147,14725,1566.1415625,MERGED,1,1,1,0,1,63,False,0,0,0,697,2,62.85583333333334,Bug
TypeScript,2147,14725,1566.0577546296297,MERGED,0,5,1,0,1,331,False,0,0,0,634,5,64.85555555555555,Feature
TypeScript,12,11,1081.2757870370372,MERGED,24,21,8,0,41,197,False,0,0,0,898,45,192.51194444444445,Feature
TypeScript,178,1359,415.53287037037035,CLOSED,38,39,2,8,3,3,False,4,4,2,1138,77,28.300555555555555,Bug
TypeScript,2147,14725,1566.135011574074,MERGED,0,5,1,0,1,332,False,0,0,0,530,5,0.01361111111111111,Feature
TypeScript,2147,14725,1564.0628356481482,MERGED,1,1,1,1,2,4,False,0,1,1,689,2,112.98166666666667,Bug
TypeScript,2147,14725,1565.8152199074075,MERGED,0,7,1,0,1,124,False,0,0,0,793,7,1.7752777777777777,Document
TypeScript,178,1359,415.42893518518514,MERGED,2,5,1,4,1,0,False,2,2,2,1171,7,17.07,Feature
TypeScript,178,1359,415.3147916666667,MERGED,0,1,1,3,1,1,False,1,2,2,865,1,19.845,Feature
TypeScript,85,724,409.6700231481482,MERGED,1,1,1,0,2,219,False,0,0,0,1126,2,0.10472222222222222,Document
TypeScript,85,724,409.14070601851853,MERGED,0,48,1,0,2,125,False,0,0,0,1192,48,0.18305555555555555,Document
TypeScript,85,724,409.3739699074074,MERGED,2,1,2,0,2,218,False,0,0,0,1133,3,0.30416666666666664,Document
TypeScript,85,724,409.37113425925924,MERGED,0,4,1,0,1,127,False,0,0,0,1082,4,0.013333333333333334,Document
TypeScript,178,1359,414.5884375,MERGED,1,3,1,2,1,1,False,0,2,2,1017,4,8.064722222222223,Bug
TypeScript,85,724,408.9568287037037,MERGED,1,1,1,0,1,216,False,0,0,0,1152,2,5.088611111111111,Document
TypeScript,2147,14725,1562.9665277777776,MERGED,5,8,1,0,1,69,False,0,0,0,767,13,4.442777777777778,Bug
TypeScript,2147,14725,1562.9585995370371,MERGED,75,95,5,0,1,801,False,0,0,0,1119,170,139.72861111111112,Bug
TypeScript,178,1359,412.75967592592593,CLOSED,1,3,1,1,1,0,False,0,1,1,836,4,43.73,Bug
TypeScript,85,724,407.5476967592592,MERGED,3,1,1,0,1,214,False,0,0,0,1069,4,16.348333333333333,Document
JavaScript,5140,7053,1296.717037037037,MERGED,2,2,1,1,1,141,False,0,1,1,554,4,0.11361111111111111,Document
TypeScript,85,724,407.5508564814815,MERGED,1,1,1,0,3,124,False,0,0,0,1138,2,0.011944444444444445,Document
TypeScript,12,11,1079.2683680555556,CLOSED,78,52,25,0,10,8,True,0,0,0,2066,130,549.5202777777778,Bug
TypeScript,12,11,1079.1817592592593,CLOSED,30940,213,30,0,9,5,True,0,0,0,1975,31153,551.6088888888889,Bug
TypeScript,2147,14725,1564.1059259259257,MERGED,5,2,2,0,3,96,False,0,0,0,929,7,21.10638888888889,Feature
TypeScript,2147,14725,1564.177627314815,MERGED,21,32,1,0,2,219,False,0,0,0,784,53,13.770833333333334,Bug
JavaScript,5140,7053,1295.911724537037,MERGED,57,154,5,1,24,140,False,0,1,1,1131,211,284.8861111111111,Document
JavaScript,5140,7053,1297.6262847222222,CLOSED,0,11,1,1,1,0,False,0,1,1,642,11,0.8933333333333333,Feature
Go,421,1654,1603.0743287037037,MERGED,0,24,1,0,1,85,False,0,0,0,916,24,68.84722222222223,Bug
TypeScript,2147,14725,1565.7604398148148,MERGED,0,248,3,0,1,220,False,0,0,0,1705,248,0.4313888888888889,Document
TypeScript,2147,14725,1563.1556597222223,MERGED,0,1,1,0,5,8,False,0,0,0,985,1,16.96611111111111,Bug
TypeScript,2147,14725,1563.1549074074073,MERGED,7,6,1,0,1,70,False,0,0,0,1087,13,15.468055555555555,Bug
PHP,1334,2960,4299.174733796296,CLOSED,0,1,1,3,1,0,False,0,3,2,1061,1,121.32611111111112,Document
TypeScript,58,78,914.0184837962962,MERGED,3,3,1,1,1,138,False,0,1,1,1196,6,1.2105555555555556,Feature
TypeScript,85,724,405.5247569444444,MERGED,2,1,1,0,1,121,False,0,0,0,1035,3,0.008055555555555555,Document
V,2097,34362,1645.4013657407406,MERGED,1,2,1,1,1,265,True,0,1,1,479,3,20.14527777777778,Bug
Python,547,7161,2332.719386574074,MERGED,1,1,1,0,2,253,False,0,0,0,651,2,39.617777777777775,Document
TypeScript,2147,14725,1566.1773842592593,MERGED,12,22,2,0,8,65,False,0,0,0,1411,34,61.87138888888889,Bug
TypeScript,2147,14725,1566.0214467592593,MERGED,11,14,1,0,2,3,False,0,0,0,1493,25,65.7213888888889,Bug
TypeScript,85,724,405.08167824074076,MERGED,1,1,1,0,1,135,False,0,0,0,1141,2,1.495,Document
TypeScript,58,78,913.280636574074,MERGED,8,8,1,1,1,137,False,0,1,1,1588,16,17.123055555555556,Feature
TypeScript,85,724,404.9945949074074,MERGED,2,2,1,0,1,21,False,0,0,0,1176,4,0.36527777777777776,Document
TypeScript,2147,14725,1562.0267824074074,MERGED,2,2,1,0,1,67,False,0,0,0,945,4,0.9591666666666666,Bug
TypeScript,2147,14725,1565.2072569444445,MERGED,596,267,16,0,2,803,False,0,0,0,1432,863,87.46222222222222,Bug
PHP,1334,2960,4298.023993055555,CLOSED,8925,2521,797,5,78,35,False,1,4,2,983,11446,4.493611111111111,Document
TypeScript,85,724,409.10375,MERGED,23,37,2,0,3,217,False,0,0,0,1844,60,7.223888888888889,Document
TypeScript,261,3764,768.8425925925926,MERGED,3,8,2,0,1,143,False,0,0,0,1598,11,16.14666666666667,Document
TypeScript,7,6,738.0825347222222,MERGED,411,27,13,2,26,26,False,0,2,2,1120,438,140.06555555555556,Feature
Python,547,7161,2332.118148148148,MERGED,2,2,1,0,2,325,True,0,0,0,638,4,7.548333333333333,Bug
JavaScript,5140,7053,1297.6792476851851,MERGED,5,9,1,1,1,96,False,0,1,1,1083,14,1.9288888888888889,Feature
Vue,293,495,923.9437268518518,MERGED,1,1,1,4,1,329,True,0,4,3,598,2,1.1697222222222223,Bug
TypeScript,261,3764,768.6691782407407,MERGED,0,5,1,0,1,1075,True,0,0,0,1315,5,0.24555555555555555,Document
Python,547,7161,2331.818425925926,MERGED,1,1,1,4,3,14,False,0,4,1,719,2,0.15694444444444444,Bug
Go,421,1654,1601.1050231481483,MERGED,1,1,1,0,1,517,True,0,0,0,920,2,0.28555555555555556,Bug
TypeScript,2147,14725,1565.2463657407407,MERGED,4,48,2,0,1,0,False,0,0,0,1626,52,12.883055555555556,Feature
TypeScript,85,724,408.0659027777778,MERGED,2,2,1,0,2,108,False,0,0,0,1278,4,0.2975,Document
TypeScript,85,724,408.036712962963,MERGED,2,23,2,0,1,215,False,0,0,0,1737,25,0.9330555555555555,Document
TypeScript,261,3764,767.9310763888889,MERGED,0,11,2,0,1,271,False,0,0,0,1235,11,2.1494444444444443,Document
TypeScript,261,3764,767.7919097222222,MERGED,4,4,2,0,2,141,False,0,0,0,1529,8,5.403888888888889,Document
TypeScript,2147,14725,1563.993287037037,CLOSED,1,2,2,1,1,2,False,1,0,0,1105,3,49.555277777777775,Feature
TypeScript,261,3764,767.4901967592592,MERGED,51,58,3,0,1,222,False,0,0,0,1469,109,1.0494444444444444,Document
Go,421,1654,1600.0622337962961,CLOSED,0,1,1,0,1,122,False,0,0,0,1042,1,3.9,Document
TypeScript,85,724,407.5391550925926,MERGED,1,1,1,0,1,123,False,0,0,0,1302,2,0.0077777777777777776,Document
TypeScript,2147,14725,1563.8400925925926,MERGED,160,161,2,1,1,2,False,0,1,1,1298,321,47.14277777777778,Feature
TypeScript,7,6,736.1105092592593,MERGED,2,1,1,0,3,61,True,0,0,0,988,3,144.87944444444443,Feature
TypeScript,2147,14725,1563.8094675925925,MERGED,3,16,2,0,1,328,False,0,0,0,1412,19,24.323611111111113,Document
TypeScript,85,724,407.07428240740745,MERGED,7,3,1,0,1,137,False,0,0,0,1345,10,0.026111111111111113,Document
TypeScript,261,3764,766.8670601851851,MERGED,0,4,4,0,2,221,False,0,0,0,1624,4,2.1033333333333335,Document
Go,421,1654,1603.0954050925927,MERGED,69,1,1,0,1,256,False,0,0,0,1476,70,68.73666666666666,Bug
Python,547,7161,2330.093923611111,MERGED,0,1,1,0,1,255,False,0,0,0,659,1,4.754444444444444,Bug
PHP,1334,2960,4301.10056712963,MERGED,16,30,4,1,3,891,False,0,1,1,1826,46,75.51555555555555,Bug
TypeScript,2147,14725,1563.0571759259258,CLOSED,0,0,0,0,0,9,False,0,0,0,1559,0,47.965555555555554,Bug
TypeScript,2147,14725,1563.7871875,MERGED,14,20,3,0,3,71,False,0,0,0,1482,34,0.10472222222222222,Bug
PHP,1334,2960,4299.197754629629,MERGED,4,3,1,6,2,179,False,2,4,2,1122,7,21.91861111111111,Document
PHP,1334,2960,4298.286527777777,MERGED,18,25,2,1,1,890,False,0,1,1,1502,43,214.29833333333335,Document
Python,547,7161,2329.692384259259,MERGED,1,4,1,0,1,251,False,0,0,0,677,5,1.3486111111111112,Bug
Go,30,295,438.9881481481482,MERGED,1,1,1,2,1,1,True,0,2,1,970,2,23.54,Bug
Python,547,7161,2330.579988425926,MERGED,19,51,2,0,14,159,False,0,0,0,1081,70,144.9922222222222,Bug
TypeScript,85,724,405.9692361111111,MERGED,1,1,1,0,1,122,False,0,0,0,1446,2,0.021666666666666667,Document
Vue,293,495,924.0994328703704,MERGED,0,7,2,6,3,435,False,0,6,5,873,7,42.25611111111111,Bug
Go,421,1654,1599.2820833333333,MERGED,1231,4170,86,5,28,84,False,2,3,1,858,5401,236.3425,Feature
TypeScript,261,3764,769.8109953703703,MERGED,9,10,1,0,2,280,True,0,0,0,1739,19,0.3275,Document
TypeScript,2147,14725,1562.8064467592592,MERGED,2,6,1,0,1,7,False,0,0,0,1281,8,3.6369444444444445,Bug
TypeScript,7,6,736.8736111111111,MERGED,21,11,3,0,5,63,True,0,0,0,1186,32,6.1786111111111115,Feature
TypeScript,261,3764,769.6775347222223,MERGED,4,11,3,0,2,658,True,0,0,0,1922,15,1.866111111111111,Document
TypeScript,7,6,736.8732870370371,MERGED,1,1,1,0,1,307,False,0,0,0,828,2,0.11638888888888889,Document
Vue,293,495,919.8234375000001,MERGED,29,0,1,4,1,324,True,0,4,3,635,29,0.09111111111111111,Bug
TypeScript,15,34,580.4740509259259,CLOSED,7,43,6,0,15,209,False,0,0,0,259,50,185.52083333333334,Feature
TypeScript,85,724,409.1677893518518,MERGED,4,21,5,0,2,126,False,0,0,0,2076,25,0.1411111111111111,Document
TypeScript,12,11,1080.428935185185,MERGED,114,499,10,0,3,86,False,0,0,0,2131,613,41.83972222222222,Bug
TypeScript,85,724,405.06916666666666,MERGED,2,2,1,0,1,134,False,0,0,0,1653,4,1.798888888888889,Document
JavaScript,5140,7053,1296.7235648148148,MERGED,11,14,12,2,8,352,False,1,1,1,1362,25,122.93222222222222,Bug
Java,450,746,4166.0634375,MERGED,1,1,1,1,1,19,False,0,1,1,137,2,119.03444444444445,Feature
Vue,293,495,919.8980671296296,MERGED,0,9,1,5,3,83,False,1,4,4,878,9,20.758055555555554,Bug
Python,547,7161,2331.866863425926,MERGED,150,236,2,0,2,256,False,0,0,0,1021,386,0.16472222222222221,Bug
PHP,1334,2960,4298.211180555555,MERGED,6,2,1,3,1,36,False,1,2,2,1237,8,137.6775,Document
Python,547,7161,2331.793738425926,MERGED,2,1,1,4,1,13,False,0,4,1,888,3,0.2452777777777778,Bug
Python,547,7161,2331.747060185185,MERGED,4,9,2,0,3,12,False,0,0,0,848,13,0.5016666666666667,Bug
Vue,293,495,922.9147222222223,MERGED,1,1,1,9,1,3,False,3,6,4,828,2,48.58416666666667,Document
TypeScript,2147,14725,1561.8312037037037,MERGED,4,8,1,0,1,66,False,0,0,0,1328,12,5.7725,Feature
Vue,293,495,922.0770717592592,MERGED,0,17,2,15,4,0,False,5,10,5,1001,17,90.30416666666666,Document
Python,547,7161,2331.422314814815,MERGED,19,31,5,1,2,160,False,1,0,0,1114,50,4.265833333333333,Bug
TypeScript,2147,14725,1565.0634027777778,MERGED,2,13,4,0,1,10,False,0,0,0,2103,15,17.259166666666665,Bug
Go,752,2399,817.6238888888888,MERGED,2,2,1,0,1,183,False,0,0,0,808,4,0.014166666666666666,Bug
TypeScript,202,107,1237.7978587962964,MERGED,2,4,1,3,1,308,True,0,3,3,940,6,0.19083333333333333,Document
TypeScript,202,107,1237.7168402777777,MERGED,1,1,1,4,2,327,True,0,4,3,1066,2,2.1438888888888887,Document
Go,30,295,441.0574537037037,MERGED,0,204,5,1,1,117,True,0,1,1,1125,204,0.13694444444444445,Feature
TypeScript,202,107,1237.6713657407406,MERGED,2,2,1,3,1,307,True,0,3,3,930,4,2.160277777777778,Bug
Go,30,295,440.9826967592592,MERGED,0,82,3,1,1,116,True,0,1,1,1371,82,0.12805555555555556,Feature
Go,30,295,440.92346064814814,MERGED,81,128,1,0,2,114,True,0,0,0,1535,209,0.12111111111111111,Document
TypeScript,261,3764,767.7460763888889,MERGED,2,2,2,0,1,1073,True,0,0,0,1615,4,0.011666666666666667,Document
TypeScript,261,3764,767.6936689814816,MERGED,50,46,7,0,2,1071,True,0,0,0,2401,96,0.32916666666666666,Document
TypeScript,261,3764,767.6400694444445,MERGED,18,29,3,0,4,127,True,0,0,0,1827,47,0.7488888888888889,Document
TypeScript,261,3764,767.5533564814815,MERGED,1,16,2,0,3,238,True,0,0,0,2079,17,5.410555555555556,Document
Go,752,2399,820.5531134259259,MERGED,15,18,1,0,1,481,False,0,0,0,1052,33,0.8136111111111111,Bug
Vue,293,495,922.1618402777777,MERGED,125,3,23,6,5,0,True,1,5,4,946,128,14.973611111111111,Bug
Go,752,2399,820.4497685185185,MERGED,6,4,1,0,1,321,False,0,0,0,796,10,0.03888888888888889,Bug
PHP,883,2338,1926.9635532407408,CLOSED,0,0,0,6,0,0,False,4,2,2,1596,0,69.40527777777778,Document
Vue,293,495,921.805,MERGED,97,94,48,8,85,328,True,1,7,5,885,191,0.6811111111111111,Bug
Vue,293,495,919.7388657407408,CLOSED,5,9,5,6,2,0,False,0,6,6,883,14,148.9113888888889,Bug
PHP,1334,2960,4301.142048611111,MERGED,3,3,3,2,1,97,False,0,2,2,1900,6,67.59472222222222,Document
Python,19251,70268,2552.800787037037,CLOSED,76,29,14,1,1,1665,False,1,0,0,116,105,3.2741666666666664,Feature
JavaScript,5140,7053,1294.5363078703704,CLOSED,135,4242,44,2,32,190,False,1,1,1,2111,4377,359.4558333333333,Document
Python,547,7161,2329.571585648148,MERGED,0,3,1,0,3,1,False,0,0,0,110,3,61.22222222222222,Bug
Python,547,7161,2329.3893171296295,MERGED,33,22,2,0,10,250,False,0,0,0,756,55,24.066388888888888,Bug
Go,421,1654,1602.4024652777778,MERGED,38,2,4,0,1,518,True,0,0,0,1788,40,86.08694444444444,Bug
Go,752,2399,819.7187731481481,MERGED,6,4,1,0,1,320,False,0,0,0,796,10,0.11361111111111111,Bug
Go,752,2399,819.7144328703704,MERGED,26,6,1,0,1,319,False,0,0,0,1127,32,0.22722222222222221,Bug
Python,19251,70268,2552.0016666666666,CLOSED,0,6,1,6,2,1662,False,4,2,1,208,6,15.345,Feature
Go,752,2399,819.6361111111111,MERGED,26,6,1,0,1,318,False,0,0,0,1127,32,0.31805555555555554,Bug
Go,752,2399,819.604988425926,CLOSED,1,3,1,0,1,477,False,0,0,0,995,4,1.1108333333333333,Document
Rust,433,2229,330.64064814814816,MERGED,5,2,2,0,1,1185,False,0,0,0,211,7,43.22138888888889,Feature
TypeScript,202,107,1238.7605208333332,MERGED,2,6,2,3,2,7,False,1,2,2,1495,8,242.63361111111112,Document
JavaScript,5140,7053,1298.9710416666667,CLOSED,5,8,2,14,2,0,False,4,10,5,1885,13,67.64833333333333,Document
TypeScript,2147,14725,1563.0101273148148,MERGED,5,6,4,1,2,187,False,0,1,1,2328,11,18.549722222222222,Bug
Vue,293,495,919.7648726851852,CLOSED,5,6,1,6,1,1,False,0,6,6,836,11,92.96416666666667,Bug
JavaScript,5140,7053,1295.7919328703704,MERGED,16,8,1,2,1,0,False,0,2,2,1750,24,9.734166666666667,Document
TypeScript,15,34,580.5883101851852,MERGED,17,70,9,0,35,85,False,0,0,0,368,87,543.1544444444445,Feature
Python,547,7161,2329.0734837962964,MERGED,4,4,1,0,6,253,False,0,0,0,767,8,0.34805555555555556,Bug
Vue,10811,21164,1114.260775462963,MERGED,6,3,1,0,1,205,False,0,0,0,1355,9,14.723888888888888,Bug
Python,547,7161,2329.000775462963,MERGED,25,171,9,0,4,634,True,0,0,0,680,196,1.6908333333333334,Feature
JavaScript,5140,7053,1295.6710185185186,MERGED,1,25,1,2,4,117,False,0,2,2,1195,26,2.073611111111111,Document
JavaScript,5140,7053,1297.6663078703702,MERGED,20,329,7,1,7,115,False,0,1,1,2264,349,115.91666666666667,Document
TypeScript,2147,14725,1562.0544560185183,MERGED,3,320,3,0,1,218,False,0,0,0,2036,323,2.9855555555555555,Document
TypeScript,2147,14725,1562.7943287037035,MERGED,5,263,14,0,1,68,False,0,0,0,1891,268,3.1838888888888888,Bug
PHP,1334,2960,4301.173900462963,MERGED,1,1,1,1,2,182,False,0,1,1,2005,2,0.2941666666666667,Document
TypeScript,15,34,579.8214814814816,CLOSED,9,9,4,0,6,83,False,0,0,0,361,18,2.955,Feature
Vue,10811,21164,1115.0872685185184,MERGED,0,10,2,1,6,8,False,0,1,1,1648,10,340.10055555555556,Bug
TypeScript,202,107,1235.5325347222222,MERGED,2,10,1,2,1,320,True,0,2,2,986,12,0.0525,Document
TypeScript,85,724,405.26872685185185,CLOSED,112,146,1,0,1,211,False,0,0,0,2837,258,355.46555555555557,Document
Python,547,7161,2328.607986111111,MERGED,47,17,13,0,6,157,False,0,0,0,904,64,5.228888888888889,Document
Java,450,746,4163.128101851852,MERGED,12,24,3,2,1,171,False,0,2,1,990,36,51.33694444444444,Bug
Vue,293,495,925.0006365740741,MERGED,208,208,18,21,55,12,False,6,15,8,1846,416,114.4636111111111,Bug
TypeScript,7,6,734.908599537037,MERGED,2,2,1,0,8,5,False,0,0,0,1568,4,255.23361111111112,Feature
JavaScript,5140,7053,1296.5803472222221,MERGED,3,92,4,5,4,283,False,3,2,2,2094,95,143.66694444444445,Feature
Vue,293,495,919.8513078703704,MERGED,8,8,2,4,3,326,True,0,4,3,824,16,21.891111111111112,Bug
TypeScript,85,724,405.0616782407408,MERGED,33,51,1,0,1,70,False,0,0,0,2222,84,0.19,Document
Go,395,660,1358.1455439814815,MERGED,1,1,1,0,2,143,False,0,0,0,240,2,184.55166666666668,Feature
Vue,293,495,920.0167592592593,MERGED,1,1,1,4,1,327,True,0,4,3,844,2,0.21333333333333335,Bug
Vue,293,495,924.1496180555555,MERGED,1,22,2,23,6,0,False,9,14,5,1452,23,134.54333333333332,Bug
Go,1835,11246,1819.7934143518517,CLOSED,2,2,1,0,1,127,False,0,0,0,228,4,0.7111111111111111,Bug
TypeScript,42,46,862.9208796296297,MERGED,0,1,1,1,1,191,False,0,1,1,219,1,101.37444444444445,Document
Python,547,7161,2327.5705787037036,MERGED,13,35,7,0,4,251,False,0,0,0,918,48,1.885,Bug
TypeScript,7,6,738.1893518518518,MERGED,30,40,3,0,2,27,False,0,0,0,1724,70,0.5569444444444445,Feature
Go,752,2399,817.6212615740741,MERGED,2,2,1,0,1,182,False,0,0,0,789,4,0.014166666666666666,Bug
Python,547,7161,2327.5429166666668,MERGED,562,948,10,0,2,631,True,0,0,0,989,1510,0.18444444444444444,Bug
Vue,10811,21164,1112.6919907407407,MERGED,0,6,1,0,1,203,False,0,0,0,1578,6,14.270555555555555,Bug
TypeScript,7,6,737.9960532407407,MERGED,4,7,2,0,3,266,False,0,0,0,1406,11,2.0722222222222224,Bug
TypeScript,7,6,734.1623726851852,MERGED,12,22,2,0,4,263,False,0,0,0,1428,34,238.88777777777779,Feature
TypeScript,85,724,408.22188657407406,MERGED,72,167,7,0,11,138,False,0,0,0,3156,239,90.76222222222222,Document
TypeScript,202,107,1233.6094675925926,CLOSED,17,201,6,4,8,316,True,1,3,3,1312,218,404.05444444444447,Document
Python,547,7161,2331.8018055555553,MERGED,173,338,10,0,26,323,True,0,0,0,1198,511,91.0875,Bug
Python,547,7161,2327.765162037037,MERGED,0,95,2,1,18,156,False,1,0,0,1323,95,336.46777777777777,Bug
TypeScript,202,107,1238.8206597222222,MERGED,2,2,1,3,1,4,False,0,3,3,403,4,90.81694444444445,Bug
JavaScript,5140,7053,1296.8786805555555,MERGED,29,29,5,1,2,191,False,0,1,1,2370,58,13.779166666666667,Feature
TypeScript,7,6,737.0172337962963,MERGED,4,104,4,1,3,309,False,0,1,1,1432,108,3.701388888888889,Feature
Go,395,660,1357.0158449074074,MERGED,0,23,1,0,1,89,False,0,0,0,202,23,166.07444444444445,Feature
Rust,433,2229,326.1437731481481,MERGED,4,3,2,0,1,210,False,0,0,0,190,7,6.643888888888889,Bug
TypeScript,7,6,736.937962962963,CLOSED,66,4,3,0,2,262,False,0,0,0,1331,70,1.2891666666666666,Bug
TypeScript,15,34,583.7921412037036,MERGED,19,14,1,0,1,1110,False,0,0,0,292,33,0.0325,Feature
Go,1174,11429,1934.9194791666666,MERGED,13,13,8,0,3,683,True,0,0,0,1308,26,2.194722222222222,Bug
TypeScript,7,6,736.1248726851851,MERGED,10,51,7,0,13,62,True,0,0,0,1986,61,46.19083333333333,Feature
TypeScript,15,34,583.681261574074,CLOSED,5,3,1,0,1,1106,False,0,0,0,199,8,1.8530555555555555,Bug
TypeScript,58,78,912.3160300925925,MERGED,57,74,3,1,4,231,True,0,1,1,2680,131,0.8730555555555556,Bug
TypeScript,7,6,737.0803472222223,MERGED,1,4,1,0,6,328,False,0,0,0,279,5,0.3655555555555556,Feature
Vue,293,495,923.7653935185185,MERGED,38,105,10,6,10,11,False,0,6,5,1505,143,27.8625,Bug
Go,1174,11429,1934.5865046296296,CLOSED,16,8,4,1,2,188,True,1,0,0,1417,24,0.3308333333333333,Feature
Python,547,7161,2329.7809722222223,MERGED,1,6,1,0,7,158,False,0,0,0,1401,7,166.56861111111112,Bug
TypeScript,261,3764,768.8343634259259,MERGED,33,32,4,0,1,142,False,0,0,0,3054,65,0.25916666666666666,Document
TypeScript,202,107,1236.6374421296296,MERGED,3,19,1,3,1,305,True,0,3,3,1428,22,143.22722222222222,Bug
TypeScript,202,107,1236.6339351851852,MERGED,14,10,2,3,2,304,True,0,3,3,1584,24,143.31666666666666,Bug
TypeScript,261,3764,768.7081828703704,MERGED,0,62,4,0,1,1076,True,0,0,0,2369,62,0.7080555555555555,Document
TypeScript,12,11,1079.2861805555556,MERGED,124,665,15,1,7,85,False,1,0,0,3240,789,69.64694444444444,Feature
Python,547,7161,2331.329560185185,MERGED,152,522,16,2,18,636,True,1,1,1,1049,674,53.041111111111114,Document
Go,1174,11429,1933.6398958333332,MERGED,43,219,6,1,3,185,True,0,1,1,1475,262,24.504444444444445,Bug
TypeScript,15,34,582.7895138888889,MERGED,1,12,1,0,1,1103,False,0,0,0,251,13,0.23472222222222222,Feature
Go,1835,11246,1820.594050925926,MERGED,133,88,3,0,1,128,False,0,0,0,247,221,2.2875,Feature
TypeScript,15,34,582.706412037037,MERGED,324,340,2,0,2,1101,False,0,0,0,217,664,0.7608333333333334,Bug
Python,547,7161,2331.8199074074073,MERGED,3,74,4,0,8,324,True,0,0,0,996,77,1.8430555555555554,Bug
TypeScript,7,6,735.9786226851852,MERGED,3,15,1,0,1,326,False,0,0,0,448,18,0.2325,Feature
Python,72,25,1727.8128935185186,MERGED,4,27,3,0,1,52,False,0,0,0,1428,31,15.6325,Feature
TypeScript,7,6,735.0958680555556,MERGED,50,70,2,1,11,264,False,0,1,1,1291,120,25.176666666666666,Bug
TypeScript,261,3764,768.0206018518519,MERGED,9,16,2,0,1,279,True,0,0,0,2283,25,0.4002777777777778,Document
Python,547,7161,2328.4235648148147,CLOSED,2843,2920,34,1,10,632,True,1,0,0,522,5763,367.86583333333334,Bug
TypeScript,15,34,582.1210185185186,MERGED,35,57,10,1,8,1100,False,0,1,1,192,92,11.06638888888889,Feature
Java,450,746,4163.272094907407,MERGED,3,37,3,1,7,670,False,0,1,1,321,40,214.74277777777777,Feature
TypeScript,261,3764,767.8368287037038,MERGED,10,13,2,0,1,128,True,0,0,0,2445,23,0.3452777777777778,Document
TypeScript,15,34,582.799699074074,MERGED,27,75,3,0,4,1104,False,0,0,0,409,102,155.99722222222223,Feature
Vue,293,495,922.2713888888889,MERGED,11,3,3,9,1,1,False,2,7,6,1278,14,14.185833333333333,Bug
TypeScript,15,34,581.6223148148148,MERGED,141,969,41,0,17,386,False,0,0,0,201,1110,26.64666666666667,Feature
TypeScript,15,34,581.9628472222222,MERGED,5029,14703,2,0,4,1096,False,0,0,0,269,19732,0.8213888888888888,Feature
TypeScript,15,34,581.9648148148148,MERGED,115,109,2,0,1,1097,False,0,0,0,272,224,0.665,Feature
Go,395,660,1354.9011458333332,MERGED,131,94,11,0,6,149,False,0,0,0,412,225,507.05555555555554,Feature
Vue,293,495,920.77,MERGED,53,353,9,19,35,9,False,7,12,5,1330,406,99.81277777777778,Bug
Go,1174,11429,1936.159837962963,MERGED,690,964,18,2,1,187,True,2,0,0,1860,1654,96.42722222222223,Document
TypeScript,15,34,580.6726851851852,CLOSED,164,2531,47,0,35,1092,False,0,0,0,508,2695,28.769444444444446,Bug
TypeScript,202,107,1233.7534837962962,CLOSED,0,9,1,3,2,3,False,0,3,3,543,9,400.5975,Bug
Go,752,2399,820.6505092592593,MERGED,7,9,2,0,1,324,False,0,0,0,1156,16,0.024722222222222222,Bug
Go,1174,11429,1936.0904513888888,MERGED,38,244,6,2,1,186,True,1,1,1,1888,282,91.8925,Document
TypeScript,261,3764,766.8894675925926,MERGED,46,119,7,0,13,72,False,0,0,0,3094,165,20.743333333333332,Document
TypeScript,149,2900,475.032650462963,MERGED,1,9,1,3,2,133,False,0,3,3,797,10,210.65027777777777,Feature
Go,421,1654,1602.090613425926,MERGED,0,88,8,0,2,123,False,0,0,0,2689,88,95.48833333333333,Document
TypeScript,15,34,584.3765625,MERGED,2,4,2,0,1,393,False,0,0,0,385,6,1.1044444444444443,Feature
TypeScript,15,34,584.3764930555556,MERGED,68,80,13,0,2,392,False,0,0,0,280,148,1.0719444444444444,Bug
Vue,293,495,921.9132175925926,MERGED,0,53,2,5,1,10,False,0,5,4,1118,53,20.92222222222222,Bug
TypeScript,15,34,581.1687384259259,CLOSED,277,333,6,0,14,210,False,0,0,0,240,610,7.461111111111111,Feature
TypeScript,202,107,1236.7537615740741,MERGED,44,29,3,3,2,324,True,0,3,3,1806,73,18.6975,Document
TypeScript,261,3764,766.8469212962963,MERGED,2,43,4,0,1,45,False,0,0,0,2639,45,0.24138888888888888,Document
TypeScript,15,34,584.0359606481481,MERGED,173,108,23,0,3,1111,False,0,0,0,290,281,0.6402777777777777,Bug
TypeScript,7,6,737.0149652777777,MERGED,6,15,4,0,4,327,False,0,0,0,427,21,1.1305555555555555,Feature
TypeScript,7,6,734.1884143518519,CLOSED,373,0,8,1,1,321,False,0,1,1,324,373,18.698333333333334,Feature
TypeScript,15,34,583.7544444444444,MERGED,13,23,3,0,2,1108,False,0,0,0,311,36,0.8827777777777778,Feature
Go,752,2399,819.6422685185184,MERGED,7,6,2,0,1,478,False,0,0,0,1539,13,0.22555555555555556,Bug
Go,395,660,1355.9180324074075,MERGED,6,28,1,0,4,152,False,0,0,0,190,34,26.175833333333333,Bug
TypeScript,7,6,734.167349537037,MERGED,4339,6770,1275,0,7,320,False,0,0,0,314,11109,1.6266666666666667,Feature
TypeScript,7,6,734.1891550925926,MERGED,4489,0,92,0,1,322,False,0,0,0,264,4489,0.3005555555555556,Feature
Vue,293,495,923.7724305555556,MERGED,17,405,10,24,17,2,False,7,17,6,1908,422,170.16833333333332,Bug
TypeScript,15,34,583.5320833333334,MERGED,1,3,1,0,1,168,False,0,0,0,315,4,3.087222222222222,Feature
TypeScript,7,6,734.0976273148149,MERGED,0,6,3,0,1,319,False,0,0,0,313,6,0.35583333333333333,Feature
Python,19251,70268,2550.422962962963,CLOSED,180,99,45,1,2,1655,False,1,0,0,366,279,4.6125,Feature
TypeScript,15,34,580.3870717592592,MERGED,30,113,14,0,4,382,False,0,0,0,215,143,1.8352777777777778,Bug
TypeScript,15,34,583.4207638888889,MERGED,14,95,7,0,5,390,False,0,0,0,325,109,4.000555555555556,Feature
Vue,10811,21164,1113.3390162037037,MERGED,1,3,1,3,1,7,False,1,2,2,1859,4,86.60805555555555,Bug
TypeScript,85,724,405.18591435185186,MERGED,115,149,1,0,1,209,False,0,0,0,3315,264,0.1638888888888889,Document
Go,395,660,1355.836689814815,MERGED,2,2,1,0,2,151,False,0,0,0,238,4,2.0375,Feature
Vue,293,495,921.0568171296296,MERGED,0,83,9,7,1,432,False,0,7,5,1053,83,1.7822222222222222,Bug
JavaScript,5140,7053,1296.6501157407408,MERGED,25,727,11,2,7,95,False,1,1,1,3101,752,143.95277777777778,Feature
TypeScript,85,724,405.1289236111111,MERGED,15,23,1,0,1,71,False,0,0,0,3330,38,0.22111111111111112,Document
JavaScript,9664,43890,3749.1101273148147,MERGED,1,0,1,0,1,86,True,0,0,0,356,1,0.2152777777777778,Feature
Go,1174,11429,1934.9568981481482,MERGED,21,22,4,1,3,390,True,1,0,0,1754,43,66.66416666666667,Document
TypeScript,42,46,862.0339004629631,MERGED,2,3,2,1,2,190,False,0,1,1,391,5,17.400555555555556,Document
JavaScript,5140,7053,1295.6557060185185,MERGED,21,341,9,2,9,350,False,1,1,1,2637,362,190.83027777777778,Feature
Go,395,660,1357.230162037037,MERGED,41,201,4,1,4,39,False,0,1,1,590,242,475.70194444444445,Feature
TypeScript,15,34,582.9277662037038,MERGED,1,1,1,0,1,88,False,0,0,0,280,2,0.013055555555555556,Feature
Vue,10811,21164,1114.0447685185184,MERGED,3,6,1,2,1,1,False,0,2,2,1581,9,4.938055555555556,Bug
TypeScript,15,34,579.6870138888888,MERGED,1,1,1,0,1,1091,False,0,0,0,219,2,2.2794444444444446,Feature
Go,752,2399,818.6084375,MERGED,76,110,6,0,12,473,False,0,0,0,1439,186,3.975277777777778,Bug
TypeScript,15,34,582.6825694444444,MERGED,98,153,2,0,5,388,False,0,0,0,382,251,1.9136111111111112,Feature
JavaScript,9664,43890,3751.1373379629626,MERGED,24,85,3,0,2,31,False,0,0,0,486,109,0.49,Feature
TypeScript,202,107,1238.609849537037,MERGED,40,40,2,3,2,13,False,0,3,3,1897,80,95.88416666666667,Bug
TypeScript,7,6,734.141087962963,MERGED,46,49,5,0,9,261,False,0,0,0,2063,95,217.1288888888889,Feature
JavaScript,9664,43890,3750.878564814815,MERGED,1,4,1,0,1,339,True,0,0,0,416,5,0.14694444444444443,Bug
TypeScript,15,34,582.400636574074,MERGED,34,18,7,0,6,387,False,0,0,0,397,52,1.4269444444444443,Feature
Go,1174,11429,1933.2110300925926,MERGED,2,6,2,0,2,95,False,0,0,0,1951,8,110.56472222222222,Document
TypeScript,202,107,1234.4621296296298,MERGED,4,7,2,3,2,271,True,0,3,3,1401,11,27.25027777777778,Document
TypeScript,202,107,1234.5839583333334,MERGED,5,18,2,3,3,302,True,0,3,3,1862,23,7.88,Bug
JavaScript,9664,43890,3747.889039351852,MERGED,16,16,2,0,1,84,True,0,0,0,273,32,0.8575,Bug
C#,80,125,913.4131944444445,MERGED,1,1,1,0,1,22,False,0,0,0,500,2,4.04,Document
TypeScript,7,6,734.8521180555555,MERGED,766,1385,245,0,6,323,False,0,0,0,501,2151,2.8080555555555557,Feature
TypeScript,15,34,581.9522800925926,MERGED,72,55,2,0,1,1094,False,0,0,0,274,127,0.4011111111111111,Bug
Go,1174,11429,1934.240925925926,MERGED,3,3,3,0,1,99,False,0,0,0,1827,6,14.529722222222222,Document
TypeScript,307,2556,629.4782523148148,MERGED,0,4,1,1,1,34,False,0,1,1,920,4,4.131666666666667,Bug
Python,547,7161,2327.656099537037,MERGED,1,1,1,0,5,252,False,0,0,0,1042,2,1.081388888888889,Bug
Go,1174,11429,1934.102199074074,MERGED,2,6,1,0,1,98,False,0,0,0,1787,8,17.8425,Document
Vue,10811,21164,1112.7873032407408,MERGED,1,100,1,0,1,204,False,0,0,0,1710,101,9.889166666666666,Bug
Go,1174,11429,1933.8829513888888,CLOSED,6,6,6,0,4,97,False,0,0,0,1715,12,8.639722222222222,Document
Go,1174,11429,1933.9341087962964,MERGED,16,26,1,1,1,486,True,1,0,0,1811,42,3.959722222222222,Document
JavaScript,9664,43890,3747.4543055555555,MERGED,153,154,2,3,6,0,False,2,1,1,488,307,373.4269444444444,Feature
TypeScript,15,34,581.3930439814815,MERGED,3,8,1,0,1,384,False,0,0,0,272,11,1.5266666666666666,Feature
JavaScript,5140,7054,1296.7860532407408,MERGED,33,83,8,1,3,118,False,0,1,1,2914,116,0.21666666666666667,Document
Rust,433,2229,325.7027777777778,MERGED,30,6,1,0,1,1168,False,0,0,0,393,36,1.3933333333333333,Feature
TypeScript,261,3764,767.5076504629629,MERGED,46,50,7,0,1,54,False,0,0,0,2269,96,3.4658333333333333,Document
Go,1174,11429,1933.7268287037039,MERGED,1,10,2,0,1,485,True,0,0,0,1898,11,0.018055555555555554,Document
TypeScript,15,34,583.6163773148148,MERGED,81,160,9,0,3,1105,False,0,0,0,461,241,0.505,Feature
Go,1174,11429,1933.638263888889,MERGED,0,1,1,0,1,147,True,0,0,0,1663,1,0.09333333333333334,Document
Go,1174,11429,1933.6356828703704,MERGED,1,10,2,2,1,484,True,1,1,1,1904,11,0.07194444444444445,Document
Go,1174,11429,1933.275150462963,MERGED,0,28,1,0,1,96,False,0,0,0,1842,28,20.87472222222222,Document
JavaScript,9664,43890,3749.0977546296294,MERGED,19,5,5,0,3,85,True,0,0,0,462,24,19.169722222222223,Feature
JavaScript,9664,43890,3746.8244907407407,MERGED,54,578,2,0,1,81,True,0,0,0,251,632,0.21472222222222223,Feature
JavaScript,5140,7054,1295.5062152777778,MERGED,20,280,8,1,3,114,False,0,1,1,2764,300,49.56916666666667,Feature
Go,395,660,1357.144236111111,MERGED,95,162,10,0,5,153,False,0,0,0,498,257,114.61194444444445,Feature
Go,1174,11429,1933.2528935185185,MERGED,6,83,2,0,1,503,False,0,0,0,2071,89,0.12555555555555556,Document
TypeScript,2070,16643,1335.5025925925927,MERGED,0,1,1,0,1,1,False,0,0,0,2472,1,353.23333333333335,Bug
Go,1174,11429,1933.121875,MERGED,1,0,1,0,1,94,False,0,0,0,1835,1,0.08666666666666667,Document
TypeScript,261,3764,771.4397337962963,MERGED,3,79,5,0,1,1077,True,0,0,0,3477,82,24.996388888888887,Document
Go,54,355,824.2488888888888,MERGED,5,84,3,1,2,1,False,0,1,1,2068,89,135.04916666666668,Bug
JavaScript,5140,7054,1294.7356712962962,MERGED,21,577,11,1,6,349,False,0,1,1,3207,598,67.98388888888888,Feature
Go,1174,11429,1932.890428240741,MERGED,5,1,1,0,1,113,False,0,0,0,1848,6,0.1411111111111111,Document
PHP,1334,2960,4296.953726851852,MERGED,2,2,1,1,1,178,False,0,1,1,2354,4,22.524444444444445,Document
TypeScript,15,34,579.3348726851851,CLOSED,5,61,7,0,4,207,False,0,0,0,351,66,43.71722222222222,Feature
TypeScript,178,1359,415.56425925925925,MERGED,42,45,2,1,1,23,True,0,1,1,4601,87,0.12305555555555556,Bug
TypeScript,307,2556,627.603599537037,MERGED,1,1,1,1,1,316,True,0,1,1,1006,2,1.05,Bug
TypeScript,15,34,579.6716087962963,CLOSED,9,191,13,1,4,381,False,1,0,0,525,200,403.0602777777778,Feature
TypeScript,1297,21107,508.7520949074074,MERGED,10,30,2,1,2,1267,True,0,1,1,2113,40,0.5297222222222222,Document
Go,1174,11429,1931.6719444444443,CLOSED,0,1,1,0,1,387,True,0,0,0,1741,1,48.57194444444445,Document
Java,450,746,4165.1328125,MERGED,11,108,2,1,1,18,False,0,1,1,666,119,141.39333333333335,Feature
TypeScript,15,34,582.0818518518519,MERGED,27,52,6,0,2,1099,False,0,0,0,430,79,7.471666666666667,Feature
TypeScript,15,34,582.0802083333333,MERGED,24,60,6,0,1,1098,False,0,0,0,632,84,7.446111111111111,Feature
Go,395,660,1357.790474537037,MERGED,17,20,2,0,1,154,False,0,0,0,398,37,1.288888888888889,Feature
TypeScript,202,107,1236.9702546296296,MERGED,8,8,4,3,1,306,True,0,3,3,2229,16,13.545,Bug
Vue,293,495,920.7576041666666,CLOSED,43,76,15,8,3,1,False,3,5,4,1846,119,12.502777777777778,Bug
TypeScript,58,78,910.5922569444446,MERGED,373,718,6,1,4,199,False,0,1,1,3874,1091,183.25277777777777,Feature
TypeScript,15,34,581.9601388888889,MERGED,1242,1956,2,0,1,1095,False,0,0,0,413,3198,0.7752777777777777,Feature
TypeScript,15,34,579.39,MERGED,1,4,2,0,1,380,False,0,0,0,342,5,1.7925,Bug
TypeScript,41369,87415,3029.7335879629627,CLOSED,1,1,1,3,1,658,True,0,3,3,2062,2,0.8272222222222222,Document
JavaScript,5140,7054,1294.5819791666665,MERGED,21,221,8,2,5,282,False,1,1,1,2701,242,28.731666666666666,Feature
TypeScript,261,3764,769.7867708333333,MERGED,84,132,6,0,2,272,False,0,0,0,3086,216,68.89,Document
Go,395,660,1354.8478125,MERGED,34,121,2,0,4,148,False,0,0,0,491,155,166.5547222222222,Feature
Go,30,295,441.26598379629627,MERGED,4,228,8,1,1,119,True,0,1,1,2875,232,0.12666666666666668,Feature
Go,30,295,441.22194444444443,MERGED,1,198,8,1,2,118,True,0,1,1,2509,199,0.6605555555555556,Feature
Vue,293,495,919.8466319444445,MERGED,1,1,1,4,1,325,True,0,4,3,474,2,0.8488888888888889,Bug
Go,30,295,440.96802083333336,MERGED,0,256,5,1,1,115,True,0,1,1,2757,256,0.1225,Feature
TypeScript,15,34,580.8087962962962,MERGED,2,38,5,0,14,86,False,0,0,0,404,40,48.541111111111114,Document
TypeScript,15,34,581.4577777777778,MERGED,77,110,7,0,1,385,False,0,0,0,509,187,0.29333333333333333,Bug
JavaScript,9664,43890,3750.9820949074074,MERGED,1,1,1,0,1,340,True,0,0,0,478,2,4.618611111111111,Bug
Go,752,2399,819.6109027777778,MERGED,13,32,3,0,2,316,False,0,0,0,2012,45,0.05416666666666667,Bug
C#,80,125,911.4726273148149,MERGED,2,2,2,2,2,194,True,1,1,1,676,4,48.28333333333333,Document
TypeScript,41369,87415,3030.9372222222223,MERGED,0,28,1,2,1,1676,True,0,2,2,1912,28,2.492777777777778,Document
TypeScript,7,6,735.177349537037,MERGED,14,67,2,0,1,325,False,0,0,0,690,81,17.203611111111112,Feature
JavaScript,9664,43890,3747.076307870371,MERGED,11,11,2,0,1,83,True,0,0,0,390,22,0.2311111111111111,Bug
JavaScript,9664,43890,3747.0159027777777,MERGED,11,11,2,0,1,82,True,0,0,0,440,22,0.26472222222222225,Bug
TypeScript,12,11,1082.3121643518518,MERGED,52,582,25,0,58,52,False,0,0,0,1023,634,164.8022222222222,Feature
TypeScript,15,34,579.5361111111112,MERGED,233,1363,26,0,31,533,True,0,0,0,487,1596,92.74416666666667,Document
Python,547,7161,2327.763287037037,MERGED,1,68,3,0,8,155,False,0,0,0,954,69,187.02388888888888,Bug
Python,547,7161,2330.577199074074,MERGED,426,505,8,0,13,635,True,0,0,0,647,931,3.3194444444444446,Feature
JavaScript,9664,43890,3750.0644444444442,CLOSED,2,16,1,0,1,338,True,0,0,0,505,18,21.080555555555556,Feature
Python,547,7161,2330.6024537037038,MERGED,0,22,2,1,16,1,False,0,1,1,952,22,362.6175,Bug
Go,1174,11429,1930.8630555555555,CLOSED,0,14,1,0,1,112,False,0,0,0,1682,14,0.22805555555555557,Document
Go,1174,11429,1930.843090277778,MERGED,0,2,1,2,1,1,True,1,1,1,1669,2,1.01,Document
V,2097,34362,1646.742650462963,MERGED,44,59,4,2,8,71,True,2,0,0,2784,103,34.46805555555556,Document
C#,655,7879,1921.1577662037037,MERGED,13,7,1,1,1,69,True,0,1,1,1260,20,22.011111111111113,Document
TypeScript,15,34,583.78875,MERGED,58,61,6,0,2,1109,False,0,0,0,766,119,0.0125,Bug
Go,752,2399,819.6558333333334,MERGED,7,6,2,0,1,480,False,0,0,0,593,13,19.098333333333333,Bug
Vue,293,495,919.7679398148148,MERGED,40,86,6,16,9,82,False,5,11,7,1737,126,31.427777777777777,Bug
TypeScript,15,34,579.9468402777778,MERGED,7,9,4,0,8,84,False,0,0,0,444,16,0.029722222222222223,Feature
F#,153,337,3010.063969907407,MERGED,692,1085,27,10,67,188,False,7,3,2,3866,1777,306.5886111111111,Bug
TypeScript,41369,87415,3029.9027314814816,MERGED,8,9,5,9,10,0,False,3,6,4,2571,17,397.8125,Document
TypeScript,41370,87415,3029.455868055555,CLOSED,1,1,1,2,2,657,True,0,2,2,2055,2,3.1597222222222223,Document
TypeScript,1297,21107,505.9949884259259,MERGED,89,107,12,1,6,1255,True,0,1,1,1931,196,0.4925,Document
TypeScript,15,34,583.3910763888889,MERGED,22,208,9,0,3,389,False,0,0,0,525,230,0.5702777777777778,Bug
Java,450,746,4164.1755439814815,MERGED,47,82,12,2,3,44,False,0,2,1,702,129,44.35194444444444,Feature
JavaScript,9664,43890,3749.175648148148,MERGED,225,18,7,0,4,337,True,0,0,0,570,243,1.0966666666666667,Feature
TypeScript,307,2556,629.6960879629629,MERGED,0,2,1,1,1,596,True,0,1,1,1131,2,0.5733333333333334,Feature
TypeScript,2070,16643,1334.0371412037036,CLOSED,1,1,1,0,1,0,False,0,0,0,2303,2,214.71944444444443,Bug
PHP,1334,2960,4300.123321759259,MERGED,5,82,4,1,4,181,False,0,1,1,3993,87,141.6338888888889,Document
PHP,1334,2960,4300.021377314814,MERGED,38,49,2,1,3,180,False,0,1,1,3658,87,142.20944444444444,Document
Go,1174,11429,1934.7695138888887,MERGED,134,9,4,4,1,403,True,4,0,0,2698,143,101.26166666666667,Document
PHP,883,2338,1923.087650462963,CLOSED,1,24,3,5,1,0,False,1,4,3,2968,25,327.22777777777776,Document
V,2097,34362,1641.4530787037038,MERGED,0,7,3,0,1,234,True,0,0,0,1839,7,16.14388888888889,Document
TypeScript,41370,87415,3028.5963541666665,MERGED,6,3,1,2,2,46,False,0,2,2,2151,9,0.6127777777777778,Document
Go,1174,11429,1935.0121990740743,MERGED,20,36,4,1,3,391,True,1,0,0,2374,56,65.97,Document
TypeScript,261,3764,767.7159606481482,MERGED,160,117,12,0,2,1072,True,0,0,0,3388,277,0.6261111111111111,Document
JavaScript,9664,43890,3748.228414351852,MERGED,0,1,1,0,1,36,False,0,0,0,580,1,0.3236111111111111,Document
Vue,10811,21164,1113.7911574074074,MERGED,1,1,1,1,1,0,False,0,1,1,1046,2,3.8544444444444443,Document
TypeScript,202,107,1238.6248958333333,MERGED,9,20,6,3,1,75,True,0,3,3,2805,29,126.74083333333333,Document
Go,1174,11429,1935.0536458333333,MERGED,3,3,3,0,1,101,False,0,0,0,2666,6,30.841666666666665,Document
TypeScript,41370,87415,3026.4761458333337,MERGED,1,1,1,3,1,1667,True,0,3,3,2025,2,0.4736111111111111,Document
TypeScript,2070,16643,1335.839351851852,CLOSED,5,5,1,2,1,80,True,1,1,1,2382,10,33.35,Bug
TypeScript,15,34,581.8082523148148,MERGED,164,2536,47,0,38,1093,False,0,0,0,674,2700,1.511388888888889,Bug
TypeScript,261,3764,766.7087615740742,MERGED,0,107,9,0,1,220,False,0,0,0,3843,107,5.8902777777777775,Document
TypeScript,7,6,737.2164930555556,MERGED,64,64,5,0,9,25,False,0,0,0,2666,128,21.11,Bug
Go,1174,11429,1934.9475925925926,MERGED,5,9,1,0,1,100,False,0,0,0,2079,14,0.08638888888888889,Document
TypeScript,41370,87415,3027.4738310185185,MERGED,1,0,1,2,1,1670,True,0,2,2,2160,1,0.7030555555555555,Document
TypeScript,7,6,736.9509490740742,MERGED,78,670,6,0,13,265,False,0,0,0,3339,748,27.950555555555557,Feature
JavaScript,5140,7054,1295.8917129629629,MERGED,21,671,13,3,8,351,False,1,2,2,3842,692,41.94916666666666,Document
Go,1174,11429,1934.139050925926,MERGED,2,2,1,1,1,187,True,1,0,0,2358,4,2.1744444444444446,Document
TypeScript,15,34,579.5981134259259,MERGED,6,11,4,0,1,1090,False,0,0,0,579,17,56.89055555555556,Feature
Go,2083,11770,1608.830798611111,MERGED,20,34,5,0,1,957,True,0,0,0,2063,54,0.2561111111111111,Document
Go,421,1654,1600.9013541666666,MERGED,61,34,2,0,2,516,True,0,0,0,3680,95,4.251944444444445,Bug
TypeScript,1297,21107,509.5780555555555,MERGED,16,73,12,1,4,1272,True,0,1,1,3320,89,0.6958333333333333,Document
C#,655,7879,1920.1988888888889,MERGED,190,238,3,4,1,626,True,0,4,3,1808,428,379.39166666666665,Document
Go,1174,11429,1932.7508449074076,MERGED,16,48,2,4,3,389,True,4,0,0,2365,64,22.708333333333332,Document
Go,1174,11429,1933.0794097222222,MERGED,3,3,3,0,1,92,False,0,0,0,2431,6,0.4558333333333333,Document
TypeScript,4,33,856.2424421296296,MERGED,6,15,2,2,2,286,True,1,1,1,885,21,0.1275,Feature
Go,421,1654,1600.1281597222223,MERGED,35,37,3,0,1,254,False,0,0,0,4438,72,20.58222222222222,Bug
TypeScript,1297,21107,508.95855324074074,MERGED,12,25,8,1,3,1268,True,0,1,1,3019,37,0.3358333333333333,Document
JavaScript,5140,7054,1293.9161458333333,MERGED,8,549,10,3,21,71,False,2,1,1,4304,557,186.64416666666668,Feature
TypeScript,7,6,734.8984027777778,MERGED,17,35,9,0,12,60,True,0,0,0,3140,52,6.601388888888889,Feature
Go,1174,11429,1931.9789583333334,MERGED,4,4,1,2,1,233,False,2,0,0,2164,8,23.9,Document
Go,1174,11429,1931.9175694444446,MERGED,40,104,6,2,1,401,True,2,0,0,2398,144,24.873333333333335,Document
Go,1174,11429,1931.953900462963,MERGED,49,216,5,1,1,482,True,1,0,0,2533,265,16.801388888888887,Document
Go,1174,11429,1932.1433101851853,MERGED,2,24,2,1,1,483,True,1,0,0,1943,26,0.8716666666666667,Document
Go,421,1654,1599.1966435185186,MERGED,115,264,9,0,1,515,True,0,0,0,3991,379,41.18083333333333,Bug
Go,1174,11429,1931.7411226851852,MERGED,37,78,1,4,1,480,True,3,1,1,2358,115,0.19083333333333333,Document
Java,450,746,4163.195509259259,MERGED,49,539,9,0,7,753,False,0,0,0,3606,588,143.15527777777777,Feature
Go,1174,11429,1931.327928240741,MERGED,0,1,1,1,1,130,False,1,0,0,2552,1,14.2575,Document
TypeScript,41370,87415,3028.8951851851853,MERGED,25,26,4,10,2,0,False,1,9,5,2390,51,167.65333333333334,Document
Python,137,75,778.354837962963,MERGED,61,788,32,2,52,7,False,0,2,2,1257,849,450.8097222222222,Document
TypeScript,1297,21107,508.00574074074075,MERGED,23,3,3,1,1,1261,True,0,1,1,2642,26,0.04833333333333333,Document
Go,1174,11429,1930.8694097222224,MERGED,19,92,4,6,8,682,True,1,5,1,2108,111,25.961944444444445,Document
JavaScript,34,25,290.32778935185183,MERGED,0,5,2,0,1,41,False,0,0,0,941,5,0.2652777777777778,Bug
Go,1174,11429,1930.9155324074075,MERGED,26,31,4,3,1,385,True,2,1,1,2424,57,16.988333333333333,Document
Go,1174,11429,1930.836400462963,MERGED,2,5,1,2,1,478,True,1,1,1,2416,7,17.570833333333333,Document
TypeScript,15,34,580.458888888889,MERGED,65,74,3,0,2,208,False,0,0,0,727,139,210.28833333333333,Bug
TypeScript,15,34,583.7199652777778,MERGED,39,37,8,0,1,1107,False,0,0,0,745,76,0.014166666666666666,Feature
Go,1174,11429,1930.7274189814816,MERGED,1,18,3,2,2,384,True,2,0,0,2664,19,2.8194444444444446,Document
Erlang,2054,12122,3886.0025810185184,MERGED,5,6,1,0,1,149,False,0,0,0,875,11,2.5966666666666667,Document
JavaScript,9664,43890,3748.9829861111107,MERGED,4,7,1,0,1,336,True,0,0,0,649,11,0.23694444444444446,Bug
V,2097,34362,1642.599513888889,MERGED,18,98,3,0,2,69,True,0,0,0,2807,116,17.547777777777778,Document
Java,450,746,4164.010925925926,MERGED,1,0,1,1,2,24,False,0,1,1,923,1,1.5852777777777778,Bug
TypeScript,15,34,582.3855787037037,MERGED,433,707,26,0,13,167,False,0,0,0,734,1140,26.407222222222224,Feature
TypeScript,15,34,582.7108101851852,MERGED,29,214,17,0,4,211,False,0,0,0,956,243,1.0977777777777777,Bug
JavaScript,9664,43890,3747.0496296296296,MERGED,6,61,4,1,2,337,True,1,0,0,771,67,93.17583333333333,Feature
TypeScript,149,2900,469.98214120370375,MERGED,1,1,1,2,1,130,False,1,1,1,887,2,0.02277777777777778,Bug
TypeScript,149,2900,469.98141203703705,MERGED,1,1,1,1,1,129,False,0,1,1,878,2,0.009444444444444445,Feature
TypeScript,41370,87415,3029.5994097222224,MERGED,1,9,2,2,3,1674,True,0,2,2,2652,10,1.2852777777777777,Document
JavaScript,5140,7054,1293.7696875,MERGED,25,433,12,1,4,348,False,0,1,1,4138,458,19.398611111111112,Document
C#,655,7879,1918.3291203703702,MERGED,2,40,2,4,1,90,False,0,4,3,1359,42,27.698611111111113,Document
TypeScript,4,33,855.8580439814815,CLOSED,0,122,1,1,2,80,False,0,1,1,1270,122,441.9888888888889,Document
TypeScript,41370,87415,3026.7235416666667,MERGED,1,12,2,3,1,1965,True,0,3,3,2737,13,2.977777777777778,Document
Python,137,75,778.121423611111,MERGED,0,315,13,0,29,2,False,0,0,0,1078,315,334.64694444444444,Bug
TypeScript,2070,16643,1335.5218750000001,MERGED,15,17,1,0,1,0,False,0,0,0,4354,32,352.4638888888889,Document
TypeScript,41370,87415,3028.9966435185183,MERGED,2,11,1,2,2,656,True,0,2,2,2867,13,14.133333333333333,Document
TypeScript,41370,87415,3028.9910648148148,MERGED,2,692,46,2,2,1966,True,0,2,2,2438,694,1.3202777777777779,Document
TypeScript,41370,87415,3028.6732060185186,MERGED,3,3,3,2,1,1672,True,0,2,2,2721,6,0.8083333333333333,Document
TypeScript,202,107,1233.723912037037,MERGED,7,13,5,2,3,301,True,0,2,2,2762,20,0.5238888888888888,Document
C#,655,7879,1921.1653819444446,MERGED,74,123,10,3,4,628,True,1,2,2,1764,197,27.192222222222224,Document
TypeScript,12,11,1082.442511574074,MERGED,30,269,11,0,70,53,False,0,0,0,5671,299,161.8713888888889,Feature
PHP,883,2338,1923.9004282407407,CLOSED,5,5,3,0,1,0,False,0,0,0,3302,10,23.265555555555554,Document
Go,30,295,441.27878472222227,MERGED,0,191,7,1,2,120,True,0,1,1,3455,191,0.27194444444444443,Feature
TypeScript,202,107,1235.4951157407406,MERGED,14,12,6,5,4,303,True,1,4,3,4299,26,502.7191666666667,Bug
TypeScript,15,34,580.4959722222222,MERGED,81,1081,43,0,10,383,False,0,0,0,812,1162,3.120277777777778,Feature
TypeScript,41370,87415,3027.6773263888886,MERGED,1,1,1,3,1,75,False,0,3,3,2220,2,0.6733333333333333,Document
C#,655,7879,1918.2251967592592,MERGED,82,115,16,1,7,623,True,0,1,1,1783,197,20.755277777777778,Document
TypeScript,41370,87415,3027.621099537037,MERGED,2,2,1,2,1,652,True,0,2,2,2501,4,0.6930555555555555,Document
C#,80,125,913.6348032407408,CLOSED,2,84,1,0,2,105,False,0,0,0,1088,86,143.78444444444443,Document
TypeScript,41370,87415,3026.9427083333335,MERGED,0,3,1,2,2,651,True,0,2,2,2265,3,12.379444444444445,Document
TypeScript,41370,87415,3026.772118055556,MERGED,0,8,2,1,4,156,True,0,1,1,2386,8,21.410555555555554,Document
TypeScript,41370,87415,3026.700636574074,MERGED,0,1,1,2,1,1964,True,0,2,2,2305,1,21.32111111111111,Document
C#,655,7879,1919.1210069444444,MERGED,102,117,1,5,4,24,False,1,4,3,1893,219,54.7375,Document
TypeScript,3393,2334,1059.9195023148147,MERGED,3,7,2,2,1,524,False,0,2,1,1573,10,0.38805555555555554,Bug
TypeScript,41370,87415,3026.6569675925925,MERGED,2,3,1,2,1,1669,True,0,2,2,2532,5,0.6913888888888889,Document
C#,655,7879,1921.3228240740739,MERGED,30,216,10,5,5,20,False,2,3,2,2384,246,343.49305555555554,Document
TypeScript,41370,87415,3026.6080439814814,MERGED,38,120,8,2,3,1668,True,0,2,2,3038,158,0.9686111111111111,Document
Python,137,75,778.2923726851851,CLOSED,0,194,10,0,5,2,False,0,0,0,1663,194,113.85583333333334,Bug
C++,363,552,627.0859722222223,CLOSED,39,66,5,0,5,310,False,0,0,0,1709,105,407.9236111111111,Document
TypeScript,12,11,1080.5375578703704,MERGED,5,227,9,0,4,415,False,0,0,0,5497,232,124.79416666666667,Feature
Erlang,2054,12122,3885.1761574074076,MERGED,5,63,5,0,3,58,False,0,0,0,1355,68,335.99333333333334,Document
Erlang,2054,12122,3888.4137962962964,MERGED,9,73,9,3,1,445,False,1,2,1,1313,82,136.85472222222222,Document
TypeScript,85,724,409.15459490740744,MERGED,336,392,23,0,10,123,False,0,0,0,8137,728,0.7772222222222223,Document
Erlang,2054,12122,3888.972847222222,MERGED,2,51,5,0,2,413,True,0,0,0,1376,53,75.335,Document
TypeScript,261,3764,769.7072569444445,MERGED,88,81,17,0,3,225,False,0,0,0,6393,169,96.46694444444445,Document
TypeScript,261,3764,769.5153356481482,MERGED,20,42,11,0,2,224,False,0,0,0,5958,62,101.21472222222222,Document
TypeScript,7,6,734.0652777777777,MERGED,11,141,3,0,22,260,False,0,0,0,3411,152,237.98722222222221,Feature
C#,655,7879,1920.1671180555556,MERGED,139,153,6,4,9,625,True,0,4,4,2077,292,285.6586111111111,Document
C#,655,7879,1921.8652546296296,CLOSED,2,13,2,2,2,707,True,1,1,1,2241,15,171.2913888888889,Document
TypeScript,3393,2334,1061.3843055555556,MERGED,11,10,2,2,1,0,False,0,2,1,1377,21,81.68111111111111,Feature
Python,137,75,776.1181828703703,MERGED,1,29,4,0,3,115,False,0,0,0,1575,30,1.6266666666666667,Bug
TypeScript,261,3764,768.8448032407408,MERGED,112,358,14,0,1,144,False,0,0,0,7347,470,88.10638888888889,Document
TypeScript,85,724,406.9425347222222,MERGED,200,576,9,0,4,136,False,0,0,0,6116,776,45.56916666666667,Document
Erlang,2054,12122,3888.7280787037034,MERGED,0,14,1,0,1,412,True,0,0,0,1256,14,4.191388888888889,Document
Erlang,2054,12122,3888.7280787037034,MERGED,5,9,5,0,1,259,True,0,0,0,1341,14,2.2197222222222224,Document
C#,655,7879,1921.8921759259258,MERGED,5,5,2,0,1,709,True,0,0,0,2376,10,129.76527777777778,Document
Erlang,2054,12122,3888.690462962963,CLOSED,3,3,3,0,1,411,True,0,0,0,1337,6,1.086111111111111,Document
C#,655,7879,1922.9759606481482,MERGED,2,1,1,1,1,713,True,0,1,1,2210,3,58.217777777777776,Document
C#,655,7879,1922.965613425926,MERGED,6,0,1,1,1,712,True,0,1,1,2244,6,58.509166666666665,Document
C#,655,7879,1921.8867361111113,MERGED,3,2,1,3,1,708,True,0,3,3,2198,5,126.30805555555555,Document
TypeScript,3393,2334,1059.1265162037037,MERGED,25,73,6,3,6,523,False,0,3,2,1435,98,186.00944444444445,Feature
TypeScript,85,724,406.3100231481481,MERGED,166,113,7,0,3,212,False,0,0,0,7860,279,68.48444444444445,Document
TypeScript,58,78,911.2116550925925,CLOSED,18,242,16,1,13,230,True,0,1,1,7876,260,2.7855555555555553,Feature
Erlang,2054,12122,3886.1209143518518,MERGED,38,710,20,0,1,441,True,0,0,0,1335,748,41.559444444444445,Document
Go,1174,11429,1933.7054629629629,MERGED,7,8,1,3,1,186,True,2,1,1,3015,15,6.2972222222222225,Document
Erlang,2054,12122,3887.8925694444442,MERGED,192,197,10,0,1,409,True,0,0,0,1513,389,23.744444444444444,Document
Python,2409,12194,332.26350694444443,MERGED,21,25,3,0,10,438,True,0,0,0,1606,46,19.68888888888889,Document
TypeScript,3393,2334,1061.2146875,MERGED,0,6,2,1,1,181,False,0,1,1,1684,6,0.17805555555555555,Document
TypeScript,3393,2334,1061.223414351852,MERGED,2,2,2,1,1,391,False,0,1,1,1419,4,0.06472222222222222,Bug
Erlang,2054,12122,3887.5530787037037,CLOSED,1,1,1,1,1,444,False,0,1,1,1194,2,12.571111111111112,Document
TypeScript,261,3764,768.6896412037037,MERGED,13,59,10,0,2,223,False,0,0,0,5843,72,23.134166666666665,Document
Starlark,440,286,581.9831134259259,CLOSED,0,377,34,4,2,0,False,1,3,2,1403,377,23.511388888888888,Document
Go,421,1654,1602.9446990740742,CLOSED,45,324,6,1,1,255,False,1,0,0,5777,369,70.87527777777778,Bug
TypeScript,1297,21107,510.0006481481482,MERGED,607,503,7,1,3,1278,True,0,1,1,4711,1110,0.20833333333333334,Document
TypeScript,21,40,2378.837997685185,MERGED,0,5,1,1,1,60,False,0,1,1,1143,5,0.6677777777777778,Feature
TypeScript,3393,2334,1061.0627430555555,MERGED,1,2,1,1,1,390,False,0,1,1,1197,3,0.5925,Bug
Go,1174,11429,1933.0932060185185,MERGED,5,6,1,0,1,93,False,0,0,0,3145,11,1.791388888888889,Document
TypeScript,3393,2334,1061.0350115740741,MERGED,2,50,1,1,2,774,False,0,1,1,1563,52,0.4313888888888889,Feature
C#,655,7879,1921.0362037037037,MERGED,10,2,4,2,1,706,True,0,2,2,2379,12,104.375,Document
TypeScript,3393,2334,1061.0014467592594,MERGED,2,2,1,1,1,773,False,0,1,1,1432,4,0.5180555555555556,Bug
Go,1174,11429,1931.682048611111,MERGED,42,174,12,6,9,232,False,3,3,2,3906,216,51.5425,Document
Erlang,2054,12122,3887.396886574074,MERGED,3,29,4,0,4,443,False,0,0,0,1216,32,1.5788888888888888,Document
Erlang,2054,12122,3887.389594907407,MERGED,1,1,1,0,1,442,False,0,0,0,1202,2,0.08694444444444445,Document
Vue,10811,21164,1116.1339699074074,MERGED,14,14,2,2,3,1,False,0,2,2,1579,28,3.2275,Document
TypeScript,41370,87415,3030.4815972222223,MERGED,15,258,14,6,12,157,True,2,4,4,5060,273,150.03277777777777,Document
Erlang,2054,12122,3887.257731481481,MERGED,148,258,17,0,19,441,False,0,0,0,1470,406,2.446111111111111,Document
Python,137,75,776.2884143518519,MERGED,2,5,2,0,1,234,False,0,0,0,1192,7,0.16944444444444445,Document
C#,80,125,913.6240625,MERGED,12,16,3,0,2,10,True,0,0,0,1249,28,1.0016666666666667,Document
Go,1174,11429,1931.9391898148149,MERGED,2,2,1,0,1,91,False,0,0,0,3305,4,23.337777777777777,Document
Erlang,2054,12122,3887.205497685185,CLOSED,148,248,17,1,18,440,False,1,0,0,1287,396,1.2591666666666668,Document
JavaScript,34,25,286.9880092592593,MERGED,0,260,6,1,7,92,False,1,0,0,1499,260,246.61,Document
Starlark,440,286,580.9225810185185,MERGED,3,3,2,1,4,17,False,0,1,1,1229,6,48.733333333333334,Bug
TypeScript,3393,2334,1060.4672800925925,MERGED,0,1,1,2,1,527,False,0,2,1,1261,1,15.376944444444444,Feature
Starlark,440,286,580.6580324074074,MERGED,28,18,1,2,6,5,False,1,1,1,1116,46,55.095,Feature
TypeScript,3393,2334,1060.2789930555557,MERGED,4,4,2,1,2,771,False,0,1,1,1440,8,0.26722222222222225,Bug
Java,450,746,4165.03050925926,MERGED,1,8,1,1,2,25,False,0,1,1,1354,9,23.37388888888889,Bug
TypeScript,1297,21107,508.97881944444447,MERGED,18,51,13,1,3,1270,True,0,1,1,3820,69,0.050277777777777775,Document
Erlang,2054,12122,3886.4421296296296,MERGED,1,1,1,0,1,439,False,0,0,0,1219,2,10.049444444444445,Document
C#,655,7879,1919.0208912037035,MERGED,8,498,19,3,14,624,True,1,2,2,2347,506,57.01972222222222,Document
C++,363,552,629.1105671296297,MERGED,1,1,1,0,1,311,False,0,0,0,1417,2,0.5402777777777777,Document
Starlark,440,286,579.8744791666667,MERGED,0,70,2,2,2,16,False,0,2,2,1713,70,73.90916666666666,Document
TypeScript,261,3764,767.4908912037037,MERGED,109,91,33,0,3,1070,True,0,0,0,5147,200,3.936111111111111,Document
C#,655,7879,1920.9340740740743,MERGED,6,6,1,2,1,14,True,0,2,2,1943,12,28.77722222222222,Document
TypeScript,1073,11366,1186.596412037037,MERGED,1,3,1,1,1,240,False,0,1,1,1544,4,23.01222222222222,Bug
Python,137,75,774.2776504629629,MERGED,2,6,3,3,1,44,False,1,2,2,1705,8,73.76222222222222,Document
Erlang,2054,12122,3886.3463541666665,MERGED,4,3,3,0,1,438,False,0,0,0,1216,7,2.1569444444444446,Document
Erlang,2054,12122,3886.0322337962966,MERGED,12,15,5,0,1,408,True,0,0,0,1300,27,19.795555555555556,Document
Erlang,2054,12122,3885.8266898148145,MERGED,5,48,3,0,2,407,True,0,0,0,1149,53,24.732777777777777,Document
JavaScript,5140,7054,1297.8420023148149,MERGED,21,534,14,2,5,0,False,1,1,1,4283,555,138.53805555555556,Feature
Erlang,2054,12122,3886.13693287037,MERGED,1869,4545,147,0,81,437,False,0,0,0,1349,6414,3.7930555555555556,Document
Go,752,2399,819.6535185185185,MERGED,7,6,2,0,1,479,False,0,0,0,1633,13,0.015,Bug
JavaScript,34,25,289.0728125,MERGED,1,1,1,5,4,15,False,3,2,1,1340,2,53.105,Bug
Python,137,75,775.0565972222222,MERGED,0,12,3,0,1,46,False,0,0,0,1513,12,0.3522222222222222,Document
Erlang,2054,12122,3884.9846180555555,MERGED,3,65,4,0,2,406,True,0,0,0,1291,68,63.93472222222222,Document
C#,655,7879,1920.9284953703702,MERGED,0,1,1,1,1,627,True,0,1,1,2266,1,3.1819444444444445,Document
C#,655,7879,1920.351273148148,MERGED,116,176,14,2,9,704,True,0,2,2,2410,292,38.08444444444444,Document
C#,655,7879,1920.7367013888888,MERGED,2,2,1,0,1,705,True,0,0,0,2174,4,9.261111111111111,Document
Java,450,746,4164.134236111111,MERGED,0,27,4,1,4,82,False,0,1,1,1419,27,24.340833333333332,Document
TypeScript,1297,21107,508.05305555555555,MERGED,44,50,22,2,4,1262,True,0,2,2,5034,94,0.44583333333333336,Document
TypeScript,4,33,854.0774768518519,MERGED,2,2,1,2,1,284,True,1,1,1,1155,4,0.13333333333333333,Document
Java,450,746,4162.259675925926,MERGED,300,194,7,1,5,170,False,0,1,1,3821,494,161.2675,Bug
Java,450,746,4162.994537037037,MERGED,1,1,1,1,1,23,False,0,1,1,1084,2,72.18916666666667,Bug
TypeScript,4,33,853.7774074074074,MERGED,4,3,1,1,1,262,False,0,1,1,1709,7,0.07861111111111112,Feature
C#,80,125,911.6908101851851,MERGED,30,37,6,0,3,214,True,0,0,0,1015,67,2.805277777777778,Document
Python,137,75,777.2743518518519,CLOSED,0,78,3,0,2,6,False,0,0,0,1478,78,288.6988888888889,Bug
Erlang,2054,12122,3885.189513888889,MERGED,8,102,5,0,1,435,False,0,0,0,1219,110,3.4975,Document
TypeScript,41370,87415,3030.698877314815,MERGED,128,39,6,3,4,660,True,0,3,3,4020,167,3.235,Document
TypeScript,3393,2334,1057.9911805555555,MERGED,9,9,1,2,1,517,False,0,2,1,1740,18,29.166666666666668,Feature
TypeScript,1073,11366,1185.5236342592593,MERGED,3,3,2,1,1,154,True,0,1,1,1202,6,0.38805555555555554,Bug
TypeScript,3393,2334,1058.305,MERGED,0,28,1,2,2,520,False,0,2,1,1100,28,0.15833333333333333,Feature
TypeScript,202,107,1235.7129861111111,MERGED,41,57,4,3,2,322,True,0,3,3,4276,98,0.8047222222222222,Document
TypeScript,4,33,853.5337962962963,MERGED,4,7,2,0,1,259,False,0,0,0,1127,11,0.05416666666666667,Feature
Starlark,440,286,581.1483680555556,MERGED,90,74,1,6,6,0,False,3,3,2,1519,164,350.9111111111111,Document
Python,137,75,775.9828356481481,MERGED,0,200,9,0,44,0,False,0,0,0,2104,200,300.3261111111111,Document
TypeScript,41370,87415,3029.712754629629,MERGED,4,49,4,2,2,1675,True,0,2,2,2863,53,0.44,Document
Erlang,2054,12122,3886.061631944445,CLOSED,148,880,20,1,19,96,False,1,0,0,1797,1028,338.4625,Document
Go,1835,11246,1821.7844444444445,MERGED,0,2,1,0,1,179,False,0,0,0,1531,2,0.020277777777777777,Document
TypeScript,21,40,2375.0305555555556,MERGED,2,2,1,1,1,58,False,0,1,1,1519,4,11.998333333333333,Feature
TypeScript,307,2556,629.7207523148148,MERGED,184,191,66,1,6,597,True,0,1,1,3151,375,1.0047222222222223,Document
TypeScript,4,33,852.5573148148147,MERGED,205,201,9,1,1,258,False,0,1,1,1595,406,0.23027777777777778,Feature
C#,655,7879,1918.9269791666666,CLOSED,2,12,1,0,2,702,True,0,0,0,2352,14,3.8716666666666666,Document
C#,80,125,909.9830671296296,CLOSED,8660,14873,155,0,77,104,False,0,0,0,1282,23533,16.996111111111112,Document
C#,655,7879,1918.545439814815,CLOSED,1,1,1,3,1,701,True,3,0,0,2228,2,7.411111111111111,Document
TypeScript,1297,21107,505.7104976851852,MERGED,7,91,6,1,4,1254,True,0,1,1,4328,98,0.07222222222222222,Document
TypeScript,1297,21107,505.6701851851852,MERGED,5,104,7,1,2,1251,True,0,1,1,4164,109,0.09694444444444444,Document
Python,2409,12194,335.05252314814817,MERGED,373,375,6,13,13,3,False,7,6,2,2302,748,21.654722222222222,Document
C++,363,552,626.2108912037037,MERGED,3,6,1,0,1,309,False,0,0,0,1407,9,0.6744444444444444,Document
TypeScript,1073,11366,1185.5931365740742,MERGED,0,19,2,2,7,238,False,0,2,2,2345,19,165.5247222222222,Bug
TypeScript,4,33,851.6438310185185,MERGED,32,103,12,1,7,423,True,0,1,1,1111,135,1.3847222222222222,Feature
TypeScript,41370,87415,3028.506990740741,MERGED,8,8,2,2,1,45,False,0,2,2,3228,16,0.08555555555555555,Document
TypeScript,202,107,1233.6188194444444,MERGED,6,80,5,2,1,300,True,0,2,2,4315,86,0.06277777777777778,Document
Go,1835,11246,1819.943425925926,MERGED,3,17,1,0,2,53,True,0,0,0,1632,20,16.615,Document
TypeScript,15,34,579.261099537037,MERGED,38,47,6,0,1,166,False,0,0,0,1161,85,45.928333333333335,Bug
Starlark,440,286,584.3159027777778,MERGED,0,64,4,2,1,46,False,1,1,1,2210,64,9.161111111111111,Document
TypeScript,41370,87415,3027.9378125000003,CLOSED,7,164,8,3,2,1,False,0,3,3,3488,171,0.6927777777777778,Document
TypeScript,41370,87415,3027.9327199074073,CLOSED,7,164,8,2,1,0,False,0,2,2,3530,171,0.058611111111111114,Document
JavaScript,5140,7054,1293.9238657407407,MERGED,25,1105,11,1,9,113,False,0,1,1,5378,1130,97.71833333333333,Bug
TypeScript,41370,87415,3027.726087962963,MERGED,2447,1581,7,2,3,653,True,0,2,2,3798,4028,1.0386111111111112,Document
TypeScript,41370,87415,3026.8121180555554,MERGED,3,37,2,2,6,44,False,0,2,2,2283,40,44.20944444444444,Document
C++,363,552,629.2506365740741,MERGED,117,98,2,1,2,313,False,1,0,0,2085,215,189.93805555555556,Document
TypeScript,3393,2334,1059.4678703703705,MERGED,66,52,5,3,1,0,False,0,3,2,2124,118,34.455555555555556,Bug
Python,2409,12194,333.3909027777778,MERGED,1,1,1,1,1,95,True,0,1,1,1780,2,10.500277777777777,Document
Python,2409,12194,331.7313657407407,MERGED,303,805,46,7,22,437,True,5,2,2,1777,1108,12.711388888888889,Document
Go,2083,11770,1609.7976157407409,MERGED,4,48,7,0,1,958,True,0,0,0,3820,52,0.10833333333333334,Document
TypeScript,3393,2334,1060.0413078703702,MERGED,3,56,3,2,6,526,False,0,2,1,2191,59,117.7088888888889,Bug
Erlang,2054,12122,3885.447210648148,MERGED,17,621,11,2,3,436,False,1,1,1,1621,638,187.51361111111112,Document
Erlang,2054,12122,3887.9964004629633,MERGED,3,23,3,0,2,410,True,0,0,0,1599,26,26.58972222222222,Document
TypeScript,41370,87415,3026.5196759259256,MERGED,32,35,3,2,2,1963,True,0,2,2,2919,67,1.6955555555555555,Document
Python,2409,12194,333.03146990740737,MERGED,1,1,1,0,2,439,True,0,0,0,2075,2,1.3102777777777779,Document
C++,363,552,629.1224421296296,MERGED,30,41,7,0,3,312,False,0,0,0,1889,71,126.615,Document
TypeScript,2147,14725,1566.1643981481482,MERGED,104,300,5,0,4,64,False,0,0,0,9361,404,0.11722222222222223,Bug
C#,655,7879,1923.022025462963,MERGED,85,20,29,0,2,714,True,0,0,0,2545,105,102.8625,Document
Python,2409,12194,331.7196064814815,MERGED,1,2,2,0,5,94,True,0,0,0,1959,3,12.320833333333333,Document
Python,2409,12194,331.8463194444444,MERGED,9,13,1,1,2,13,False,0,1,1,1837,22,3.5616666666666665,Document
TypeScript,4,33,855.7661689814814,MERGED,69,74,6,2,7,5,True,1,1,1,2230,143,11.369722222222222,Bug
TypeScript,149,2900,470.9324189814815,MERGED,14,31,2,1,3,131,False,0,1,1,2161,45,0.6466666666666666,Bug
Starlark,440,286,581.2051273148148,MERGED,30,1,1,2,1,6,False,0,2,2,1894,31,41.9425,Bug
Python,2409,12194,331.59555555555556,CLOSED,3,38,1,0,2,0,False,0,0,0,1835,41,0.025,Document
TypeScript,4,33,855.2587384259259,MERGED,60,57,7,1,6,427,True,0,1,1,2074,117,5.878611111111111,Bug
TypeScript,3393,2334,1059.956087962963,MERGED,2,5,3,2,1,525,False,0,2,1,2066,7,0.47638888888888886,Document
TypeScript,85,724,407.3100231481481,MERGED,204,173,17,0,4,213,False,0,0,0,9234,377,22.061944444444446,Document
TypeScript,7,6,738.1283333333334,MERGED,85,374,23,0,34,64,True,0,0,0,5125,459,332.56694444444446,Bug
Go,1835,11246,1819.1828125,MERGED,1,7,1,0,1,178,False,0,0,0,2163,8,65.56888888888889,Document
C#,655,7879,1919.0835300925926,CLOSED,0,2,1,1,1,16,False,1,0,0,2823,2,242.75444444444443,Document
TypeScript,3393,2334,1059.0967939814816,MERGED,0,16,2,2,2,522,False,0,2,1,1822,16,0.6061111111111112,Feature
C#,80,125,911.6495833333333,MERGED,8,8,2,0,2,3,False,0,0,0,1498,16,23.171388888888888,Document
TypeScript,3706,54077,1446.484837962963,MERGED,200,112,3,0,7,48,True,0,0,0,2355,312,135.96972222222223,Feature
C#,655,7879,1919.1697453703703,MERGED,167,221,128,1,8,703,True,1,0,0,2578,388,206.25583333333333,Document
Python,137,75,778.1473148148148,MERGED,0,893,30,1,43,10,False,0,1,1,3185,893,382.58805555555557,Document
Go,1835,11246,1822.7484953703704,MERGED,0,1,1,0,1,599,False,0,0,0,1744,1,0.5741666666666667,Document
TypeScript,2147,14725,1563.0138541666665,MERGED,3657,453,21,0,4,73,False,0,0,0,10339,4110,1.2794444444444444,Feature
Starlark,440,286,584.3200925925926,MERGED,3,3,1,3,1,4,False,0,3,3,2581,6,321.7033333333333,Feature
C#,655,7879,1917.9666666666665,MERGED,513,284,29,0,10,699,True,0,0,0,2582,797,223.73944444444444,Document
TypeScript,4,33,851.8182754629629,MERGED,236,338,17,1,16,425,True,0,1,1,1713,574,68.54777777777778,Document
TypeScript,1073,11366,1184.8163194444444,MERGED,2,1,1,0,2,42,True,0,0,0,1891,3,0.02,Document
TypeScript,1073,11366,1184.7978819444445,MERGED,4,6,3,1,3,152,True,0,1,1,1779,10,0.7430555555555556,Bug
TypeScript,1073,11366,1184.8024421296298,MERGED,1,16,2,1,1,236,False,0,1,1,1938,17,0.2897222222222222,Document
TypeScript,1073,11366,1184.7471874999999,MERGED,1,8,1,2,1,91,True,0,2,2,1980,9,0.6922222222222222,Bug
Go,752,2399,817.6166898148149,MERGED,3,19,2,0,3,469,False,0,0,0,2052,22,0.0225,Bug
Starlark,440,286,584.2794791666666,MERGED,9,46,2,1,3,95,False,0,1,1,3054,55,299.3952777777778,Bug
Python,14534,41196,1176.851574074074,MERGED,3,3,3,0,5,1440,True,0,0,0,2102,6,0.04111111111111111,Document
Go,1835,11246,1821.8010416666666,MERGED,1,3,2,0,1,180,False,0,0,0,2060,4,0.11527777777777778,Document
Go,752,2399,817.5025810185185,MERGED,3,19,2,0,3,468,False,0,0,0,2046,22,2.6952777777777777,Bug
Go,789,5551,1133.8872569444445,MERGED,4,10,3,0,1,12,False,0,0,0,3041,14,269.9869444444444,Document
TypeScript,1073,11366,1183.6035648148147,MERGED,0,2,1,1,1,320,True,0,1,1,2015,2,1.3883333333333334,Bug
TypeScript,7,6,737.9358564814816,MERGED,20,20,7,0,2,310,False,0,0,0,6705,40,142.79638888888888,Feature
TypeScript,307,2556,627.6623611111112,MERGED,7,8,2,1,2,213,True,0,1,1,1982,15,30.57888888888889,Document
Go,1835,11246,1819.8226273148148,MERGED,5,5,2,0,1,597,False,0,0,0,1828,10,0.2683333333333333,Document
Go,30,295,437.9097800925926,MERGED,15,81,15,7,6,113,True,3,4,1,4314,96,83.72833333333334,Feature
Python,2409,12194,334.98649305555557,MERGED,275,146,14,12,6,444,True,6,6,2,2770,421,18.842777777777776,Document
Python,2409,12194,334.70608796296295,MERGED,2,2,1,0,1,443,True,0,0,0,2107,4,1.2897222222222222,Document
C++,363,552,631.8876157407407,MERGED,13,28,4,0,2,314,False,0,0,0,2634,41,53.32333333333333,Document
TypeScript,1073,11366,1185.8845949074073,MERGED,1138,4065,3,1,1,239,False,0,1,1,2762,5203,278.80027777777775,Bug
TypeScript,3393,2334,1061.167025462963,CLOSED,0,0,0,2,0,528,False,0,2,1,3026,0,115.04194444444444,Feature
V,2097,34362,1646.4674768518519,MERGED,12,107,9,0,8,0,False,0,0,0,4851,119,27.336944444444445,Feature
Python,2409,12194,334.07028935185184,MERGED,1,13,1,0,1,441,True,0,0,0,2250,14,0.31444444444444447,Document
Starlark,440,286,583.2501620370371,CLOSED,0,371,6,1,13,6,False,0,1,1,3284,371,0.022222222222222223,Document
Starlark,440,286,583.2417824074074,CLOSED,0,373,6,1,12,5,False,0,1,1,2790,373,0.021944444444444444,Document
Go,752,2399,817.5112268518519,MERGED,306,2053,37,0,8,85,False,0,0,0,6247,2359,246.39277777777778,Document
Python,14534,41196,1181.2430671296295,MERGED,2,2,1,0,1,1443,True,0,0,0,2384,4,0.08666666666666667,Document
Vue,10811,21164,1115.1387384259258,MERGED,0,6,4,6,2,0,False,3,3,2,5696,6,123.55416666666666,Bug
Python,2409,12194,332.4556597222222,CLOSED,3,37,1,0,6,14,False,0,0,0,2332,40,21.24222222222222,Document
TypeScript,1073,11366,1187.5594907407408,CLOSED,3,121,3,3,3,323,True,1,2,2,3065,124,78.25833333333334,Bug
TypeScript,7,6,734.0525231481482,MERGED,40,632,30,0,36,59,True,0,0,0,5893,672,47.30083333333334,Bug
Go,1174,11429,1932.6147800925926,MERGED,214,482,16,6,5,402,True,2,4,1,2441,696,147.3425,Document
Python,4517,54994,1017.7101851851852,MERGED,1,1,1,1,1,126,True,0,1,1,2895,2,72.08,Document
Python,2409,12194,331.4278703703704,MERGED,5,10,2,1,3,93,True,0,1,1,2517,15,13.924444444444445,Document
TypeScript,41370,87415,3028.6657638888887,MERGED,4,38,3,2,5,47,False,0,2,2,4933,42,169.31416666666667,Document
TypeScript,1073,11366,1187.5497337962963,MERGED,2,12,1,1,1,241,False,0,1,1,2702,14,0.35138888888888886,Bug
Python,14534,41196,1179.7894444444444,MERGED,3,3,3,0,1,1442,True,0,0,0,2807,6,0.18722222222222223,Document
TypeScript,41370,87415,3029.003923611111,CLOSED,19,514,8,5,23,1673,True,2,3,3,7221,533,12.249444444444444,Document
TypeScript,41370,87415,3027.968125,MERGED,110,5661,11,3,2,655,True,0,3,3,4703,5771,12.019166666666667,Document
JavaScript,34,25,289.34966435185186,MERGED,26,114,2,1,4,3,False,0,1,1,3361,140,3.2069444444444444,Bug
TypeScript,41370,87415,3030.7509375000004,MERGED,68,1535,10,2,3,661,True,0,2,2,6401,1603,1.9830555555555556,Document
V,2097,34362,1643.2724537037038,MERGED,81,75,8,2,8,2,False,2,0,0,5670,156,17.16861111111111,Document
TypeScript,41370,87415,3030.5011342592593,MERGED,1,47,3,2,4,46,True,0,2,2,5741,48,3.03,Document
Python,2409,12194,330.7930324074074,MERGED,12,23,10,0,5,436,True,0,0,0,2861,35,0.4577777777777778,Document
Go,752,2399,819.4550347222222,MERGED,76,110,6,0,1,476,False,0,0,0,3241,186,1.0544444444444445,Bug
Java,450,746,4163.252106481482,MERGED,164,50,12,1,3,97,True,0,1,1,6401,214,47.58611111111111,Bug
Go,1835,11246,1819.9359490740742,CLOSED,1,125,7,0,2,12,False,0,0,0,2672,126,242.69027777777777,Document
Java,450,746,4163.006493055555,MERGED,53,77,6,1,12,81,False,0,1,1,2954,130,74.93694444444445,Document
Vue,10811,21164,1112.4509837962962,MERGED,70,69,1,1,5,0,False,0,1,1,5975,139,61.471944444444446,Document
TypeScript,85,724,409.1579282407408,MERGED,38,1333,34,0,24,124,False,0,0,0,15511,1371,4.482222222222222,Document
TypeScript,4,33,853.5742824074074,MERGED,278,170,18,1,1,260,False,0,1,1,3395,448,0.04694444444444444,Feature
JavaScript,34,25,288.6644212962963,CLOSED,17,18,4,3,2,14,False,2,1,1,3022,35,9.478055555555555,Bug
TypeScript,4,33,852.7672569444444,MERGED,468,987,63,1,38,426,True,0,1,1,2540,1455,44.92944444444444,Bug
Python,2409,12194,329.3819675925926,MERGED,13,27,1,0,1,434,True,0,0,0,3074,40,0.12472222222222222,Document
TypeScript,1073,11366,1184.922372685185,MERGED,6,6,2,1,2,153,True,0,1,1,2506,12,0.24861111111111112,Bug
TypeScript,12,11,1081.3308449074075,MERGED,156,367,10,0,2,87,False,0,0,0,13889,523,19.981944444444444,Feature
C++,363,552,625.9184143518519,MERGED,28,79,6,0,2,307,False,0,0,0,2655,107,74.04888888888888,Document
JavaScript,34,25,288.0926851851852,MERGED,23,187,3,0,1,96,False,0,0,0,2721,210,0.09444444444444444,Feature
Go,752,2399,817.6309027777778,MERGED,3,19,2,0,1,472,False,0,0,0,2868,22,0.009166666666666667,Bug
TypeScript,1073,11366,1184.6528819444445,MERGED,0,25,1,1,1,235,False,0,1,1,2304,25,0.21138888888888888,Bug
Python,14534,41196,1176.8203819444445,MERGED,0,22,2,0,6,1439,True,0,0,0,2289,22,0.49166666666666664,Document
TypeScript,1073,11366,1184.5659722222222,MERGED,35,0,1,1,1,321,True,0,1,1,2503,35,0.3325,Bug
TypeScript,1073,11366,1184.5427430555555,MERGED,1,2,1,1,1,90,True,0,1,1,2110,3,0.6180555555555556,Bug
Java,450,746,4161.925798611111,MERGED,5,30,5,5,8,80,False,2,3,2,2335,35,5.684722222222222,Feature
TypeScript,4,33,852.3211805555555,MERGED,136,185,5,2,1,282,True,1,1,1,2331,321,0.16666666666666666,Feature
TypeScript,1073,11366,1183.7110300925926,MERGED,24,36,5,1,9,41,True,0,1,1,2884,60,20.91027777777778,Document
TypeScript,41370,87415,3027.643715277778,MERGED,203,571,20,3,13,1671,True,0,3,3,6946,774,1.735,Document
TypeScript,4,33,851.7127199074074,MERGED,16,19,5,1,2,424,True,0,1,1,3090,35,0.3136111111111111,Feature
V,2097,34362,1640.872349537037,MERGED,3,64,2,0,4,1,False,0,0,0,1983,67,6.1130555555555555,Document
TypeScript,41370,87415,3026.7218865740742,MERGED,10,103,8,6,4,648,True,2,4,4,5279,113,2.643611111111111,Document
TypeScript,41370,87415,3026.5213657407407,MERGED,43,93,7,2,2,647,True,0,2,2,5700,136,2.2655555555555558,Document
Go,1835,11246,1819.594710648148,MERGED,44,44,4,0,1,52,True,0,0,0,2879,88,4.7427777777777775,Document
Go,1835,11246,1819.5718749999999,MERGED,6,6,4,0,1,51,True,0,0,0,2770,12,0.3641666666666667,Document
Go,789,5551,1130.8650578703703,MERGED,4,15,5,3,1,27,False,2,1,1,4513,19,555.1633333333333,Document
Go,1835,11246,1818.8718402777777,MERGED,248,14,40,0,1,56,False,0,0,0,2383,262,4.4175,Document
Starlark,440,286,583.0383333333333,MERGED,0,204,4,2,2,52,False,1,1,1,3457,204,329.1766666666667,Document
Starlark,440,286,584.6689699074074,MERGED,245,117,3,3,3,53,False,2,1,1,3857,362,266.4302777777778,Document
TypeScript,202,107,1237.573263888889,MERGED,318,285,102,3,6,325,True,0,3,3,8574,603,121.75666666666666,Document
Python,1912,12144,157.91744212962962,MERGED,1,90,3,2,2,1,False,0,2,1,1575,91,51.22527777777778,Feature
Python,2409,12194,332.693125,MERGED,9,25,1,8,9,0,False,3,5,1,3999,34,28.178055555555556,Document
Python,2409,12194,331.6610300925926,CLOSED,4,24,2,7,7,0,False,4,3,1,3126,28,53.325,Document
TypeScript,21,40,2378.9112962962963,MERGED,8,11,5,1,11,61,False,0,1,1,3069,19,3.4580555555555557,Document
TypeScript,4,33,854.0696180555556,CLOSED,10,52,6,2,5,283,True,1,1,1,3557,62,216.04944444444445,Document
Python,1912,12144,157.91724537037035,MERGED,1,1,1,1,1,0,False,0,1,1,1335,2,0.3125,Bug
Python,2409,12194,333.22003472222224,MERGED,30,30,23,0,4,440,True,0,0,0,5025,60,0.8886111111111111,Document
TypeScript,4,33,854.2010995370371,MERGED,112,468,12,2,46,285,True,1,1,1,4584,580,121.46194444444444,Feature
TypeScript,4,33,856.7244907407407,MERGED,281,349,34,1,9,429,True,0,1,1,4029,630,20.524166666666666,Bug
Python,2409,12194,332.4379398148148,CLOSED,0,83,9,3,2,1,False,1,2,1,4366,83,12.995833333333334,Document
TypeScript,4,33,855.7129745370371,MERGED,76,623,28,1,24,428,True,0,1,1,4173,699,47.67055555555555,Bug
Starlark,440,286,582.1662268518519,CLOSED,0,483,36,1,3,1,False,0,1,1,3538,483,19.12361111111111,Feature
Python,2409,12194,331.86939814814815,MERGED,56,32,5,4,11,2,False,1,3,1,3848,88,3.535,Document
TypeScript,3706,54077,1446.458414351852,MERGED,55,842,5,1,11,47,True,1,0,0,4349,897,256.32444444444445,Feature
TypeScript,3393,2334,1060.3760532407407,MERGED,14,181,8,1,4,389,False,0,1,1,3819,195,0.31777777777777777,Feature
Java,450,746,4161.982766203703,MERGED,1345,6268,59,0,35,752,False,0,0,0,8507,7613,8.885,Document
Python,14534,41196,1179.7605324074075,MERGED,12,12,6,0,1,1441,True,0,0,0,4057,24,0.19722222222222222,Document
Python,137,75,775.4730324074075,MERGED,0,188,9,0,10,233,False,0,0,0,4380,188,0.5675,Document
TypeScript,41370,87415,3026.939247685185,MERGED,63,573,11,2,3,650,True,0,2,2,8919,636,15.893333333333333,Document
TypeScript,307,2556,630.8098032407407,CLOSED,2777,7636,507,4,177,2,False,2,2,1,4719,10413,3.4283333333333332,Document
Python,2409,12194,329.9741319444444,MERGED,223,420,15,0,8,435,True,0,0,0,3928,643,2.9180555555555556,Document
TypeScript,41370,87415,3026.85630787037,MERGED,109,556,40,3,14,649,True,0,3,3,9707,665,0.6969444444444445,Document
TypeScript,3393,2334,1056.9514930555556,MERGED,72,203,6,1,7,770,False,0,1,1,3608,275,93.82333333333334,Feature
JavaScript,34,25,288.0507175925926,MERGED,21,1249,13,0,7,94,False,0,0,0,3637,1270,0.06305555555555556,Bug
TypeScript,1073,11366,1184.6437152777778,MERGED,5,235,2,1,2,322,True,0,1,1,3282,240,0.17194444444444446,Bug
TypeScript,12,11,1082.4151273148148,MERGED,1158,2523,48,0,21,198,False,0,0,0,15411,3681,117.73472222222222,Bug
Go,1835,11246,1820.0541782407408,MERGED,33,16,13,0,1,598,False,0,0,0,4140,49,13.178888888888888,Document
Go,1835,11246,1817.896087962963,MERGED,15,41,7,0,4,50,True,0,0,0,3566,56,17.669722222222223,Document
TypeScript,202,107,1237.7775578703704,MERGED,176,187,27,3,3,328,True,0,3,3,12570,363,117.05277777777778,Document
TypeScript,202,107,1235.5816435185186,MERGED,223,236,23,3,8,321,True,0,3,3,11219,459,4.1175,Document
TypeScript,184,377,2005.1758564814816,MERGED,0,9,1,0,8,55,False,0,0,0,4359,9,242.77777777777777,Document
TypeScript,41370,87415,3029.944837962963,MERGED,2611,2964,216,2,22,659,True,0,2,2,10409,5575,11.649166666666666,Document
TypeScript,3393,2334,1058.948275462963,CLOSED,62,654,26,1,3,14,False,0,1,1,7099,716,450.81583333333333,Document
TypeScript,41370,87415,3027.775474537037,MERGED,102,138,22,2,4,654,True,0,2,2,10543,240,1.5769444444444445,Document
Python,137,75,777.977824074074,MERGED,387,627,58,4,26,116,False,1,3,2,5596,1014,190.98,Document
TypeScript,1073,11366,1183.5347800925927,MERGED,638,5213,55,3,75,778,True,0,3,3,5037,5851,415.3663888888889,Bug
Python,2409,12194,335.0904282407408,MERGED,98,120,6,0,6,445,True,0,0,0,5330,218,27.476111111111113,Document
Java,450,746,4165.189131944445,MERGED,2344,1882,98,11,101,83,False,1,10,2,6504,4226,267.0163888888889,Document
Starlark,440,286,583.0116666666667,CLOSED,166,543,8,4,5,2,False,2,2,2,5082,709,136.59972222222223,Bug
Python,2409,12194,334.25439814814814,MERGED,55,87,22,0,12,442,True,0,0,0,7322,142,1.7477777777777779,Document
TypeScript,149,2900,474.62971064814815,MERGED,82,107,3,5,3,14,False,0,5,3,5171,189,0.43666666666666665,Document
Python,137,75,775.8675578703704,MERGED,62,56,5,0,9,113,False,0,0,0,5605,118,2.9430555555555555,Bug
TypeScript,3393,2334,1060.868888888889,MERGED,8,21,7,1,1,772,False,0,1,1,5214,29,95.50722222222223,Feature
Python,2409,12194,332.3133564814815,MERGED,52,178,5,7,12,2,False,3,4,1,6890,230,15.672222222222222,Document
TypeScript,4,33,855.1683912037038,MERGED,62,351,12,1,6,415,False,0,1,1,5156,413,0.42138888888888887,Bug
TypeScript,4,33,854.8380324074074,MERGED,42,44,7,1,3,263,False,0,1,1,4762,86,0.1225,Feature
Python,137,75,774.3533101851853,MERGED,127,139,48,0,1,45,False,0,0,0,5231,266,0.22083333333333333,Document
TypeScript,4,33,853.0482291666667,MERGED,152,434,14,2,17,68,False,1,1,1,6201,586,27.4925,Bug
TypeScript,3393,2334,1058.0377314814816,MERGED,191,245,10,1,24,519,False,0,1,1,8226,436,31.543333333333333,Feature
Go,1835,11246,1818.9174652777776,MERGED,2264,2242,35,1,16,22,False,0,1,1,6867,4506,136.44861111111112,Document
Go,1835,11246,1820.587060185185,MERGED,9001,6742,125,1,1,78,False,0,1,1,5480,15743,4.665277777777778,Document
TypeScript,58,78,913.2269560185185,MERGED,177,358,14,1,17,123,False,0,1,1,18171,535,116.2875,Document
TypeScript,3393,2334,1062.2640162037037,MERGED,167,51,5,4,2,0,False,1,3,2,7780,218,77.64083333333333,Bug
TypeScript,3393,2334,1060.4930671296295,MERGED,200,119,29,2,2,0,False,0,2,1,9215,319,81.78055555555555,Document
TypeScript,4,33,857.7716898148147,MERGED,185,170,20,1,11,430,True,0,1,1,8635,355,0.17777777777777778,Feature
Go,1835,11246,1817.897939814815,MERGED,0,2945,38,1,6,125,False,0,1,1,8252,2945,574.0288888888889,Document
Python,547,7161,2327.934699074074,MERGED,768,683,5,0,40,48,False,0,0,0,8401,1451,187.57888888888888,Document
TypeScript,3393,2334,1058.0336111111112,MERGED,245,191,10,2,1,518,False,0,2,1,8685,436,0.07388888888888889,Bug
Go,1835,11246,1820.7868055555555,CLOSED,97,323,34,1,20,126,False,1,0,0,8034,420,96.16833333333334,Document
Go,1835,11246,1820.5734606481483,CLOSED,8999,8195,128,1,1,77,False,0,1,1,9264,17194,0.10194444444444445,Document
Go,1835,11246,1817.852199074074,MERGED,7623,6900,41,1,4,27,False,0,1,1,8922,14523,1.0988888888888888,Document
Go,789,5551,1133.8608564814815,MERGED,367,90,12,0,1,201,True,0,0,0,13187,457,1.9569444444444444,Document
TypeScript,3393,2334,1058.925011574074,CLOSED,18,54,3,2,2,521,False,0,2,1,11979,72,4.832777777777777,Bug
TypeScript,149,2900,473.35184027777774,MERGED,1981,3820,200,5,30,23,False,1,4,1,17950,5801,40.11944444444445,Bug
Go,789,5551,1132.2262384259259,MERGED,394,342,25,1,3,200,True,1,0,0,20819,736,19.036944444444444,Document
TypeScript,2147,14725,1572.2300231481483,MERGED,1,1,1,0,1,223,False,0,0,0,654,2,11.344166666666666,Feature
TypeScript,2147,14725,1572.165196759259,CLOSED,0,0,0,0,0,16,False,0,0,0,609,0,1.1819444444444445,Bug
TypeScript,2147,14725,1572.0104282407408,CLOSED,1,1,2,0,1,6,False,0,0,0,658,2,0.2311111111111111,Bug
TypeScript,2147,14725,1571.806111111111,MERGED,9,183,2,0,1,75,False,0,0,0,709,192,4.0569444444444445,Bug
TypeScript,12,11,1088.7080208333334,MERGED,3,52,3,0,5,417,False,0,0,0,1145,55,12.765555555555556,Feature
TypeScript,2147,14725,1571.015798611111,MERGED,4,4,2,0,1,74,False,0,0,0,717,8,1.6297222222222223,Bug
TypeScript,178,1359,420.54599537037035,CLOSED,0,4,1,4,1,6,False,2,2,2,794,4,11.614444444444445,Feature
TypeScript,2147,14725,1569.9927546296296,MERGED,4,0,1,0,1,189,False,0,0,0,648,4,3.5597222222222222,Feature
TypeScript,2147,14725,1572.2642361111111,MERGED,0,99,1,0,1,7,False,0,0,0,780,99,10.516944444444444,Feature
TypeScript,2147,14725,1569.726875,MERGED,1,1,1,0,1,808,False,0,0,0,711,2,0.9811111111111112,Bug
TypeScript,2147,14725,1572.172164351852,MERGED,2,30,2,0,1,222,False,0,0,0,910,32,0.4672222222222222,Feature
TypeScript,178,1359,420.273275462963,MERGED,1,1,1,2,1,5,False,0,2,2,912,2,13.282777777777778,Bug
TypeScript,2147,14725,1571.959791666667,MERGED,6,14,1,0,1,812,False,0,0,0,970,20,5.101388888888889,Feature
TypeScript,2147,14725,1568.9677199074074,MERGED,1,310,3,0,1,691,False,0,0,0,717,311,19.287777777777777,Document
TypeScript,2147,14725,1568.9538541666668,MERGED,0,8,1,0,1,66,False,0,0,0,682,8,19.60972222222222,Bug
TypeScript,85,724,414.35765046296297,MERGED,4,13,3,0,3,220,False,0,0,0,1098,17,14.1425,Document
TypeScript,2147,14725,1569.0218750000001,MERGED,1,1,1,0,1,97,False,0,0,0,568,2,1.1527777777777777,Bug
PHP,1334,2960,4307.0266319444445,MERGED,1,1,1,2,2,635,False,0,2,2,757,2,2.1983333333333333,Feature
TypeScript,85,724,414.0427662037037,MERGED,10,31,1,0,1,33,False,0,0,0,1164,41,0.27666666666666667,Document
TypeScript,85,724,413.9971296296296,MERGED,1,1,1,0,1,140,False,0,0,0,1065,2,1.8916666666666666,Document
TypeScript,85,724,413.9903935185185,MERGED,0,1,1,0,1,139,False,0,0,0,1186,1,2.056111111111111,Document
TypeScript,2070,16643,1340.4278240740741,MERGED,0,12,1,0,2,0,False,0,0,0,937,12,237.00833333333333,Feature
Python,547,7161,2337.5217939814816,MERGED,85,0,1,0,1,641,True,0,0,0,363,85,0.5813888888888888,Bug
TypeScript,2147,14725,1569.718101851852,MERGED,5,4,2,0,1,807,False,0,0,0,975,9,33.80694444444445,Bug
JavaScript,5140,7054,1302.172372685185,MERGED,4,45,3,1,5,142,False,0,1,1,700,49,62.18805555555556,Document
TypeScript,2147,14725,1571.977662037037,MERGED,0,10,3,0,2,190,False,0,0,0,1172,10,137.6313888888889,Feature
Go,421,1654,1609.1107407407408,CLOSED,6,15,4,0,2,89,False,0,0,0,967,21,0.5752777777777778,Bug
TypeScript,261,3764,772.514537037037,MERGED,0,15,2,3,1,0,False,1,2,2,1439,15,219.33972222222224,Document
Python,547,7161,2335.410671296296,MERGED,6,3,1,0,4,327,True,0,0,0,663,9,0.2061111111111111,Bug
TypeScript,261,3764,775.757800925926,MERGED,0,30,3,0,1,1085,True,0,0,0,1581,30,0.9327777777777778,Document
V,2097,34362,1650.577164351852,MERGED,2,2,1,2,1,72,True,1,1,1,714,4,11.456944444444444,Document
TypeScript,2147,14725,1572.015613425926,MERGED,6,97,9,0,8,44,False,0,0,0,2572,103,292.2813888888889,Feature
JavaScript,5140,7054,1301.671099537037,CLOSED,1,1,1,1,1,192,False,0,1,1,598,2,2.2275,Feature
TypeScript,261,3764,775.5277893518519,MERGED,0,7,2,0,1,154,True,0,0,0,1440,7,0.3933333333333333,Document
TypeScript,12,11,1087.267962962963,MERGED,10,170,3,0,99,57,False,0,0,0,1890,180,46.19305555555555,Bug
V,2097,34362,1651.4947337962965,MERGED,1,39,5,0,5,73,True,0,0,0,705,40,4.178888888888889,Bug
TypeScript,85,724,415.3646527777778,MERGED,4,9,3,0,1,126,False,0,0,0,1872,13,0.24972222222222223,Document
Go,421,1654,1607.922337962963,CLOSED,0,69,1,0,3,125,False,0,0,0,1025,69,0.015277777777777777,Document
TypeScript,85,724,415.15790509259256,MERGED,3,1,2,0,3,221,False,0,0,0,1466,4,0.10777777777777778,Document
TypeScript,2147,14725,1572.1668055555556,MERGED,3,5,2,0,1,76,False,0,0,0,1370,8,0.535,Feature
TypeScript,2147,14725,1572.1607060185186,MERGED,1,20,2,0,1,333,False,0,0,0,1324,21,0.7572222222222222,Document
JavaScript,5140,7054,1303.7380092592591,MERGED,0,87,2,2,1,20,False,1,1,1,971,87,0.3011111111111111,Feature
TypeScript,2147,14725,1571.1382986111112,MERGED,6,6,3,0,1,811,False,0,0,0,1667,12,0.5091666666666667,Feature
TypeScript,261,3764,774.8420138888888,MERGED,2,11,2,0,1,30,True,0,0,0,1480,13,0.67,Document
TypeScript,261,3764,774.7523958333333,MERGED,2,4,2,0,1,229,False,0,0,0,1707,6,0.3277777777777778,Document
TypeScript,261,3764,774.7120138888889,MERGED,23,10,1,1,1,11,True,0,1,1,1104,33,0.3111111111111111,Document
JavaScript,5140,7054,1303.1026736111112,MERGED,0,4,1,2,3,0,False,0,2,2,752,4,0.5052777777777778,Document
TypeScript,85,724,414.25487268518515,MERGED,16,20,4,0,1,30,False,0,0,0,1901,36,0.6983333333333334,Document
Python,547,7161,2337.5293055555553,MERGED,1,2,1,0,1,642,True,0,0,0,505,3,0.3963888888888889,Feature
Go,421,1654,1609.306099537037,MERGED,3,16,6,0,2,91,False,0,0,0,1346,19,133.90194444444444,Bug
TypeScript,2147,14725,1571.1496412037038,MERGED,12,32,2,1,1,98,False,1,0,0,1605,44,2.104722222222222,Feature
PHP,1334,2960,4304.124328703704,CLOSED,4,20,1,2,1,183,False,1,1,1,887,24,45.71333333333333,Feature
Python,547,7161,2333.567314814815,MERGED,2,28,1,0,5,638,True,0,0,0,431,30,0.3616666666666667,Document
TypeScript,2147,14725,1570.2236226851853,CLOSED,0,1,1,1,6,15,False,0,1,1,1314,1,46.585277777777776,Bug
Go,421,1654,1606.095324074074,CLOSED,0,72,1,0,2,124,False,0,0,0,966,72,20.25861111111111,Document
TypeScript,85,724,412.1500115740741,MERGED,10,31,1,0,1,29,False,0,0,0,1404,41,45.3925,Document
TypeScript,261,3764,773.6711921296296,MERGED,173,129,3,0,1,228,False,0,0,0,1294,302,1.0730555555555557,Document
TypeScript,85,724,413.29322916666666,MERGED,1,1,1,0,4,29,False,0,0,0,1716,2,0.3844444444444444,Document
TypeScript,2147,14725,1570.1413310185187,MERGED,378,675,3,0,2,5,False,0,0,0,1396,1053,0.6241666666666666,Feature
TypeScript,2147,14725,1570.0263773148147,MERGED,29,60,2,0,1,73,False,0,0,0,1696,89,22.642222222222223,Bug
TypeScript,261,3764,773.499988425926,MERGED,1,1,1,0,1,1082,True,0,0,0,1254,2,0.26694444444444443,Document
TypeScript,85,724,413.14482638888893,MERGED,3,13,2,0,2,30,False,0,0,0,1835,16,1.051111111111111,Document
TypeScript,2147,14725,1569.1900347222224,MERGED,7,5,2,0,1,41,False,0,0,0,1379,12,67.12027777777777,Bug
TypeScript,2147,14725,1568.9681944444444,MERGED,6,103,3,0,1,804,False,0,0,0,1246,109,76.92694444444444,Feature
TypeScript,2147,14725,1570.084710648148,CLOSED,378,664,3,0,1,4,False,0,0,0,1301,1042,1.21,Feature
Go,421,1654,1605.9170717592594,MERGED,1,16,2,0,1,519,True,0,0,0,916,17,1.7316666666666667,Document
JavaScript,5140,7054,1299.2222453703705,CLOSED,0,1,1,1,1,0,False,0,1,1,658,1,10.874166666666667,Feature
TypeScript,261,3764,772.7610763888889,MERGED,0,32,2,0,2,149,False,0,0,0,1414,32,27.196944444444444,Document
TypeScript,85,724,412.1359606481481,MERGED,10,31,1,0,1,28,False,0,0,0,1387,41,0.30694444444444446,Document
Vue,293,495,927.7785185185185,MERGED,13,16,1,7,2,330,True,1,6,5,553,29,0.38333333333333336,Bug
TypeScript,2147,14725,1569.220625,MERGED,13,13,4,0,1,188,False,0,0,0,1723,26,13.251666666666667,Feature
TypeScript,261,3764,772.5461111111111,MERGED,1,12,2,0,1,145,False,0,0,0,1085,13,2.41,Document
Go,421,1654,1607.9482754629628,CLOSED,0,33,2,0,2,126,False,0,0,0,1181,33,119.48138888888889,Document
TypeScript,2147,14725,1569.0621180555556,MERGED,3,395,4,0,2,5,False,0,0,0,1599,398,18.159166666666668,Bug
TypeScript,2147,14725,1568.935775462963,MERGED,1,3,1,0,1,4,False,0,0,0,1076,4,19.961388888888887,Feature
Python,547,7161,2337.569351851852,MERGED,136,138,7,0,40,258,False,0,0,0,959,274,131.67083333333332,Bug
TypeScript,202,107,1243.994386574074,MERGED,1,1,1,3,3,134,False,0,3,3,1259,2,132.52138888888888,Document
Go,421,1654,1609.1751736111112,MERGED,9,18,4,0,2,90,False,0,0,0,1598,27,17.642222222222223,Bug
Python,547,7161,2335.662013888889,MERGED,2,0,1,0,1,330,True,0,0,0,636,2,0.11972222222222222,Bug
TypeScript,12,11,1087.4224421296296,MERGED,0,424,6,0,7,91,False,0,0,0,1757,424,44.7125,Feature
TypeScript,12,11,1087.3441782407408,MERGED,27,727,4,0,20,199,False,0,0,0,2205,754,45.140277777777776,Feature
TypeScript,2147,14725,1572.2219328703704,MERGED,2,8,2,0,2,17,False,0,0,0,2039,10,11.550277777777778,Feature
Python,547,7161,2335.4094444444445,CLOSED,5,0,1,0,2,326,True,0,0,0,663,5,0.04388888888888889,Bug
Vue,293,495,926.6979398148147,MERGED,1,1,1,6,1,85,False,1,5,4,731,2,5.868888888888889,Bug
Vue,293,495,930.0584837962964,MERGED,0,1,1,4,1,443,False,0,4,4,818,1,18.071666666666665,Bug
TypeScript,58,78,919.1219675925926,MERGED,2,12,1,1,1,233,True,0,1,1,1825,14,4.598888888888889,Feature
Vue,293,495,929.94125,MERGED,11,29,4,10,5,441,False,1,9,6,1060,40,22.18166666666667,Bug
TypeScript,2147,14725,1572.0437268518517,MERGED,5,49,2,0,1,813,False,0,0,0,1416,54,1.2638888888888888,Feature
TypeScript,85,724,412.3733217592592,CLOSED,25,444,10,1,9,28,False,1,0,0,2092,469,161.1461111111111,Document
TypeScript,202,107,1240.842037037037,MERGED,1,1,1,3,1,310,True,0,3,3,763,2,43.52194444444444,Bug
Vue,293,495,929.8405324074074,MERGED,4,0,1,6,1,331,True,0,6,4,720,4,0.11472222222222223,Bug
PHP,1334,2960,4306.285451388889,MERGED,4,10,1,2,1,893,False,0,2,2,1283,14,17.356666666666666,Feature
TypeScript,261,3764,774.5480555555555,MERGED,4,11,3,5,1,0,False,2,3,1,2048,15,33.352777777777774,Document
Python,547,7161,2333.8721875,MERGED,60,34,1,0,7,164,False,0,0,0,713,94,48.910555555555554,Bug
TypeScript,178,1359,419.8427546296296,CLOSED,12,21,2,1,1,4,False,0,1,1,1938,33,0.6416666666666667,Feature
Python,547,7161,2335.3968402777778,MERGED,7,26,3,1,13,254,False,0,1,1,755,33,171.98472222222222,Bug
Python,547,7161,2335.666087962963,MERGED,38,24,1,2,15,257,False,0,2,1,810,62,152.1875,Bug
Vue,293,495,925.7615162037036,MERGED,7,2,1,4,1,84,False,0,4,3,761,9,1.6655555555555555,Bug
JavaScript,5140,7054,1302.5451851851851,MERGED,3,67,4,4,2,23,False,0,4,3,1345,70,113.78694444444444,Feature
Go,421,1654,1607.1660879629628,MERGED,12,3,3,0,2,520,True,0,0,0,1516,15,49.39555555555555,Document
Go,421,1654,1607.2155208333334,MERGED,6,4,4,0,3,521,True,0,0,0,1351,10,46.09361111111111,Bug
Python,547,7161,2334.5417708333334,MERGED,1,60,2,0,14,165,False,0,0,0,1105,61,190.62527777777777,Bug
TypeScript,261,3764,774.492037037037,MERGED,2,7,2,0,1,129,True,0,0,0,1635,9,0.2675,Document
Python,547,7161,2334.542199074074,MERGED,10,14,3,1,7,113,False,1,0,0,919,24,171.44972222222222,Bug
Go,421,1654,1608.914050925926,MERGED,38,60,4,0,3,522,True,0,0,0,1836,98,145.86805555555554,Bug
Vue,293,495,929.001412037037,MERGED,3,3,12,5,1,440,False,0,5,4,800,6,1.0341666666666667,Bug
TypeScript,12,11,1085.4007175925926,MERGED,3,211,5,0,11,90,False,0,0,0,2377,214,43.68333333333333,Feature
TypeScript,261,3764,773.8821527777777,MERGED,2,17,3,0,2,281,True,0,0,0,1859,19,14.037222222222223,Document
TypeScript,2147,14725,1570.080023148148,MERGED,9,462,5,0,1,809,False,0,0,0,1935,471,25.9125,Feature
TypeScript,7,6,742.1717476851851,CLOSED,5311,3006,19,0,4,329,False,0,0,0,249,8317,162.56416666666667,Feature
TypeScript,7,6,740.9212847222221,MERGED,3,4,3,0,2,267,False,0,0,0,1007,7,0.77,Feature
JavaScript,5140,7054,1302.6475231481481,MERGED,27,55,4,1,2,97,False,0,1,1,1510,82,21.735833333333332,Feature
TypeScript,12,11,1085.2215393518518,MERGED,0,178,1,0,1,89,False,0,0,0,2002,178,8.959166666666667,Feature
Vue,10811,21164,1120.7118518518519,MERGED,1,1,1,0,1,207,False,0,0,0,1243,2,61.50277777777778,Document
TypeScript,12,11,1085.1096180555555,MERGED,26,780,4,0,5,88,False,0,0,0,2019,806,11.773888888888889,Feature
Go,11874,71346,2792.487789351852,MERGED,22,14,9,0,1,310,True,0,0,0,258,36,0.05416666666666667,Bug
TypeScript,261,3764,772.6621990740741,MERGED,3,9,3,0,1,148,False,0,0,0,1861,12,2.4786111111111113,Document
TypeScript,261,3764,772.6342592592592,MERGED,3,3,3,0,1,147,False,0,0,0,1707,6,2.169722222222222,Document
TypeScript,2147,14725,1569.1744791666667,MERGED,34,5,1,0,1,805,False,0,0,0,2105,39,14.269166666666667,Bug
TypeScript,4,33,859.4518518518518,CLOSED,0,0,0,1,7,432,True,0,1,1,75,0,57.05916666666667,Feature
Vue,293,495,927.1054976851851,MERGED,2,7,1,3,1,437,False,0,3,3,989,9,15.342777777777778,Bug
Python,547,7161,2334.7829282407406,MERGED,2,14,1,0,7,8,False,0,0,0,1052,16,38.14,Bug
TypeScript,12,11,1088.416226851852,MERGED,3,193,3,0,1,205,False,0,0,0,2295,196,94.06555555555556,Feature
TypeScript,12,11,1088.3799305555556,MERGED,30,571,7,0,4,204,False,0,0,0,2919,601,96.05611111111111,Feature
TypeScript,12,11,1088.3051967592594,MERGED,60,665,7,0,4,203,False,0,0,0,3054,725,97.95361111111112,Feature
TypeScript,12,11,1088.2639699074073,MERGED,72,1011,5,0,24,202,False,0,0,0,2921,1083,99.30527777777777,Feature
TypeScript,2147,14725,1569.0524305555555,MERGED,6,16,3,0,1,40,False,0,0,0,1983,22,0.9444444444444444,Feature
Python,547,7161,2334.7782291666667,CLOSED,8,10,3,0,2,49,False,0,0,0,1010,18,17.6725,Bug
JavaScript,9664,43891,3756.7045370370374,CLOSED,2,96293,2,5,4,0,False,2,3,1,392,96295,294.47333333333336,Feature
Python,547,7161,2334.566851851852,MERGED,173,166,7,0,8,166,False,0,0,0,1241,339,21.264722222222222,Bug
TypeScript,261,3764,771.7213078703703,MERGED,130,106,9,0,9,1079,True,0,0,0,2355,236,17.95611111111111,Document
TypeScript,261,3764,771.7034027777778,MERGED,4,4,3,0,4,1078,True,0,0,0,1805,8,18.65138888888889,Document
Python,547,7161,2334.7756944444445,CLOSED,2,9,1,0,1,7,False,0,0,0,904,11,0.1,Bug
TypeScript,3393,2334,1066.9531597222222,MERGED,0,0,4,1,1,188,False,0,1,1,226,0,0.058055555555555555,Feature
Go,395,660,1364.8817824074074,MERGED,1,9,1,0,1,90,False,0,0,0,235,10,172.40694444444443,Feature
Python,547,7161,2334.558101851852,MERGED,29,25,18,1,4,639,True,0,1,1,855,54,0.34833333333333333,Feature
Go,421,1654,1608.2059722222223,MERGED,39,84,8,0,5,88,False,0,0,0,1848,123,19.400277777777777,Bug
TypeScript,2147,14725,1572.2471643518518,MERGED,125,1108,12,0,1,814,False,0,0,0,2964,1233,95.33166666666666,Bug
Vue,10811,21164,1119.299074074074,MERGED,0,1,1,0,2,206,False,0,0,0,1208,1,21.3525,Bug
PHP,883,2338,1928.307210648148,CLOSED,7,10,2,1,1,4,False,0,1,1,1863,17,352.41194444444443,Feature
Go,395,660,1362.102800925926,MERGED,1,7,1,0,2,158,False,0,0,0,239,8,0.3252777777777778,Feature
Python,547,7161,2333.8635995370373,MERGED,0,16,2,0,3,163,False,0,0,0,975,16,17.94972222222222,Bug
Go,395,660,1361.8559722222224,MERGED,0,0,1,0,2,155,False,0,0,0,218,0,0.5019444444444444,Feature
Go,421,1654,1607.9577083333334,MERGED,18,37,2,0,3,87,False,0,0,0,1265,55,5.169722222222222,Document
TypeScript,12,11,1087.445300925926,MERGED,4,242,4,0,20,201,False,0,0,0,2599,246,43.39861111111111,Feature
TypeScript,12,11,1087.4209953703705,MERGED,5,114,2,0,3,200,False,0,0,0,2398,119,43.196666666666665,Bug
Python,547,7161,2333.2301041666665,MERGED,10,35,3,0,3,637,True,0,0,0,701,45,5.185277777777777,Bug
TypeScript,7,6,743.847175925926,MERGED,28,86,3,1,13,248,False,0,1,1,1579,114,2.7344444444444442,Feature
TypeScript,85,724,415.1690162037037,MERGED,2,63,6,0,3,35,False,0,0,0,2856,65,2.1241666666666665,Document
TypeScript,85,724,415.1485300925926,MERGED,2,63,6,0,3,34,False,0,0,0,2676,65,1.9375,Document
TypeScript,85,724,415.0949074074074,MERGED,6,6,3,0,1,142,False,0,0,0,3045,12,0.04083333333333333,Document
PHP,1334,2960,4304.226712962963,MERGED,141,252,4,1,5,892,False,0,1,1,2071,393,69.81972222222223,Feature
Go,395,660,1364.0469328703705,MERGED,40,23,1,0,2,159,False,0,0,0,180,63,21.77777777777778,Feature
TypeScript,85,724,414.90591435185183,MERGED,36,35,3,0,3,141,False,0,0,0,2601,71,4.277777777777778,Document
TypeScript,202,107,1244.0065162037038,MERGED,2,2,2,3,3,135,False,0,3,3,1527,4,132.16944444444445,Document
TypeScript,261,3764,775.8451273148148,MERGED,17,42,6,0,1,231,False,0,0,0,2508,59,0.39694444444444443,Document
Vue,293,495,930.2064699074075,MERGED,10,0,1,8,3,1,False,2,6,5,1492,10,38.54361111111111,Bug
Go,1174,11429,1940.7477546296295,MERGED,195,75,29,0,4,688,True,0,0,0,1257,270,28.334444444444443,Document
JavaScript,5140,7054,1302.6701967592592,MERGED,4,466,10,2,8,355,False,1,1,1,2577,470,22.880277777777778,Feature
TypeScript,42,46,868.9924768518518,MERGED,0,2,2,1,1,194,False,0,1,1,264,2,0.03916666666666667,Feature
Rust,433,2229,334.55074074074076,MERGED,1,1,1,0,1,1199,False,0,0,0,204,2,4.303888888888889,Feature
TypeScript,85,724,411.88266203703705,MERGED,59,293,12,0,27,27,False,0,0,0,2999,352,163.69694444444445,Document
Vue,293,495,929.9434259259259,MERGED,4,4,3,7,2,32,True,1,6,4,1474,8,22.108055555555556,Bug
Vue,293,495,929.9289467592592,MERGED,1,4,2,6,3,31,True,0,6,5,1487,5,22.294166666666666,Bug
TypeScript,15,34,589.2374189814815,MERGED,3,22,1,0,2,538,True,0,0,0,272,25,25.715555555555557,Bug
Vue,293,495,929.9009953703703,MERGED,0,1,1,9,1,30,True,1,8,7,1532,1,21.925555555555555,Bug
Vue,293,495,927.7805092592592,MERGED,26,332,5,19,22,13,False,4,15,8,1245,358,149.29666666666665,Bug
JavaScript,5140,7054,1303.656238425926,MERGED,8,206,9,4,4,285,False,2,2,2,3199,214,283.6797222222222,Feature
Python,547,7161,2336.6953703703703,CLOSED,0,180,2,1,11,168,False,1,0,0,1948,180,119.71388888888889,Bug
Go,395,660,1364.9489930555555,MERGED,0,4,1,0,1,162,False,0,0,0,207,4,0.0875,Bug
Go,395,660,1364.8380324074074,MERGED,8,23,6,0,6,161,False,0,0,0,247,31,5.166944444444445,Bug
PHP,883,2338,1931.9506712962964,CLOSED,1,1,1,0,1,1,False,0,0,0,1620,2,0.6336111111111111,Document
PHP,1334,2960,4303.995,MERGED,4,4,1,1,1,98,False,0,1,1,1894,8,0.09027777777777778,Document
TypeScript,178,1359,417.6150231481481,MERGED,5,105,7,5,5,2,False,2,3,2,2688,110,108.11277777777778,Feature
TypeScript,85,724,413.4191087962963,MERGED,16,157,8,0,5,31,False,0,0,0,3382,173,14.276111111111112,Document
TypeScript,7,6,742.0001851851852,MERGED,1,28,2,1,1,246,False,0,1,1,1425,29,0.21166666666666667,Feature
TypeScript,7,6,741.9115856481482,MERGED,2,2,2,1,1,245,False,0,1,1,1498,4,0.4891666666666667,Feature
TypeScript,85,724,413.24532407407406,MERGED,200,19,3,0,8,110,False,0,0,0,2970,219,1.8288888888888888,Document
Go,1174,11429,1939.635335648148,CLOSED,0,5,1,0,1,392,True,0,0,0,1725,5,311.34055555555557,Document
TypeScript,85,724,413.19609953703707,CLOSED,17,18,2,0,5,109,False,0,0,0,3196,35,1.1836111111111112,Document
TypeScript,202,107,1244.041863425926,MERGED,13,12,1,3,2,311,True,0,3,3,1868,25,13.359166666666667,Bug
Vue,293,495,928.6892013888888,MERGED,1,53,2,7,2,0,False,0,7,4,1357,54,23.41888888888889,Bug
Python,547,7161,2335.421967592593,MERGED,30,332,11,0,21,328,True,0,0,0,1430,362,145.80138888888888,Bug
TypeScript,1297,21107,515.0741666666667,MERGED,1,2,1,1,1,48,False,0,1,1,1791,3,10.401666666666667,Document
Python,547,7161,2334.745925925926,MERGED,3,87,3,0,17,167,False,0,0,0,1254,90,184.37666666666667,Bug
Go,395,660,1364.08625,MERGED,1,1,1,0,1,160,False,0,0,0,211,2,0.075,Bug
Python,547,7161,2337.5612962962964,MERGED,2,41,4,0,6,333,True,0,0,0,1091,43,0.5013888888888889,Bug
TypeScript,15,34,588.2936342592592,MERGED,1,1,1,0,1,537,True,0,0,0,275,2,0.335,Feature
TypeScript,1297,21107,514.9812847222222,MERGED,3,11,1,1,3,1295,True,0,1,1,1548,14,0.2822222222222222,Document
Vue,293,495,928.0203703703704,MERGED,2,7,3,7,1,438,False,1,6,5,1271,9,15.565555555555555,Bug
V,2097,34362,1651.6500694444446,MERGED,0,8,3,0,1,235,True,0,0,0,1355,8,1.6308333333333334,Feature
Kotlin,164,4297,503.73412037037036,MERGED,1,7,1,10,11,1,False,5,5,2,612,8,266.58222222222224,Bug
TypeScript,2147,14725,1569.233703703704,MERGED,5,198,7,0,1,806,False,0,0,0,3162,203,12.837777777777777,Document
Vue,293,495,928.0439004629629,MERGED,15,21,4,5,3,439,False,0,5,5,1525,36,17.166944444444443,Bug
TypeScript,261,3764,774.8403935185185,MERGED,20,66,4,0,1,55,False,0,0,0,2013,86,0.8038888888888889,Document
TypeScript,15,34,587.4027893518519,MERGED,0,1,1,0,1,395,False,0,0,0,230,1,2.136388888888889,Feature
Rust,433,2229,334.6648148148148,MERGED,19,51,1,0,3,1202,False,0,0,0,401,70,3.1675,Document
Rust,433,2229,334.51283564814815,MERGED,7,8,5,0,2,1197,False,0,0,0,273,15,1.0427777777777778,Feature
Go,1174,11429,1937.8746527777778,MERGED,4,16,2,0,1,505,False,0,0,0,1194,20,0.3877777777777778,Bug
TypeScript,307,2556,637.4927430555556,MERGED,1,2,1,1,2,598,True,0,1,1,898,3,3.6838888888888888,Bug
Vue,293,495,925.9501157407408,MERGED,33,287,3,26,11,436,False,7,19,8,1136,320,43.70305555555556,Bug
Vue,293,495,927.7089467592592,MERGED,1,1,1,8,1,29,True,2,6,5,1573,2,1.56,Bug
TypeScript,15,34,586.7211111111111,MERGED,0,1,1,0,1,1112,False,0,0,0,279,1,0.3308333333333333,Document
TypeScript,15,34,586.2385763888889,MERGED,33,2,2,0,2,169,False,0,0,0,248,35,25.52611111111111,Feature
C#,80,125,917.7610648148147,MERGED,79,78,9,0,23,164,True,0,0,0,394,157,44.85805555555555,Document
Go,395,660,1362.0390277777778,MERGED,2,2,1,0,1,157,False,0,0,0,225,4,0.3308333333333333,Feature
Go,395,660,1362.012824074074,MERGED,0,0,1,0,1,156,False,0,0,0,224,0,0.07583333333333334,Feature
Go,1835,11246,1825.878587962963,MERGED,2,1,1,0,1,130,False,0,0,0,241,3,0.28,Feature
PHP,1334,2960,4306.1270023148145,MERGED,1,1,1,3,1,4,False,0,3,2,2143,2,0.7202777777777778,Document
TypeScript,7,6,741.9887037037038,MERGED,29,18,2,1,6,65,True,0,1,1,2636,47,27.86722222222222,Feature
Python,547,7161,2333.852986111111,MERGED,0,70,2,0,3,162,False,0,0,0,1346,70,64.48222222222222,Bug
C#,655,7879,1927.327025462963,MERGED,2,10,1,0,8,1531,True,0,0,0,530,12,22.230833333333333,Feature
TypeScript,202,107,1240.8078587962962,MERGED,4,4,2,3,1,309,True,0,3,3,1455,8,44.33861111111111,Bug
Go,1174,11429,1941.1776504629631,MERGED,9,2,1,2,1,188,True,2,0,0,1759,11,3.7169444444444446,Document
Go,752,2399,824.4873958333333,CLOSED,0,6,1,0,1,87,False,0,0,0,1180,6,2.3455555555555554,Bug
JavaScript,5140,7054,1300.8544212962963,MERGED,20,792,12,2,5,116,False,1,1,1,3452,812,186.8275,Feature
Go,752,2399,823.4491435185186,MERGED,0,15,2,0,1,86,False,0,0,0,1335,15,28.974722222222223,Bug
Go,752,2399,823.8199421296296,CLOSED,2,6,1,0,2,485,False,0,0,0,1680,8,0.55,Bug
JavaScript,9664,43891,3756.0402199074074,MERGED,3,71,2,0,2,91,True,0,0,0,411,74,0.5508333333333333,Feature
Go,1174,11429,1940.1176273148149,CLOSED,17,1220,13,1,4,139,True,1,0,0,1926,1237,1.7827777777777778,Document
Go,2083,11770,1617.2328125000001,MERGED,3,0,1,0,1,960,True,0,0,0,1379,3,0.019166666666666665,Document
TypeScript,15,34,587.4900694444444,MERGED,35,59,10,0,4,396,False,0,0,0,426,94,3.5411111111111113,Bug
TypeScript,15,34,587.4861805555555,MERGED,3,7,1,0,2,536,True,0,0,0,254,10,3.3602777777777777,Bug
PHP,883,2338,1929.8778356481482,CLOSED,0,0,0,5,0,1,False,3,2,1,2268,0,49.47277777777778,Document
Go,395,660,1362.4315856481483,MERGED,0,17,1,0,1,102,False,0,0,0,299,17,37.56805555555555,Bug
C#,80,125,918.7001504629629,MERGED,9,9,1,0,1,200,False,0,0,0,594,18,0.7791666666666667,Document
TypeScript,12,11,1088.3381828703702,MERGED,284,701,17,1,20,92,False,1,0,0,3610,985,93.48944444444444,Feature
Kotlin,164,4297,503.7217824074074,CLOSED,1,14,2,0,1,0,False,0,0,0,646,15,0.28444444444444444,Bug
TypeScript,15,34,588.4692708333333,MERGED,119,263,23,0,15,171,False,0,0,0,568,382,49.18194444444445,Feature
TypeScript,3989,23863,2927.941087962963,MERGED,5,25,3,1,4,69,False,0,1,1,547,30,28.008333333333333,Feature
Python,547,7161,2336.8542013888887,MERGED,12,81,3,0,12,4,False,0,0,0,1526,93,38.289722222222224,Bug
JavaScript,9664,43891,3755.0696412037037,MERGED,9,11,1,0,1,89,True,0,0,0,480,20,0.16583333333333333,Feature
JavaScript,5140,7054,1301.7955092592592,MERGED,21,320,9,2,4,117,False,1,1,1,2787,341,18.814444444444444,Feature
Python,547,7161,2336.8329050925927,MERGED,14,149,4,0,10,169,False,0,0,0,2071,163,37.90111111111111,Bug
Go,1174,11429,1938.8635763888888,MERGED,37,80,7,3,1,490,True,1,2,1,1997,117,2.1708333333333334,Document
Go,395,660,1364.2307175925926,MERGED,2,2,1,0,1,1,False,0,0,0,588,4,17.616944444444446,Bug
TypeScript,15,34,588.4046527777778,MERGED,78,90,13,0,6,397,False,0,0,0,521,168,21.552222222222223,Feature
Go,395,660,1363.9572685185185,MERGED,1,1,1,0,1,0,False,0,0,0,482,2,23.935,Bug
Go,1174,11429,1937.9350000000002,CLOSED,280,0,3,0,1,489,True,0,0,0,1734,280,0.03138888888888889,Document
Go,1174,11429,1937.8688541666668,MERGED,180,0,2,1,1,488,True,1,0,0,1796,180,0.12694444444444444,Document
TypeScript,41370,87415,3037.0845023148145,MERGED,0,2,2,2,5,0,False,0,2,2,1913,2,13.662777777777778,Document
Vue,293,495,927.0202430555555,MERGED,31,58,31,7,6,28,True,1,6,5,1847,89,26.490833333333335,Bug
TypeScript,2070,16643,1342.3320601851851,MERGED,3,11,1,0,3,81,True,0,0,0,2699,14,188.7697222222222,Bug
TypeScript,12,11,1086.362349537037,MERGED,16,196,13,0,105,55,False,0,0,0,4091,212,68.03333333333333,Feature
Go,1174,11429,1937.3492592592593,MERGED,2,3,1,0,1,102,False,0,0,0,1833,5,11.963888888888889,Document
Vue,293,495,926.7938310185185,MERGED,0,2,1,6,1,27,True,0,6,5,1859,2,0.7027777777777777,Bug
Go,1174,11429,1936.8290277777778,MERGED,1568,1692,84,0,4,684,True,0,0,0,2068,3260,43.44972222222222,Document
Go,1174,11429,1940.8540162037036,MERGED,180,492,21,10,17,690,True,6,4,3,2641,672,224.03666666666666,Document
TypeScript,2070,16643,1342.0111805555555,MERGED,0,1,1,0,3,0,False,0,0,0,2507,1,199.175,Bug
Go,1174,11429,1939.710752314815,MERGED,236,59,13,12,7,393,True,4,8,5,2229,295,293.1588888888889,Document
TypeScript,2070,16643,1341.988923611111,MERGED,0,1,1,0,1,0,False,0,0,0,2325,1,197.6172222222222,Bug
TypeScript,178,1359,418.88424768518513,MERGED,291,194,7,2,1,54,True,0,2,2,3736,485,43.437777777777775,Document
TypeScript,2070,16643,1341.0813078703704,MERGED,4,18,1,0,1,0,False,0,0,0,3029,22,219.4425,Document
TypeScript,15,34,586.4855671296297,MERGED,18,41,3,0,3,534,True,0,0,0,437,59,0.6230555555555556,Feature
TypeScript,85,724,413.4951736111111,MERGED,16,157,8,0,5,32,False,0,0,0,4165,173,13.096388888888889,Document
JavaScript,9664,43891,3756.1090856481483,MERGED,3,81,2,0,2,92,True,0,0,0,519,84,2.022222222222222,Feature
TypeScript,12,11,1084.7049421296297,MERGED,11,400,3,0,93,54,False,0,0,0,3719,411,107.6361111111111,Feature
TypeScript,58,78,916.9660300925925,MERGED,11,249,4,1,5,139,False,0,1,1,4905,260,32.316944444444445,Feature
JavaScript,9664,43891,3755.8665162037037,MERGED,0,2,1,0,1,340,True,0,0,0,579,2,0.16722222222222222,Feature
TypeScript,261,3764,774.7921296296296,MERGED,51,70,2,0,2,153,True,0,0,0,3220,121,0.4477777777777778,Document
C#,80,125,918.4882291666667,MERGED,21365,34041,150,0,22,199,False,0,0,0,708,55406,7.403888888888889,Document
TypeScript,15,34,589.4827777777778,MERGED,1,8,2,0,2,539,True,0,0,0,499,9,0.41194444444444445,Bug
Go,1174,11429,1939.9311342592591,MERGED,6167,5078,34,4,17,394,True,0,4,4,2246,11245,189.40166666666667,Document
Go,1174,11429,1939.8054861111111,CLOSED,148,185,6,1,2,512,True,1,0,0,2268,333,2.231388888888889,Document
JavaScript,9664,43891,3755.130150462963,MERGED,1,51,2,0,7,90,True,0,0,0,497,52,21.098055555555554,Feature
TypeScript,261,3764,774.4277083333333,MERGED,6,32,5,0,5,1084,True,0,0,0,4202,38,0.9763888888888889,Document
TypeScript,41370,87415,3034.8266898148145,CLOSED,0,1,1,3,1,1969,True,1,2,2,2117,1,21.168055555555554,Document
TypeScript,2070,16643,1340.0223611111112,MERGED,2,2,1,0,2,0,False,0,0,0,2322,4,201.19916666666666,Document
TypeScript,41370,87415,3034.4910416666667,MERGED,2,2,2,2,1,0,False,0,2,2,2018,4,8.002777777777778,Document
TypeScript,261,3764,773.5050578703704,MERGED,0,158,15,1,1,227,False,0,1,1,3582,158,0.2986111111111111,Document
JavaScript,9664,43891,3754.893738425926,MERGED,2,2,1,0,1,88,True,0,0,0,462,4,0.14916666666666667,Bug
TypeScript,261,3764,773.8429050925926,MERGED,74,84,21,0,4,1083,True,0,0,0,4711,158,2.3722222222222222,Document
TypeScript,261,3764,772.7459259259259,MERGED,166,589,24,0,8,226,False,0,0,0,3842,755,73.2625,Document
TypeScript,41370,87415,3034.6124768518516,MERGED,5,0,1,2,1,667,True,0,2,2,1992,5,1.6283333333333334,Document
TypeScript,261,3764,773.5060763888888,MERGED,142,259,11,0,7,239,True,0,0,0,4154,401,13.056111111111111,Document
Go,1174,11429,1939.4149537037038,MERGED,3,3,3,0,1,104,False,0,0,0,2559,6,161.95638888888888,Document
Go,752,2399,824.6011111111111,MERGED,5,20,1,0,1,486,False,0,0,0,728,25,0.008055555555555555,Bug
TypeScript,261,3764,773.4231944444444,MERGED,914,709,18,0,1,1081,True,0,0,0,4825,1623,1.043611111111111,Document
TypeScript,15,34,587.3959953703703,MERGED,293,489,10,0,8,535,True,0,0,0,608,782,48.467777777777776,Document
C#,80,125,916.8146412037037,MERGED,4,25,1,0,1,192,False,0,0,0,676,29,18.897222222222222,Document
Python,137,75,785.0323726851852,MERGED,1,7,2,0,1,243,False,0,0,0,1008,8,0.8338888888888889,Document
TypeScript,41370,87415,3033.7503819444446,MERGED,1,2,2,1,2,1967,True,0,1,1,2229,3,0.8188888888888889,Document
TypeScript,2147,14725,1571.9183217592592,MERGED,5,146,5,0,1,221,False,0,0,0,3258,151,0.7122222222222222,Document
Go,1174,11429,1940.805613425926,MERGED,138,216,6,4,2,515,True,3,1,1,2796,354,20.229166666666668,Document
Go,752,2399,823.6787037037037,MERGED,5,20,1,0,4,484,False,0,0,0,722,25,19.752777777777776,Bug
JavaScript,5140,7054,1302.8819907407408,MERGED,31,0,2,9,1,0,False,3,6,3,773,31,1.7438888888888888,Feature
TypeScript,15,34,587.398125,MERGED,9,452,5,0,3,394,False,0,0,0,588,461,2.7144444444444447,Bug
Go,1174,11429,1940.2149768518518,MERGED,43,123,4,3,4,395,True,2,1,1,2428,166,17.170833333333334,Document
Go,752,2399,825.4488657407406,MERGED,0,1231,20,0,15,184,False,0,0,0,3477,1231,173.7,Bug
JavaScript,5140,7054,1303.560787037037,MERGED,21,334,10,1,6,118,False,0,1,1,4169,355,22.125,Feature
Go,1174,11429,1938.905115740741,MERGED,130,124,7,4,2,511,True,3,1,1,2454,254,25.840833333333332,Document
Go,421,1654,1606.250289351852,MERGED,108,284,7,0,4,86,False,0,0,0,4979,392,43.57888888888889,Bug
TypeScript,41370,87415,3035.567071759259,MERGED,0,2,1,4,5,2,False,1,3,3,2216,2,24.024166666666666,Document
Go,1174,11429,1937.899201388889,MERGED,61,358,11,10,6,686,True,9,1,1,2146,419,67.69944444444444,Document
Python,72,25,1733.789236111111,MERGED,19,11,3,1,1,53,False,0,1,1,2715,30,0.19083333333333333,Document
Go,1174,11429,1938.651574074074,CLOSED,0,2,1,0,1,687,True,0,0,0,2158,2,10.640277777777778,Document
JavaScript,5140,7054,1302.8225694444443,MERGED,21,554,13,1,4,356,False,0,1,1,4941,575,18.963333333333335,Feature
TypeScript,3393,2334,1067.203148148148,CLOSED,2,2,1,2,1,537,False,0,2,1,1108,4,0.8647222222222222,Bug
Erlang,2054,12122,3893.308460648148,MERGED,38,47,2,0,2,97,False,0,0,0,985,85,19.810277777777777,Document
JavaScript,5140,7054,1301.8135879629629,MERGED,19,850,11,2,7,110,False,1,1,1,3638,869,67.41333333333333,Feature
TypeScript,3393,2334,1066.8573032407407,MERGED,2,2,1,2,1,532,False,0,2,1,1052,4,0.04,Feature
JavaScript,5140,7054,1300.780775462963,MERGED,21,1305,14,3,6,353,False,2,1,1,3579,1326,91.9575,Feature
TypeScript,1297,21107,513.8898263888889,MERGED,3,204,6,2,4,1285,True,0,2,2,3380,207,0.7280555555555556,Document
C#,80,125,918.1074652777778,MERGED,241,327,35,0,4,193,False,0,0,0,975,568,60.104166666666664,Document
Python,547,7161,2335.100532407407,MERGED,426,1323,40,1,80,640,True,0,1,1,2221,1749,60.31305555555556,Bug
C#,80,125,918.8550694444444,MERGED,18,23,1,0,1,194,False,0,0,0,848,41,2.546666666666667,Document
Go,1174,11429,1937.2058449074075,MERGED,27,229,11,0,5,504,False,0,0,0,2716,256,11.7225,Document
TypeScript,41370,87415,3036.788483796296,MERGED,2,2,1,2,2,0,False,0,2,2,2287,4,15.52,Document
TypeScript,41370,87415,3036.8711689814813,MERGED,1,17,2,2,2,27,True,0,2,2,2579,18,0.6713888888888889,Document
C#,80,125,918.6131597222221,MERGED,2,2,1,0,1,201,False,0,0,0,843,4,4.006666666666667,Document
TypeScript,41370,87415,3036.7018402777776,MERGED,4,24,3,2,2,77,False,0,2,2,2714,28,1.4619444444444445,Document
JavaScript,9664,43891,3755.06150462963,MERGED,3,4,3,0,5,2,False,0,0,0,662,7,21.104166666666668,Bug
Go,2083,11770,1617.8111805555554,MERGED,3,34,2,0,1,961,True,0,0,0,3174,37,0.8338888888888889,Document
C#,80,125,916.6036921296296,MERGED,13,54,2,0,1,42,False,0,0,0,889,67,1.4297222222222221,Document
C#,80,125,916.5923611111111,MERGED,9,27,3,0,1,106,False,0,0,0,844,36,1.9841666666666666,Document
JavaScript,5140,7054,1302.6892939814813,MERGED,21,363,13,1,3,0,False,0,1,1,3314,384,21.4475,Feature
TypeScript,41370,87415,3034.7425694444446,MERGED,2,2,1,2,1,668,True,0,2,2,2392,4,1.7308333333333332,Document
V,2097,34362,1647.3996412037038,MERGED,6,242,6,4,7,3,False,2,2,1,2486,248,24.75722222222222,Document
TypeScript,41370,87415,3034.514988425926,MERGED,2,2,2,2,1,4,False,0,2,2,2725,4,3.2294444444444443,Document
TypeScript,41370,87415,3034.486122685185,MERGED,1,1,1,3,1,1679,True,0,3,3,2115,2,2.953333333333333,Document
TypeScript,41370,87415,3034.439826388889,MERGED,1,1,1,2,1,665,True,0,2,2,2203,2,3.528888888888889,Document
JavaScript,5140,7054,1301.8719675925925,MERGED,21,446,13,2,5,0,False,1,1,1,3465,467,48.79888888888889,Feature
TypeScript,15,34,586.488425925926,MERGED,65,99,5,0,2,170,False,0,0,0,733,164,44.31527777777778,Feature
TypeScript,41370,87415,3033.463101851852,MERGED,14,14,12,2,4,1677,True,0,2,2,2443,28,2.8113888888888887,Document
TypeScript,41370,87415,3034.021712962963,MERGED,1,13,1,1,1,527,True,0,1,1,2168,14,9.386111111111111,Document
TypeScript,41370,87415,3033.7426736111115,MERGED,7,11,2,3,3,158,True,2,1,1,2944,18,3.5455555555555556,Document
C#,655,7879,1926.689212962963,MERGED,32,70,2,4,2,26,False,0,4,3,1995,102,19.849166666666665,Document
TypeScript,41370,87415,3033.4841319444445,MERGED,0,2,1,2,1,0,False,0,2,2,2557,2,0.8977777777777778,Document
TypeScript,12,11,1088.1042824074075,CLOSED,103,118,78,0,1,10,True,0,0,0,5731,221,96.33638888888889,Feature
C#,655,7879,1925.9445949074072,MERGED,3,8,1,1,1,25,False,0,1,1,1962,11,10.249722222222223,Document
C#,655,7879,1925.1112037037037,MERGED,1,1,1,1,1,630,True,0,1,1,1583,2,21.26888888888889,Document
Erlang,2054,12122,3895.1560185185185,MERGED,28,159,26,1,4,32,False,1,0,0,1426,187,101.86583333333333,Document
Kotlin,164,4297,501.03728009259254,CLOSED,1,136,5,1,1,0,False,0,1,1,1598,137,232.60611111111112,Bug
Erlang,2054,12122,3895.168599537037,MERGED,4,1,1,0,1,454,False,0,0,0,1115,5,99.65805555555555,Document
TypeScript,12,11,1085.821099537037,MERGED,42,250,9,1,13,416,False,1,0,0,7808,292,156.58944444444444,Bug
TypeScript,2070,16643,1338.646701388889,MERGED,17,26,2,0,5,21,False,0,0,0,3873,43,282.39194444444445,Document
Python,2409,12193,340.0786689814815,MERGED,482,352,51,0,41,457,True,0,0,0,1362,834,72.32444444444444,Document
Go,1174,11429,1938.2572106481482,MERGED,398,624,6,3,7,131,False,1,2,2,3531,1022,207.9922222222222,Document
Erlang,2054,12122,3894.276053240741,MERGED,4,11,6,0,1,452,False,0,0,0,1477,15,121.07555555555555,Document
C#,80,125,919.7359837962963,MERGED,703,853,114,0,32,110,False,0,0,0,1396,1556,186.01527777777778,Document
Go,1174,11429,1940.9965509259257,MERGED,30,146,10,5,1,491,True,2,3,2,3536,176,20.83,Document
TypeScript,2147,14725,1572.1459259259261,MERGED,1,3,2,0,2,49,False,0,0,0,1387,4,0.5380555555555555,Bug
TypeScript,58,78,918.137199074074,MERGED,20,132,13,1,1,232,True,0,1,1,6059,152,22.754722222222224,Bug
Erlang,2054,12122,3895.2880555555553,MERGED,71,878,26,0,30,455,False,0,0,0,1410,949,21.673055555555557,Document
Erlang,2054,12122,3895.104780092593,MERGED,0,6,1,0,1,453,False,0,0,0,1204,6,28.9475,Document
Go,1174,11429,1940.67,MERGED,81,167,3,1,2,514,True,1,0,0,2837,248,5.433888888888889,Document
Go,1174,11429,1940.423784722222,MERGED,622,1019,12,3,10,132,False,1,2,2,3464,1641,20.543055555555554,Document
TypeScript,3393,2334,1066.9132175925927,MERGED,1,10,2,2,2,534,False,0,2,1,1617,11,144.59666666666666,Feature
Erlang,2054,12122,3895.30775462963,MERGED,3,5,2,0,1,150,False,0,0,0,1308,8,2.358888888888889,Document
TypeScript,41370,87415,3036.469074074074,MERGED,5,26,1,4,2,669,True,0,4,4,3357,31,2.98,Document
Go,1174,11429,1940.274664351852,MERGED,61,263,7,1,3,396,True,1,0,0,2818,324,14.538333333333334,Document
Erlang,2054,12122,3894.8629050925924,MERGED,8,18,3,1,3,33,True,1,0,0,1281,26,9.08388888888889,Document
Go,1174,11429,1939.9877546296295,MERGED,118,207,3,1,1,513,True,1,0,0,2699,325,15.891111111111112,Document
TypeScript,261,3764,775.844085648148,MERGED,589,166,24,0,1,230,False,0,0,0,6481,755,0.30972222222222223,Document
Java,450,746,4170.591956018518,MERGED,3,46,2,1,5,26,False,0,1,1,1801,49,179.09722222222223,Bug
Starlark,440,286,587.8830787037037,CLOSED,0,696,3,1,2,10,False,0,1,1,1137,696,66.75666666666666,Feature
Erlang,2054,12122,3894.1664930555557,MERGED,5,19,5,0,1,450,False,0,0,0,1205,24,21.950277777777778,Document
Erlang,2054,12122,3894.1545717592594,MERGED,5,12,1,0,1,92,False,0,0,0,1250,17,19.767777777777777,Document
Erlang,2054,12122,3894.149814814815,CLOSED,5,5,2,0,2,32,True,0,0,0,1194,10,17.099444444444444,Document
Erlang,2054,12122,3893.3209606481482,MERGED,3,44,3,1,1,31,False,1,0,0,1354,47,65.21916666666667,Document
Erlang,2054,12122,3894.196261574074,MERGED,1,11,3,0,1,451,False,0,0,0,1260,12,5.948055555555555,Document
TypeScript,4,33,862.4824537037038,MERGED,4,3,3,1,2,275,False,0,1,1,1222,7,0.18555555555555556,Bug
Python,2409,12193,338.8692824074074,CLOSED,1,1,1,1,2,0,False,1,0,0,1429,2,0.43666666666666665,Bug
Erlang,2054,12122,3894.0897222222225,MERGED,16,38,4,0,2,445,True,0,0,0,1250,54,0.8991666666666667,Document
JavaScript,22,26,1014.8059027777778,MERGED,131,131,1,0,3,19,True,0,0,0,1519,262,9.329722222222221,Bug
TypeScript,3393,2334,1065.902986111111,MERGED,492,576,38,3,6,777,False,1,2,2,1414,1068,120.16722222222222,Feature
Erlang,2054,12122,3893.1983680555554,MERGED,30,193,5,0,1,447,False,0,0,0,1373,223,45.176944444444445,Document
Python,137,75,781.6560648148148,MERGED,0,424,11,0,8,47,False,0,0,0,1078,424,78.96944444444445,Document
C++,363,552,636.2448263888889,MERGED,0,4,1,0,1,316,False,0,0,0,1526,4,1.2475,Document
TypeScript,15,34,589.3772800925926,MERGED,63,836,20,1,14,212,False,1,0,0,1046,899,115.915,Feature
Erlang,2054,12122,3893.414861111111,MERGED,2,18,5,0,1,449,False,0,0,0,1179,20,18.131944444444443,Document
TypeScript,3393,2334,1067.3596064814815,MERGED,2,2,2,1,2,540,False,0,1,1,1364,4,0.30527777777777776,Document
TypeScript,1297,21107,515.6938194444444,MERGED,20,20,20,2,1,50,False,1,1,1,5117,40,6.8677777777777775,Document
TypeScript,3393,2334,1067.1172337962964,MERGED,9,0,1,2,1,0,False,0,2,1,1421,9,0.5116666666666667,Feature
TypeScript,3393,2334,1067.2289583333334,MERGED,11,12,2,1,1,779,False,0,1,1,1667,23,0.24666666666666667,Bug
TypeScript,3393,2334,1067.171238425926,MERGED,2,2,1,1,1,16,False,0,1,1,1383,4,0.05583333333333333,Bug
Erlang,2054,12122,3893.3087384259256,MERGED,2,10,4,0,2,208,False,0,0,0,1354,12,2.2133333333333334,Document
Erlang,2054,12122,3893.2785995370373,MERGED,0,87,3,0,4,448,False,0,0,0,1423,87,2.2172222222222224,Document
C#,80,125,918.932037037037,MERGED,14,590,8,0,10,195,False,0,0,0,1223,604,42.708333333333336,Document
TypeScript,2147,14725,1569.0965509259258,MERGED,33,241,5,0,1,72,False,0,0,0,5371,274,21.585277777777776,Document
Erlang,2054,12122,3892.462175925926,MERGED,7,67,5,1,1,30,False,1,0,0,1196,74,47.82527777777778,Document
Go,1174,11429,1938.0587847222223,MERGED,24,6,9,0,6,103,False,0,0,0,2697,30,11.268888888888888,Document
Python,2409,12193,337.8104861111111,CLOSED,11,0,1,1,1,1,False,1,0,0,1327,11,0.1461111111111111,Feature
TypeScript,3393,2334,1066.1186111111112,MERGED,18,14,2,2,1,0,False,0,2,1,1697,32,17.36722222222222,Feature
TypeScript,1297,21107,515.0878819444445,MERGED,102,85,7,1,3,1297,True,0,1,1,3741,187,10.040277777777778,Document
C#,655,7879,1927.8779861111109,MERGED,3,8,3,1,3,633,True,0,1,1,2119,11,5.112777777777778,Document
TypeScript,202,107,1242.8834143518518,MERGED,9,198,5,3,3,19,True,0,3,3,3437,207,46.82555555555555,Document
Java,450,746,4171.191516203704,MERGED,1,21,3,1,2,671,False,0,1,1,1456,22,19.497222222222224,Bug
C#,80,125,918.7481250000001,MERGED,25,205,10,0,3,202,False,0,0,0,1307,230,27.76638888888889,Document
TypeScript,4,33,861.0866203703704,MERGED,20,81,9,1,9,419,False,0,1,1,1370,101,0.5305555555555556,Bug
TypeScript,3393,2334,1065.302025462963,MERGED,1,7,1,2,1,0,False,0,2,1,1455,8,4.7225,Bug
C#,80,125,918.5214120370371,CLOSED,101,139,10,0,7,108,False,0,0,0,1198,240,26.517777777777777,Document
TypeScript,261,3764,773.0666087962964,MERGED,7,94,10,0,7,29,True,0,0,0,5399,101,34.744166666666665,Document
TypeScript,3393,2334,1066.0200578703705,MERGED,0,3,1,1,1,393,False,0,1,1,1540,3,0.09305555555555556,Feature
TypeScript,1297,21107,514.655636574074,MERGED,493,106,23,1,3,1293,True,0,1,1,3907,599,0.6252777777777778,Document
C#,80,125,918.7388194444444,CLOSED,38,283,14,0,3,201,False,0,0,0,1221,321,0.17666666666666667,Document
C++,363,552,634.2273726851852,MERGED,8,55,2,0,3,315,False,0,0,0,1684,63,44.0975,Document
TypeScript,3393,2334,1065.919710648148,MERGED,14,18,2,2,2,530,False,0,2,1,1569,32,0.4147222222222222,Feature
C#,80,125,918.5559722222223,MERGED,16,78,4,0,1,109,False,0,0,0,1249,94,1.5766666666666667,Document
C#,655,7879,1926.4634837962965,MERGED,36,9,2,1,1,102,False,0,1,1,2168,45,10.446388888888889,Document
TypeScript,261,3764,772.8719097222223,MERGED,122,173,10,0,1,150,False,0,0,0,5281,295,14.670277777777779,Document
Erlang,2054,12122,3891.9509722222224,MERGED,4,3,3,2,1,414,True,1,1,1,1241,7,3.6308333333333334,Document
TypeScript,3393,2334,1065.3328819444444,MERGED,1,1,1,2,1,0,False,0,2,1,1261,2,1.7847222222222223,Feature
TypeScript,3393,2334,1065.3121296296297,MERGED,0,15,2,1,2,184,False,0,1,1,1589,15,0.02722222222222222,Feature
C#,655,7879,1925.8320370370373,MERGED,10,3,1,2,3,721,True,0,2,1,2396,13,55.66916666666667,Document
Go,752,2400,825.4451388888889,MERGED,128,314,13,0,5,326,False,0,0,0,4451,442,6.651388888888889,Bug
TypeScript,261,3764,772.5484259259259,MERGED,160,226,16,0,1,146,False,0,0,0,5117,386,2.3513888888888888,Document
TypeScript,41370,87415,3036.665983796296,MERGED,74,114,5,2,8,528,True,0,2,2,3251,188,19.089166666666667,Document
TypeScript,3393,2334,1064.954050925926,MERGED,10,4,1,2,1,529,False,0,2,1,1544,14,0.22694444444444445,Feature
TypeScript,41370,87415,3036.790625,MERGED,7,14,1,2,2,1971,True,0,2,2,2779,21,0.6088888888888889,Document
Java,450,746,4170.1407407407405,MERGED,2,497,32,2,10,172,False,0,2,1,4397,499,22.17888888888889,Bug
C#,655,7879,1925.840150462963,MERGED,0,47,1,2,3,25,False,1,1,1,2239,47,22.663333333333334,Document
C++,363,552,633.4335763888889,MERGED,3,3,1,0,2,17,True,0,0,0,1486,6,17.682222222222222,Document
TypeScript,41370,87415,3036.6193981481483,MERGED,15,70,3,2,2,670,True,0,2,2,4318,85,0.5677777777777778,Document
C#,80,125,917.4623263888889,MERGED,31,54,8,0,3,107,False,0,0,0,1410,85,2.450277777777778,Document
JavaScript,34,25,294.9059837962963,MERGED,5,13,2,0,2,99,False,0,0,0,1577,18,0.1411111111111111,Bug
TypeScript,3393,2334,1064.462673611111,MERGED,2,0,2,2,1,0,False,0,2,1,1735,2,7.5680555555555555,Bug
C#,655,7879,1925.873090277778,MERGED,3,3,1,1,1,723,True,0,1,1,2182,6,5.435277777777777,Document
C#,655,7879,1925.8089236111111,CLOSED,6,0,1,0,1,720,True,0,0,0,2220,6,1.361388888888889,Document
TypeScript,202,107,1240.655763888889,MERGED,37,47,5,2,5,329,True,0,2,2,5440,84,46.764722222222225,Document
Erlang,2054,12122,3893.1401157407404,MERGED,67,1521,27,9,3,446,False,4,5,2,1650,1588,314.08472222222224,Document
C#,655,7879,1925.0579976851852,MERGED,2,24,1,1,1,629,True,0,1,1,1987,26,22.5225,Document
Go,1835,11246,1827.9053587962962,MERGED,0,1,1,0,1,130,False,0,0,0,1599,1,0.043333333333333335,Document
TypeScript,3393,2334,1063.9844328703705,MERGED,2,2,2,1,1,183,False,0,1,1,1394,4,0.011944444444444445,Feature
C#,655,7879,1924.914722222222,MERGED,5,7,7,2,2,23,False,0,2,2,2397,12,27.35,Document
TypeScript,3393,2334,1063.9432060185184,MERGED,1,1,1,1,1,182,False,0,1,1,1090,2,0.11138888888888888,Feature
TypeScript,21,40,2380.964074074074,MERGED,1,1,2,1,1,63,False,0,1,1,1304,2,18.031666666666666,Bug
C#,655,7879,1923.8669675925928,MERGED,2,5,1,1,1,718,True,0,1,1,2478,7,82.61777777777777,Document
C#,655,7879,1923.8652430555555,MERGED,2,20,1,1,1,717,True,0,1,1,2491,22,82.64694444444444,Document
Erlang,2054,12122,3895.019513888889,MERGED,27,174,7,0,2,446,True,0,0,0,1910,201,159.40722222222223,Document
Starlark,440,286,589.9143287037037,MERGED,0,99,2,2,6,0,False,1,1,1,2216,99,140.65777777777777,Document
TypeScript,41370,87415,3034.6438541666666,MERGED,14,29,3,5,4,1968,True,1,4,4,3480,43,27.24388888888889,Document
JavaScript,5140,7054,1302.8479050925926,MERGED,4,346,10,2,3,0,False,1,1,1,4194,350,25.38722222222222,Feature
TypeScript,41370,87415,3034.026099537037,MERGED,0,2,1,3,1,0,False,0,3,3,1197,2,43.9925,Bug
C#,655,7879,1923.7626967592594,MERGED,13,0,1,1,1,715,True,0,1,1,2258,13,39.405,Document
TypeScript,41370,87415,3034.6487152777777,MERGED,10,14,2,2,1,7,False,0,2,2,4039,24,0.025277777777777777,Document
TypeScript,41370,87415,3033.8439699074074,MERGED,13,17,2,1,1,664,True,0,1,1,1350,30,0.7802777777777777,Document
Go,1835,11246,1825.9032175925925,MERGED,1,3,1,0,9,25,False,0,0,0,1596,4,0.09111111111111111,Document
TypeScript,2147,14725,1572.0748148148148,CLOSED,2,7,2,0,2,48,False,0,0,0,1580,9,2.238888888888889,Bug
TypeScript,41370,87415,3033.6694907407405,MERGED,12,9,1,2,4,1678,True,0,2,2,3039,21,0.8416666666666667,Document
JavaScript,5140,7054,1300.8387962962963,MERGED,70,19,16,1,2,354,False,0,1,1,6001,89,19.066666666666666,Feature
Python,2409,12193,339.53612268518515,MERGED,1,1,1,1,1,2,False,0,1,1,1930,2,4.005,Document
TypeScript,12,11,1088.5367013888888,MERGED,275,458,15,0,7,93,False,0,0,0,10617,733,88.41361111111111,Bug
TypeScript,41370,87415,3033.4945949074076,MERGED,0,9,2,1,2,662,True,0,1,1,4108,9,3.5147222222222223,Document
Python,2409,12193,340.0211111111111,MERGED,8,9,4,0,2,456,True,0,0,0,2221,17,0.3675,Document
Python,2409,12193,338.85829861111114,MERGED,1,1,1,1,1,1,False,0,1,1,1913,2,1.0247222222222223,Document
C#,655,7879,1927.3208564814815,MERGED,5,5,1,4,1,729,True,2,2,1,2427,10,23.11777777777778,Document
Python,2409,12193,339.0639351851852,MERGED,81,61,9,0,15,454,True,0,0,0,1743,142,17.122222222222224,Document
Python,2409,12193,338.7508101851852,CLOSED,1,1,1,2,1,0,False,1,1,1,1649,2,2.531111111111111,Document
Python,2409,12193,338.45325231481485,MERGED,8,10,1,4,2,0,False,2,2,1,2014,18,10.754444444444445,Document
TypeScript,4,33,859.2155902777778,MERGED,257,327,25,1,15,417,False,0,1,1,1760,584,193.8175,Bug
Python,2409,12193,338.2996759259259,MERGED,67,97,11,0,17,452,True,0,0,0,2032,164,17.14611111111111,Document
Python,2409,12193,338.4751967592593,CLOSED,8,38,2,0,2,17,False,0,0,0,2047,46,0.8491666666666666,Document
Erlang,2054,12122,3893.035069444444,MERGED,537,255,36,0,4,415,True,0,0,0,1764,792,36.708333333333336,Document
Erlang,2054,12122,3892.948657407407,MERGED,81,151,13,0,5,443,True,0,0,0,1800,232,30.61,Document
TypeScript,4,33,861.6634027777777,MERGED,205,267,14,1,9,434,True,0,1,1,2009,472,4.309166666666667,Bug
Python,2409,12193,337.9949652777778,MERGED,1,1,1,2,1,0,False,1,1,1,1650,2,1.8272222222222223,Document
TypeScript,3393,2334,1066.90375,MERGED,1,1,1,2,2,533,False,0,2,1,1645,2,0.38416666666666666,Feature
TypeScript,12,11,1086.5884375,MERGED,62,214,12,0,115,56,False,0,0,0,9269,276,68.61583333333333,Feature
TypeScript,3393,2334,1066.8383796296296,MERGED,18,16,4,1,3,187,False,0,1,1,2372,34,0.13416666666666666,Feature
Python,2409,12193,337.73015046296297,MERGED,3,3,3,2,3,0,False,1,1,1,2043,6,8.171111111111111,Document
Python,2409,12193,337.31960648148146,MERGED,105,84,15,0,15,451,True,0,0,0,2123,189,19.706666666666667,Document
TypeScript,4,33,859.4117824074074,MERGED,1524,1949,65,1,14,690,True,0,1,1,1698,3473,97.39527777777778,Document
C#,655,7879,1925.8628356481483,MERGED,10,292,8,2,6,14,False,2,0,0,2764,302,214.77916666666667,Document
Python,2409,12193,336.60568287037034,CLOSED,5,7,1,2,1,15,False,1,1,1,1693,12,18.2625,Document
Erlang,2054,12122,3891.6555902777777,MERGED,12,21,7,1,3,442,True,1,0,0,1780,33,10.660555555555556,Document
TypeScript,21,40,2382.561481481481,MERGED,36,3,1,1,2,66,False,0,1,1,2106,39,0.04055555555555555,Document
TypeScript,4,33,859.5517939814814,MERGED,21,12,3,1,1,268,False,0,1,1,1888,33,0.07333333333333333,Bug
TypeScript,3393,2334,1064.8491087962964,MERGED,2,2,1,1,2,776,False,0,1,1,1698,4,0.3308333333333333,Feature
TypeScript,4,33,859.3912152777779,MERGED,34,35,4,1,3,267,False,0,1,1,2009,69,0.30277777777777776,Feature
TypeScript,21,40,2381.009826388889,MERGED,3,22,3,1,3,64,False,0,1,1,1852,25,35.665277777777774,Feature
C#,655,7879,1926.367164351852,MERGED,1,30,2,2,4,726,True,0,2,2,2784,31,49.505,Document
Go,1835,11246,1827.7785532407406,MERGED,0,36,1,0,1,32,False,0,0,0,1905,36,1.4705555555555556,Document
Go,1835,11246,1827.5370486111112,MERGED,8,8,3,0,1,603,False,0,0,0,1914,16,0.8177777777777778,Document
C#,655,7879,1925.2776388888888,MERGED,1,167,5,4,3,719,True,0,4,2,2505,168,55.405,Document
Go,1835,11246,1826.8175810185185,MERGED,0,72,2,0,1,82,False,0,0,0,1941,72,0.16916666666666666,Document
C#,655,7879,1925.833298611111,MERGED,8,0,1,1,1,722,True,0,1,1,2490,8,7.665555555555556,Document
Go,1835,11246,1826.707349537037,MERGED,60,158,25,0,2,600,False,0,0,0,1728,218,0.9469444444444445,Document
Go,1835,11246,1826.5989930555554,MERGED,0,1,1,0,1,129,False,0,0,0,1684,1,0.7161111111111111,Document
Python,4517,54994,1024.6239930555555,MERGED,0,34,1,13,8,0,False,6,7,2,3201,34,361.45694444444445,Document
Go,1835,11246,1825.8102314814814,MERGED,2,47,3,0,1,24,False,0,0,0,2272,49,0.6061111111111112,Document
TypeScript,7,6,742.9203240740741,MERGED,12487,9408,120,0,40,247,False,0,0,0,6496,21895,121.45555555555555,Feature
Go,1174,11429,1940.1912384259258,MERGED,15,1337,16,2,12,140,True,1,1,1,4759,1352,36.79083333333333,Document
Kotlin,164,4297,501.8041782407408,MERGED,20,64,3,2,7,25,False,1,1,1,2491,84,142.07666666666665,Bug
Go,1835,11246,1824.6122106481482,MERGED,3,3,1,0,1,54,True,0,0,0,1899,6,0.03611111111111111,Document
TypeScript,3393,2334,1067.231412037037,CLOSED,77,137,5,1,3,17,False,0,1,1,2810,214,2.269722222222222,Bug
Python,2409,12193,339.8011921296296,MERGED,201,222,32,0,24,455,True,0,0,0,2891,423,4.426944444444445,Document
Java,450,746,4171.0446180555555,MERGED,162,326,11,2,14,98,True,0,2,1,6362,488,144.52055555555555,Bug
Python,2409,12193,339.1812268518518,MERGED,19,75,3,2,3,4,False,1,1,1,3418,94,12.535277777777777,Document
Python,2409,12193,339.0136689814815,MERGED,13,11,3,1,3,453,True,0,1,1,2810,24,0.5358333333333334,Document
TypeScript,1297,21107,515.0941898148147,MERGED,24,24,8,2,4,49,False,1,1,1,5240,48,11.568888888888889,Document
Python,2409,12193,338.5599537037037,CLOSED,7,37,1,0,1,20,False,0,0,0,2268,44,18.924444444444443,Document
Erlang,2054,12122,3893.8943287037036,MERGED,14,79,5,0,2,444,True,0,0,0,2632,93,2.1705555555555556,Document
Python,2409,12193,338.5358449074074,CLOSED,9,39,2,0,6,19,False,0,0,0,2450,48,0.035555555555555556,Document
Python,2409,12193,338.53238425925923,CLOSED,9,39,2,0,4,18,False,0,0,0,2988,48,0.06,Document
TypeScript,2147,14725,1570.0518518518518,MERGED,22,31,1,1,1,47,False,0,1,1,2916,53,2.7908333333333335,Feature
TypeScript,3393,2334,1067.187199074074,MERGED,1,191,8,1,1,395,False,0,1,1,2709,192,3.7111111111111112,Feature
TypeScript,4,33,861.6267939814815,MERGED,11,119,12,1,5,274,False,0,1,1,3157,130,0.4166666666666667,Bug
JavaScript,5140,7054,1302.9232407407408,MERGED,21,375,14,2,4,0,False,1,1,1,5433,396,206.95333333333335,Feature
Go,752,2400,825.7236342592593,MERGED,128,314,13,0,1,327,False,0,0,0,7018,442,0.035277777777777776,Document
TypeScript,3393,2334,1066.780613425926,CLOSED,2,13,2,1,1,186,False,0,1,1,2760,15,0.42916666666666664,Bug
Python,2409,12193,337.7065277777778,CLOSED,67,0,6,1,1,16,False,0,1,1,2567,67,1.2744444444444445,Document
TypeScript,4,33,860.7194675925925,MERGED,17,17,1,1,3,271,False,0,1,1,2658,34,5.471111111111111,Bug
TypeScript,4,33,861.1643634259259,MERGED,27,199,8,2,7,288,True,1,1,1,3086,226,4.632777777777778,Bug
TypeScript,1297,21107,514.0691782407407,MERGED,230,368,28,1,5,1289,True,0,1,1,7011,598,0.23305555555555554,Document
TypeScript,218,1201,3027.030381944445,MERGED,61,203,16,1,6,198,True,1,0,0,2659,264,163.73,Document
TypeScript,1073,11367,1192.754861111111,MERGED,4,10,2,1,2,327,True,0,1,1,2946,14,25.046388888888888,Document
TypeScript,4,33,860.530787037037,MERGED,148,372,15,1,5,418,False,0,1,1,2581,520,13.434722222222222,Bug
Python,2409,12193,336.7584722222222,MERGED,23,55,6,0,10,449,True,0,0,0,3121,78,4.949166666666667,Document
TypeScript,1073,11367,1192.773125,MERGED,7,7,7,0,1,328,True,0,0,0,2271,14,0.2247222222222222,Document
TypeScript,1297,21107,512.9431597222223,MERGED,242,1771,25,2,8,1281,True,0,2,2,5975,2013,0.79,Document
C#,655,7879,1923.8302199074076,MERGED,4,4,1,1,2,716,True,0,1,1,2878,8,107.20194444444445,Document
Python,2409,12193,336.2926967592593,MERGED,36,63,18,0,11,448,True,0,0,0,2870,99,1.743611111111111,Document
TypeScript,4,33,859.8725115740741,MERGED,120,294,16,1,7,270,False,0,1,1,3234,414,0.14972222222222223,Feature
Python,2409,12193,335.9241087962963,MERGED,346,182,10,0,40,447,True,0,0,0,2928,528,5.559166666666667,Document
TypeScript,1073,11367,1190.8719791666667,MERGED,164,820,4,1,12,324,True,0,1,1,2859,984,65.27916666666667,Bug
Go,1835,11246,1826.586087962963,MERGED,9,18,6,0,2,57,True,0,0,0,3196,27,1.1119444444444444,Document
TypeScript,41370,87415,3034.512858796296,MERGED,27,276,12,3,3,666,True,1,2,2,7017,303,5.1530555555555555,Document
TypeScript,21,40,2380.960625,MERGED,5,5,3,1,1,62,False,0,1,1,2296,10,18.10861111111111,Feature
Go,1835,11246,1827.9334606481482,MERGED,4,5,4,1,1,131,False,1,0,0,2868,9,0.18805555555555556,Document
Go,1835,11246,1824.8235185185185,MERGED,15,69,11,0,1,81,False,0,0,0,3039,84,42.26833333333333,Document
TypeScript,1297,21107,514.8403009259259,CLOSED,27,222,11,1,1,1294,True,0,1,1,10921,249,1.5972222222222223,Document
Go,1835,11246,1824.6188425925927,MERGED,5,25,4,0,2,23,False,0,0,0,2618,30,0.6930555555555555,Document
Python,4517,54994,1021.8954166666667,MERGED,10,21,1,1,7,0,False,1,0,0,4473,31,405.5738888888889,Document
TypeScript,1073,11367,1191.9632638888888,MERGED,0,118,1,1,4,325,True,0,1,1,3347,118,332.37194444444447,Bug
Python,137,75,785.0877546296297,MERGED,0,192,10,0,2,244,False,0,0,0,4072,192,0.18833333333333332,Document
Python,137,75,784.2193171296295,MERGED,44,289,18,1,17,48,False,1,0,0,3142,333,46.264722222222225,Document
Starlark,440,286,587.6481712962963,MERGED,0,195,2,3,1,0,False,2,1,1,4062,195,194.99388888888888,Document
Python,968,6762,154.7288888888889,MERGED,4,30,1,0,4,115,False,0,0,0,3194,34,0.18916666666666668,Document
TypeScript,41370,87415,3036.9465046296295,MERGED,52,286,16,2,1,671,True,0,2,2,8999,338,12.06,Document
TypeScript,1297,21107,513.935925925926,MERGED,191,156,26,1,2,1286,True,0,1,1,11326,347,0.11222222222222222,Document
TypeScript,7046,76149,2726.4866550925926,CLOSED,28,232,12,3,4,0,False,0,3,2,9899,260,0.0525,Document
TypeScript,4,33,862.4158449074074,MERGED,136,111,17,1,11,436,True,0,1,1,3395,247,5.285833333333334,Bug
JavaScript,34,25,294.55538194444443,MERGED,3,290,9,1,15,1,False,1,0,0,4916,293,203.41555555555556,Document
Java,450,746,4172.172696759259,MERGED,10895,227,104,2,8,391,True,0,2,1,4483,11122,26.11888888888889,Bug
TypeScript,1073,11367,1191.963888888889,MERGED,28,123,4,1,14,326,True,0,1,1,3740,151,136.3461111111111,Bug
Python,968,6762,150.87884259259258,CLOSED,0,0,1,0,2,0,False,0,0,0,3080,0,90.47,Document
Python,2409,12193,337.62261574074074,MERGED,218,16,3,2,8,96,True,0,2,1,4026,234,10.705555555555556,Document
TypeScript,3393,2334,1065.8505555555555,CLOSED,9,101,9,3,8,15,False,1,2,2,4621,110,30.4125,Feature
TypeScript,4,33,861.3413541666667,MERGED,3884,14,120,2,2,81,False,1,1,1,4017,3898,2.033333333333333,Document
TypeScript,41370,87415,3033.591747685185,MERGED,145,132,22,2,7,663,True,0,2,2,8031,277,0.49722222222222223,Document
TypeScript,4,33,860.2375462962963,MERGED,511,755,260,2,13,287,True,1,1,1,4805,1266,21.561666666666667,Bug
TypeScript,4,33,858.5867476851853,MERGED,400,1086,47,1,21,431,True,0,1,1,4369,1486,121.35194444444444,Bug
TypeScript,21,40,2382.529525462963,MERGED,141,9,3,1,5,65,False,0,1,1,3291,150,0.06416666666666666,Feature
Python,2409,12193,336.09149305555553,MERGED,16,20,4,2,2,4,False,1,1,1,3966,36,0.9847222222222223,Document
Python,2409,12193,335.86758101851854,MERGED,5,40,5,0,17,446,True,0,0,0,3438,45,0.8661111111111112,Document
TypeScript,4,33,859.687974537037,MERGED,129,312,28,1,3,269,False,0,1,1,4221,441,1.0927777777777778,Document
Go,1835,11246,1825.8683449074076,MERGED,5,10,3,0,2,56,True,0,0,0,3352,15,0.31083333333333335,Document
Go,1835,11246,1825.7975578703702,MERGED,11,15,7,0,3,55,True,0,0,0,3593,26,5.989166666666667,Document
JavaScript,34,25,292.85943287037037,MERGED,163,1343,7,1,6,98,False,1,0,0,4254,1506,7.8197222222222225,Feature
Go,1835,11246,1826.9296875,MERGED,38,31,8,0,2,31,False,0,0,0,4582,69,1.9272222222222222,Document
Go,1835,11246,1826.7544907407407,MERGED,61,591,26,0,2,602,False,0,0,0,3204,652,0.37472222222222223,Document
TypeScript,2147,14725,1570.7924652777776,MERGED,542,441,115,0,4,810,False,0,0,0,17474,983,9.713888888888889,Bug
TypeScript,3393,2334,1066.0174768518518,MERGED,10,3315,19,2,10,531,False,0,2,1,6751,3325,291.61555555555555,Feature
Python,137,75,783.0365509259259,MERGED,0,452,12,0,33,2,False,0,0,0,5191,452,186.99916666666667,Bug
Starlark,440,286,588.7562615740741,MERGED,170,709,8,2,8,3,False,0,2,2,5280,879,168.4388888888889,Bug
TypeScript,4,33,862.4648148148149,MERGED,138,656,19,1,18,6,True,0,1,1,7474,794,145.20805555555555,Document
Python,137,75,784.0818171296296,MERGED,159,139,13,0,6,119,False,0,0,0,7712,298,10.921111111111111,Document
Python,547,7161,2335.934965277778,MERGED,418,402,9,0,27,50,False,0,0,0,5391,820,161.25833333333333,Document
TypeScript,1073,11367,1193.795925925926,MERGED,51,178,3,1,2,329,True,0,1,1,7411,229,89.26944444444445,Document
Python,4517,54994,1024.647662037037,MERGED,0,34,2,4,9,3,False,3,1,1,4670,34,92.67333333333333,Document
TypeScript,3706,54077,1456.8232523148147,MERGED,18,37,4,0,1,184,True,0,0,0,4993,55,2.2644444444444445,Bug
TypeScript,4,33,861.803125,MERGED,124,320,24,1,5,82,False,0,1,1,7409,444,13.91611111111111,Document
Python,2409,12193,337.0177777777778,MERGED,17,22,3,0,12,450,True,0,0,0,5274,39,6.341111111111111,Document
Python,137,75,780.9622685185185,MERGED,56,93,21,0,7,117,False,0,0,0,6161,149,0.6077777777777778,Document
Go,1835,11246,1826.7087847222222,MERGED,49,37,6,0,4,601,False,0,0,0,5601,86,144.4572222222222,Document
Go,1835,11246,1825.6674537037036,MERGED,3,2513,47,1,13,128,False,0,1,1,5812,2516,51.22611111111111,Document
Go,1835,11246,1824.8173958333334,MERGED,4,16486,99,1,8,80,False,0,1,1,6141,16490,43.36222222222222,Document
Go,1835,11246,1824.602337962963,CLOSED,4,16840,100,1,4,79,False,0,1,1,5226,16844,4.541388888888889,Document
Java,450,746,4169.990335648148,MERGED,592,946,14,1,5,754,False,0,1,1,17652,1538,44.02333333333333,Feature
TypeScript,4,33,861.8482175925925,MERGED,7,22,5,1,12,435,True,0,1,1,8014,29,10.010277777777778,Document
TypeScript,1073,11367,1192.8122685185185,MERGED,1,140,14,1,3,155,True,0,1,1,8205,141,92.68833333333333,Feature
Go,1835,11246,1824.8308217592594,MERGED,323,739,49,1,15,129,False,0,1,1,9750,1062,77.06444444444445,Document
Go,1835,11246,1824.7872800925925,MERGED,142,324,34,0,1,127,False,0,0,0,7919,466,2.161388888888889,Document
Python,137,75,783.0121296296296,MERGED,640,291,27,0,7,118,False,0,0,0,13563,931,0.455,Document
TypeScript,3393,2334,1067.1943055555555,MERGED,327,234,26,2,1,536,False,0,2,1,12652,561,0.7272222222222222,Bug
TypeScript,261,3764,772.9228935185184,MERGED,2164,1011,51,0,6,1080,True,0,0,0,37608,3175,13.825833333333334,Document
TypeScript,3393,2334,1065.9377314814815,MERGED,3,98,19,2,2,392,False,0,2,2,11069,101,0.5213888888888889,Feature
Go,1835,11246,1824.6075,MERGED,231,328,40,0,6,29,False,0,0,0,13415,559,4.486944444444444,Document
Go,1835,11246,1824.5994675925924,CLOSED,7674,6982,48,1,8,28,False,0,1,1,11977,14656,0.2063888888888889,Document
TypeScript,3393,2334,1063.911388888889,MERGED,13,149,27,2,11,775,False,0,2,2,16989,162,248.82583333333332,Feature
TypeScript,3393,2334,1067.228738425926,MERGED,239,334,26,1,67,538,False,0,1,1,17063,573,2.331111111111111,Feature
Go,1835,11246,1826.8490277777776,MERGED,1138,430,28,1,8,30,False,0,1,1,14022,1568,0.8425,Document
TypeScript,2147,14725,1578.9401967592594,MERGED,0,3,1,0,1,5,False,0,0,0,732,3,172.92638888888888,Feature
TypeScript,2147,14725,1578.7917939814815,MERGED,0,2,1,0,1,337,False,0,0,0,673,2,0.3422222222222222,Feature
TypeScript,2147,14725,1578.2290046296296,CLOSED,0,4,1,0,1,99,False,0,0,0,722,4,14.435,Bug
TypeScript,2147,14725,1578.8222337962964,MERGED,1,113,2,0,2,68,False,0,0,0,923,114,125.2025,Bug
TypeScript,58,78,926.9812152777778,MERGED,0,1,1,1,1,141,False,0,1,1,981,1,6.416666666666667,Bug
TypeScript,2147,14725,1576.9722337962965,CLOSED,2,1,1,0,2,9,False,0,0,0,729,3,19.35388888888889,Feature
TypeScript,12,11,1089.3048263888888,MERGED,1,7,3,0,6,206,False,0,0,0,796,8,93.63527777777777,Feature
TypeScript,2147,14725,1578.0608217592592,MERGED,1,6,1,0,1,336,False,0,0,0,779,7,1.9869444444444444,Bug
TypeScript,12,11,1093.2087962962962,MERGED,1,1,1,0,2,210,False,0,0,0,782,2,0.3175,Feature
TypeScript,85,724,416.16082175925925,CLOSED,2,12,1,0,4,222,False,0,0,0,1170,14,285.97333333333336,Document
TypeScript,12,11,1092.1060879629629,MERGED,44,102,5,0,6,59,False,0,0,0,1169,146,24.73138888888889,Feature
TypeScript,85,724,420.1887962962963,MERGED,1,3,1,0,1,75,False,0,0,0,1072,4,0.19916666666666666,Document
TypeScript,2147,14725,1577.0308101851851,MERGED,2,1,2,0,1,192,False,0,0,0,1019,3,1.1641666666666666,Feature
TypeScript,261,3764,782.7986226851853,MERGED,4,14,4,0,3,244,True,0,0,0,1521,18,89.77777777777777,Document
TypeScript,2147,14725,1573.0465509259259,MERGED,1,1,1,1,1,334,False,1,0,0,738,2,71.4811111111111,Bug
TypeScript,85,724,419.0968634259259,MERGED,1,1,1,0,1,74,False,0,0,0,979,2,2.5955555555555554,Document
TypeScript,2147,14725,1575.962824074074,MERGED,0,4,1,0,1,816,False,0,0,0,758,4,6.071666666666666,Bug
TypeScript,85,724,418.8806944444445,MERGED,1,1,1,0,1,144,False,0,0,0,1092,2,4.5344444444444445,Document
TypeScript,2147,14725,1577.9530671296297,MERGED,13,40,9,0,2,5,False,0,0,0,1489,53,173.07972222222222,Document
Vue,293,495,936.593761574074,CLOSED,1,1,1,3,2,1,False,0,3,3,517,2,0.9502777777777778,Bug
TypeScript,12,11,1095.2523842592593,MERGED,4,683,4,0,4,99,False,0,0,0,1490,687,30.1825,Feature
Vue,293,495,936.6447916666666,MERGED,7,16,2,9,3,2,False,2,7,5,664,23,31.56361111111111,Bug
JavaScript,5140,7054,1308.8636805555554,MERGED,1,1,1,1,1,305,False,0,1,1,693,2,0.004722222222222222,Document
JavaScript,5140,7054,1308.7518518518518,MERGED,1,1,1,1,1,0,False,0,1,1,632,2,0.2338888888888889,Feature
Python,547,7161,2343.5656712962964,MERGED,27,9,2,0,2,649,True,0,0,0,469,36,0.6652777777777777,Feature
TypeScript,12,11,1094.5225925925927,MERGED,5,10,2,0,2,213,False,0,0,0,1584,15,16.48611111111111,Feature
Python,547,7161,2342.782835648148,CLOSED,22,30,1,0,2,179,False,0,0,0,760,52,161.16694444444445,Bug
Python,547,7161,2342.2758564814817,MERGED,2,5,1,3,4,0,False,1,2,1,738,7,187.29333333333332,Bug
TypeScript,2147,14725,1578.7995833333334,MERGED,6,1,1,0,2,194,False,0,0,0,1485,7,0.049166666666666664,Bug
TypeScript,12,11,1089.3118402777777,MERGED,3,4,2,0,1,207,False,0,0,0,1075,7,0.12777777777777777,Feature
TypeScript,7,6,749.1723032407408,MERGED,0,1,1,0,1,271,False,0,0,0,730,1,0.21,Feature
TypeScript,12,11,1093.6024768518519,MERGED,3,207,3,0,2,97,False,0,0,0,1621,210,14.493055555555555,Bug
TypeScript,7,6,748.960324074074,CLOSED,10,20,4,0,2,270,False,0,0,0,723,30,5.4286111111111115,Bug
Vue,293,495,935.7079513888889,MERGED,20,1,1,17,1,88,False,5,12,6,738,21,25.887777777777778,Bug
Vue,293,495,935.6667129629631,MERGED,0,3,1,8,1,0,False,1,7,4,652,3,27.034444444444443,Bug
TypeScript,2147,14725,1578.0047106481481,MERGED,4,12,2,0,1,821,False,0,0,0,1585,16,1.9472222222222222,Feature
TypeScript,261,3764,780.5098495370371,MERGED,0,12,3,1,10,27,True,0,1,1,1254,12,7.576388888888889,Document
Python,547,7161,2343.7093287037037,MERGED,0,38,1,0,2,185,False,0,0,0,883,38,18.32,Bug
TypeScript,261,3764,780.4966898148149,MERGED,10,18,3,0,1,133,True,0,0,0,1549,28,0.3075,Document
TypeScript,261,3764,780.4435069444444,MERGED,2,2,2,0,1,1090,True,0,0,0,1424,4,0.7275,Document
Python,547,7161,2343.809027777778,MERGED,61,0,1,0,1,186,False,0,0,0,776,61,0.29333333333333333,Bug
PHP,1334,2960,4313.955104166666,MERGED,0,25,3,2,5,188,False,1,1,1,1530,25,126.95861111111111,Document
TypeScript,2147,14725,1572.9775347222221,MERGED,12,5,2,0,1,77,False,0,0,0,801,17,0.43027777777777776,Bug
Python,547,7161,2343.7047685185184,MERGED,5116,3516,12,2,13,650,True,1,1,1,625,8632,1.36,Feature
Python,547,7161,2343.302627314815,MERGED,5,6,1,1,3,1,False,0,1,1,667,11,27.64666666666667,Bug
Go,30,295,450.90625,MERGED,1,1,1,0,1,122,True,0,0,0,1100,2,0.13555555555555557,Document
Python,547,7161,2343.605891203704,MERGED,0,3,1,0,3,338,True,0,0,0,666,3,0.09388888888888888,Bug
PHP,1334,2960,4314.277141203704,MERGED,3,3,1,2,2,38,False,0,2,2,1433,6,90.42861111111111,Document
TypeScript,2147,14725,1572.7284375,MERGED,2,3,1,0,1,815,False,0,0,0,747,5,1.65,Bug
TypeScript,2147,14725,1576.8021412037035,MERGED,3,15,3,0,2,692,False,0,0,0,1228,18,27.116666666666667,Bug
TypeScript,85,724,419.8272800925926,MERGED,2,2,1,0,2,145,False,0,0,0,1498,4,3.723333333333333,Document
TypeScript,261,3764,779.6542824074073,MERGED,2,8,2,0,2,31,True,0,0,0,1100,10,0.6175,Document
TypeScript,85,724,420.2894791666667,MERGED,248,1635,70,0,33,36,False,0,0,0,2442,1883,167.30694444444444,Document
Python,547,7161,2343.7252314814814,MERGED,29,205,25,1,29,339,True,1,0,0,909,234,139.45666666666668,Bug
JavaScript,5140,7054,1304.7995833333332,MERGED,1,10,1,1,1,143,False,0,1,1,646,11,0.07305555555555555,Document
Vue,10811,21164,1129.0366898148147,MERGED,2,2,1,8,1,1,False,3,5,3,1321,4,89.78722222222223,Bug
Vue,293,495,937.2159027777778,MERGED,0,71,2,9,4,9,False,1,8,4,832,71,14.310277777777777,Bug
PHP,1334,2960,4311.108043981481,MERGED,2,2,1,2,1,639,False,0,2,2,1504,4,166.61111111111111,Feature
PHP,1334,2960,4313.241805555555,MERGED,13,24,1,3,3,37,False,1,2,2,1158,37,23.73472222222222,Feature
PHP,1334,2960,4308.0065625,MERGED,1,1,1,4,1,637,False,0,4,3,884,2,70.29722222222222,Bug
Vue,10811,21164,1128.9649074074075,CLOSED,2,2,1,25,1,0,False,13,12,2,1266,4,91.51388888888889,Bug
TypeScript,261,3764,781.8931712962963,MERGED,3,11,2,0,2,275,False,0,0,0,1675,14,0.21444444444444444,Document
TypeScript,2070,16643,1345.534050925926,MERGED,1,1,1,3,3,0,False,2,1,1,1003,2,111.97166666666666,Document
TypeScript,261,3764,781.6947106481481,MERGED,2,19,3,0,1,136,True,0,0,0,2193,21,0.5186111111111111,Document
Vue,10811,21164,1128.2858564814815,MERGED,24,28,1,0,1,212,False,0,0,0,1150,52,120.13111111111111,Document
Python,547,7161,2344.537662037037,MERGED,1,17,3,0,2,264,False,0,0,0,890,18,2.2994444444444446,Bug
Python,547,7161,2344.470486111111,MERGED,0,40,1,0,4,42,False,0,0,0,871,40,3.071388888888889,Bug
TypeScript,202,107,1247.738263888889,MERGED,5,8,1,3,1,313,True,0,3,3,874,13,0.26555555555555554,Bug
TypeScript,261,3764,781.5343750000001,MERGED,1,8,3,0,1,135,True,0,0,0,1792,9,0.3491666666666667,Document
Vue,10811,21164,1129.387002314815,MERGED,1,1,1,1,1,22,False,0,1,1,1251,2,33.76638888888889,Document
Python,547,7161,2343.645925925926,MERGED,10,9,1,0,4,184,False,0,0,0,1161,19,46.791111111111114,Bug
Python,547,7161,2341.7466435185183,CLOSED,674,882,48,0,17,51,False,0,0,0,911,1556,166.21944444444443,Bug
TypeScript,12,11,1092.3263194444444,MERGED,20,183,5,0,26,208,False,0,0,0,2268,203,74.20305555555555,Feature
PHP,1334,2960,4308.044178240741,MERGED,1,12,2,7,3,638,False,2,5,2,936,13,0.7525,Feature
Vue,10811,21164,1129.2218518518519,MERGED,1,1,1,0,1,213,False,0,0,0,1194,2,1.376111111111111,Document
F#,271,818,2833.126550925926,MERGED,1,7,2,1,3,74,False,1,0,0,1262,8,2.977777777777778,Feature
Vue,10811,21164,1125.8803240740742,MERGED,1,12,2,2,7,0,False,0,2,2,1320,13,218.04611111111112,Bug
Python,547,7161,2342.658101851852,MERGED,5,31,2,0,6,52,False,0,0,0,784,36,73.1075,Document
Python,547,7161,2343.6372569444443,MERGED,1,46,1,0,6,183,False,0,0,0,1251,47,6.430555555555555,Bug
Vue,10811,21164,1126.8536689814816,MERGED,0,1,1,1,1,11,False,0,1,1,1261,1,148.35833333333332,Document
Vue,293,495,935.7880208333332,MERGED,0,81,2,3,1,457,False,0,3,3,969,81,0.8625,Bug
TypeScript,261,3764,780.5862037037036,MERGED,14,55,5,0,2,242,True,0,0,0,2093,69,2.6502777777777777,Document
Vue,293,495,935.7189814814815,MERGED,1,8,1,3,2,89,False,0,3,3,887,9,2.613611111111111,Bug
Vue,293,495,935.6977662037037,MERGED,1,1,1,5,2,87,False,1,4,4,950,2,3.1752777777777776,Bug
TypeScript,261,3764,780.5589930555556,MERGED,1,6,2,1,1,3,False,1,0,0,1948,7,1.8175,Document
TypeScript,2147,14725,1577.0787037037037,MERGED,58,37,11,0,5,193,False,0,0,0,1909,95,19.144166666666667,Bug
Python,547,7161,2342.4816898148147,MERGED,0,61,2,0,12,174,False,0,0,0,1138,61,48.56305555555556,Bug
Vue,293,495,935.1904398148148,MERGED,2,1,1,5,3,6,False,0,5,4,875,3,11.279722222222222,Bug
Vue,293,495,935.1169097222222,MERGED,4,9,1,6,5,5,False,1,5,4,980,13,17.054444444444446,Bug
TypeScript,202,107,1248.852048611111,MERGED,38,29,7,3,2,22,True,0,3,3,958,67,69.70805555555556,Document
TypeScript,85,724,416.1821296296296,MERGED,1,14,3,0,1,127,False,0,0,0,1806,15,1.1394444444444445,Document
TypeScript,2147,14725,1576.7676504629628,MERGED,19,143,5,0,1,817,False,0,0,0,1890,162,2.522222222222222,Bug
TypeScript,261,3764,779.8548148148147,MERGED,43,54,2,1,1,241,True,0,1,1,1910,97,0.6055555555555555,Document
PHP,1334,2960,4311.228900462963,MERGED,13,13,3,1,1,895,False,0,1,1,1413,26,0.24444444444444444,Bug
PHP,1334,2960,4311.207141203704,CLOSED,4,0,1,3,1,187,False,1,2,2,1441,4,0.20694444444444443,Document
Vue,293,495,934.8909027777778,MERGED,0,85,2,6,1,455,False,0,6,5,881,85,1.0994444444444444,Bug
PHP,1334,2960,4311.14875,MERGED,5,1,2,1,1,641,False,0,1,1,1155,6,1.6419444444444444,Bug
Python,547,7161,2342.5479976851852,MERGED,1,50,2,0,6,647,True,0,0,0,785,51,3.008888888888889,Bug
Python,547,7161,2342.507974537037,MERGED,1,1,1,0,3,175,False,0,0,0,1026,2,2.1991666666666667,Bug
Vue,293,495,934.0301157407407,CLOSED,0,4,1,8,2,454,False,2,6,4,800,4,44.77916666666667,Bug
JavaScript,5140,7054,1308.9395949074074,MERGED,7,0,1,1,6,146,False,0,1,1,1550,7,0.04888888888888889,Document
JavaScript,5140,7054,1308.9199074074074,MERGED,0,8,2,1,4,145,False,0,1,1,1173,8,0.22,Document
JavaScript,5140,7054,1308.9088310185186,MERGED,1,7,1,1,1,144,False,0,1,1,1290,8,0.1502777777777778,Document
Vue,293,495,934.1219560185185,MERGED,81,220,8,11,7,199,True,2,9,6,1023,301,17.740277777777777,Bug
Python,19251,70268,2567.548761574074,CLOSED,0,1,1,1,1,290,False,1,0,0,214,1,0.5344444444444445,Feature
TypeScript,202,107,1248.8553587962963,MERGED,1,1,1,3,1,272,True,0,3,3,988,2,0.82,Document
Python,547,7161,2341.7546527777777,MERGED,13,15,3,0,12,173,False,0,0,0,951,28,21.028333333333332,Bug
Python,547,7161,2341.9819675925924,MERGED,40,32,5,0,3,261,False,0,0,0,809,72,0.9797222222222223,Bug
PHP,1334,2960,4313.950590277777,MERGED,3,3,2,1,1,99,False,0,1,1,1982,6,3.881388888888889,Document
TypeScript,261,3764,781.9348495370369,MERGED,46,40,6,0,1,56,False,0,0,0,1836,86,16.8975,Document
Vue,293,495,934.0085763888889,MERGED,1,1,1,7,2,18,False,0,7,5,875,2,0.8408333333333333,Bug
Go,752,2400,831.752951388889,MERGED,2,9,1,0,1,329,False,0,0,0,797,11,0.49333333333333335,Bug
Vue,293,495,933.8182407407407,MERGED,2,2,1,6,3,453,False,0,6,4,974,4,1.0141666666666667,Bug
Go,395,661,1372.1689004629632,MERGED,0,14,1,4,3,0,False,2,2,1,235,14,164.0175,Feature
Python,547,7161,2341.5462037037037,MERGED,5,6,1,0,2,171,False,0,0,0,1021,11,1.2291666666666667,Bug
TypeScript,41370,87415,3042.5210185185188,MERGED,2,3,1,17,2,0,False,5,12,5,979,5,25.31277777777778,Document
Vue,293,495,933.2611111111111,MERGED,9,9,3,14,5,4,False,2,12,5,1219,18,19.754722222222224,Bug
Python,547,7161,2338.453645833333,MERGED,8,8,2,1,5,6,False,1,0,0,995,16,86.145,Bug
V,2097,34362,1654.6844560185184,MERGED,1,32,3,0,3,267,True,0,0,0,1112,33,59.50888888888889,Bug
Vue,293,495,932.8824421296296,MERGED,5,0,1,7,1,452,False,2,5,5,1006,5,19.08972222222222,Bug
TypeScript,202,107,1247.6809837962962,MERGED,6,9,1,3,1,312,True,0,3,3,1248,15,1.0102777777777778,Bug
Vue,293,495,932.5638078703704,MERGED,21,32,1,9,7,198,True,3,6,5,1046,53,30.399166666666666,Bug
Vue,293,495,932.8632407407407,MERGED,0,79,6,5,1,451,False,0,5,4,909,79,0.19333333333333333,Bug
TypeScript,42,46,876.9075462962963,MERGED,0,4,4,1,1,198,False,0,1,1,249,4,0.3616666666666667,Feature
Python,19251,70268,2565.757685185185,CLOSED,1,2,2,3,2,1670,False,3,0,0,265,3,4.206666666666667,Bug
TypeScript,58,78,921.1925347222223,MERGED,0,1,1,1,26,201,False,0,1,1,1796,1,0.01861111111111111,Feature
Python,547,7161,2343.771701388889,MERGED,0,314,7,0,20,9,False,0,0,0,1673,314,185.92,Bug
Vue,293,495,936.2189699074074,MERGED,6,152,7,10,10,1,True,3,7,6,1608,158,16.7025,Bug
Kotlin,164,4297,507.60699074074074,CLOSED,1,1,1,0,1,61,False,0,0,0,326,2,243.25222222222223,Bug
TypeScript,2147,14725,1576.8119560185185,MERGED,8,218,5,0,6,6,False,0,0,0,2941,226,152.54305555555555,Feature
TypeScript,261,3764,776.6606712962963,MERGED,5,11,3,0,1,1086,True,0,0,0,1703,16,0.38222222222222224,Document
Vue,293,495,931.5881365740742,MERGED,47,26,6,5,1,449,False,0,5,4,1040,73,5.456388888888889,Document
TypeScript,58,78,925.3113541666667,MERGED,2,217,4,1,7,124,False,0,1,1,3063,219,22.282222222222224,Bug
Vue,293,495,931.1433796296296,MERGED,0,75,2,5,1,448,False,0,5,4,943,75,16.243055555555557,Bug
Vue,293,495,931.1384837962963,MERGED,0,65,2,5,1,447,False,0,5,4,848,65,16.365555555555556,Bug
Vue,293,495,931.0241782407408,MERGED,0,14,3,5,2,446,False,0,5,4,1027,14,18.90861111111111,Bug
PHP,1334,2960,4307.996446759259,MERGED,0,3,1,1,1,184,False,0,1,1,1365,3,2.3319444444444444,Document
TypeScript,15,34,596.6876736111111,MERGED,3,50,3,0,3,1131,False,0,0,0,250,53,1.1166666666666667,Feature
Vue,293,495,937.0775462962962,MERGED,99,82,17,18,5,458,False,6,12,6,1196,181,21.205833333333334,Bug
Go,395,661,1371.9561921296297,MERGED,1,1,1,0,1,171,False,0,0,0,211,2,25.24,Feature
TypeScript,178,1359,426.2863425925926,MERGED,24,39,6,1,1,13,False,0,1,1,3327,63,39.175,Feature
Python,547,7161,2337.693472222222,MERGED,5,5,2,0,1,5,False,0,0,0,1039,10,16.9425,Bug
Vue,293,495,936.6693055555555,MERGED,137,97,1,10,2,23,False,1,9,7,1378,234,28.28527777777778,Bug
Vue,293,495,930.8746875,MERGED,0,65,2,5,1,445,False,0,5,4,954,65,0.5491666666666667,Bug
Vue,293,495,930.8686574074073,MERGED,0,119,2,5,1,444,False,0,5,4,1035,119,0.7063888888888888,Bug
TypeScript,2147,14725,1578.0276041666666,MERGED,85,523,9,0,3,67,False,0,0,0,3042,608,2.580277777777778,Document
Vue,293,495,930.8067361111111,MERGED,8,9,2,6,2,195,True,0,6,4,918,17,1.4394444444444445,Bug
TypeScript,12,11,1092.5750231481481,MERGED,5,211,4,0,29,209,False,0,0,0,2775,216,72.98027777777777,Feature
Vue,10811,21164,1128.1469791666666,MERGED,3,38,2,1,4,5,False,0,1,1,1942,41,171.13666666666666,Document
TypeScript,15,34,596.0951736111111,MERGED,21,15,1,0,3,1129,False,0,0,0,247,36,8.409444444444444,Feature
V,2097,34362,1656.272210648148,MERGED,1,1,1,0,1,14,False,0,0,0,1345,2,1.93,Document
JavaScript,9664,43891,3764.105,CLOSED,2,2,2,1,1,662,False,1,0,0,295,4,88.57805555555555,Feature
TypeScript,2147,14725,1577.7603819444446,MERGED,22,103,4,0,1,820,False,0,0,0,2327,125,7.891111111111111,Bug
TypeScript,261,3764,781.7443171296296,MERGED,5,32,3,0,4,274,False,0,0,0,3193,37,0.41,Document
TypeScript,261,3764,781.6146064814815,MERGED,2,19,3,0,2,273,False,0,0,0,3045,21,0.31527777777777777,Document
Vue,293,495,935.9547106481482,CLOSED,30,53,7,7,8,1,False,0,7,6,1165,83,47.62694444444445,Bug
Go,395,661,1369.101863425926,MERGED,208,114,2,1,2,165,False,1,0,0,231,322,164.615,Feature
TypeScript,85,724,420.14385416666664,CLOSED,14,24,5,0,2,128,False,0,0,0,3035,38,21.879444444444445,Document
PHP,1334,2960,4314.268090277778,MERGED,11,27,1,1,3,100,False,0,1,1,2498,38,117.57333333333334,Document
TypeScript,2147,14725,1577.1724074074073,MERGED,4,15,4,0,1,819,False,0,0,0,2892,19,22.79277777777778,Document
Vue,293,495,935.6538078703703,MERGED,199,206,1,15,7,22,False,2,13,7,1454,405,52.608333333333334,Bug
C++,2234,23697,2462.4811458333334,MERGED,0,172,3,1,2,13,False,0,1,1,1472,172,2.5569444444444445,Feature
TypeScript,2147,14725,1576.9815393518518,MERGED,65,35,5,0,1,818,False,0,0,0,3366,100,26.490833333333335,Document
TypeScript,15,34,595.5955208333334,MERGED,0,4,1,0,1,1128,False,0,0,0,224,4,0.01138888888888889,Feature
TypeScript,3393,2334,1074.707511574074,CLOSED,445,2680,87,1,55,404,False,0,1,1,440,3125,0.10694444444444444,Feature
TypeScript,85,724,420.1885995370371,MERGED,105,4,5,0,1,146,False,0,0,0,3231,109,0.27694444444444444,Document
TypeScript,15,34,595.4603587962963,MERGED,611,845,2,0,1,1127,False,0,0,0,236,1456,3.4730555555555553,Bug
TypeScript,261,3764,780.8613425925927,MERGED,66,11,9,0,2,134,True,0,0,0,2294,77,15.475555555555555,Document
Go,30,295,454.1112962962963,MERGED,10,25,2,0,3,125,True,0,0,0,1827,35,0.27555555555555555,Bug
Vue,293,495,935.680150462963,MERGED,8,22,1,9,6,7,False,1,8,6,1439,30,26.534444444444443,Bug
Python,547,7161,2341.682222222222,MERGED,1,228,2,0,28,172,False,0,0,0,1932,229,187.6225,Bug
TypeScript,202,107,1250.6294212962964,MERGED,1,1,1,3,1,315,True,0,3,3,1271,2,17.628055555555555,Bug
TypeScript,2147,14725,1576.866527777778,MERGED,10,85,3,0,3,191,False,0,0,0,2642,95,2.9183333333333334,Feature
Vue,293,495,935.8034953703703,MERGED,0,91,2,5,1,37,True,0,5,4,1468,91,0.5025,Bug
JavaScript,5140,7054,1307.9408449074074,MERGED,3,121,6,2,5,304,False,0,2,2,2339,124,17.090833333333332,Document
Vue,293,495,935.7701041666666,MERGED,10,24,4,6,4,200,True,0,6,4,1466,34,1.5180555555555555,Bug
Vue,293,495,935.7455787037037,MERGED,0,75,2,6,1,8,False,0,6,4,1399,75,1.9447222222222222,Bug
TypeScript,261,3764,780.6978587962963,MERGED,48,132,7,0,2,1091,True,0,0,0,2361,180,0.4086111111111111,Document
TypeScript,15,34,594.7425,MERGED,1,1,1,0,1,1123,False,0,0,0,247,2,17.023333333333333,Bug
TypeScript,12,11,1092.1426967592593,MERGED,5,180,4,0,29,94,False,0,0,0,3099,185,6.356944444444444,Bug
TypeScript,15,34,594.5438541666666,MERGED,4,4,3,0,1,1119,False,0,0,0,352,8,1.3805555555555555,Feature
Rust,433,2229,338.74895833333335,MERGED,3,21,1,0,3,1221,False,0,0,0,245,24,19.699444444444445,Feature
TypeScript,15,34,593.3090046296296,MERGED,12,7,3,0,4,172,False,0,0,0,284,19,78.17305555555555,Feature
TypeScript,3706,54077,1463.2297916666666,MERGED,30,31,5,0,1,189,True,0,0,0,330,61,23.65111111111111,Feature
Python,547,7161,2343.0822916666666,MERGED,6365,248,43,1,10,262,False,0,1,1,1175,6613,19.33222222222222,Document
Vue,293,495,935.0575462962962,MERGED,2,15,3,3,1,456,False,0,3,3,1152,17,18.49222222222222,Bug
TypeScript,1297,21107,521.0019675925926,MERGED,1,1,1,6,5,54,False,3,3,2,1690,2,13.900555555555556,Document
TypeScript,261,3764,779.7766782407407,MERGED,15,94,7,0,1,233,False,0,0,0,3040,109,14.854444444444445,Document
PHP,1334,2960,4308.357997685185,CLOSED,1,1,1,2,1,1,False,0,2,2,1710,2,62.19722222222222,Document
TypeScript,85,724,419.25474537037036,MERGED,0,111,3,0,2,35,False,0,0,0,3493,111,0.7344444444444445,Document
TypeScript,85,724,419.23671296296294,MERGED,35,29,5,0,2,34,False,0,0,0,3199,64,0.5688888888888889,Document
TypeScript,261,3764,779.8379398148148,MERGED,3,26,3,0,1,132,True,0,0,0,2275,29,1.5483333333333333,Document
TypeScript,85,724,419.08402777777775,MERGED,21,56,3,0,5,32,False,0,0,0,2878,77,2.8072222222222223,Document
Go,752,2400,830.4663773148148,MERGED,18,14,7,0,3,88,False,0,0,0,1175,32,171.07,Bug
Java,450,746,4178.342361111111,MERGED,593,40,23,1,1,21,False,0,1,1,363,633,16.084722222222222,Feature
Go,1835,11246,1833.7529513888887,MERGED,1,4,1,0,1,133,False,0,0,0,224,5,0.5113888888888889,Feature
TypeScript,15,34,593.7936458333334,MERGED,1218,300,2,0,1,1118,False,0,0,0,195,1518,0.018333333333333333,Bug
JavaScript,5140,7054,1310.7891087962964,MERGED,6742,7263,12,2,7,364,False,1,1,1,3130,14005,116.02277777777778,Feature
TypeScript,42,46,875.8713194444445,MERGED,0,3,3,2,1,196,False,0,2,2,266,3,1.2858333333333334,Feature
TypeScript,15,34,596.725949074074,MERGED,5,10,2,0,2,402,False,0,0,0,350,15,0.4486111111111111,Bug
Vue,10811,21164,1127.8822453703704,MERGED,13,5,1,0,2,27,True,0,0,0,1698,18,5.538888888888889,Bug
TypeScript,15,34,596.6363310185185,MERGED,9,12,3,0,2,401,False,0,0,0,297,21,0.38055555555555554,Bug
TypeScript,15,34,593.5695254629629,MERGED,1,1,1,0,1,1114,False,0,0,0,251,2,0.026111111111111113,Bug
TypeScript,15,34,596.5534606481482,MERGED,60,51,3,0,4,542,True,0,0,0,349,111,1.4230555555555555,Feature
TypeScript,42,46,875.8079976851851,MERGED,0,1,1,2,1,195,False,0,2,1,346,1,0.35333333333333333,Feature
TypeScript,15,34,593.4724421296296,MERGED,1,6,1,0,2,213,False,0,0,0,242,7,1.5355555555555556,Feature
TypeScript,15,34,595.8289814814815,MERGED,3,7,3,0,6,92,False,0,0,0,285,10,40.80916666666667,Feature
TypeScript,202,107,1244.9962152777778,MERGED,176,183,5,4,6,330,True,0,4,3,1756,359,274.6697222222222,Document
Vue,293,495,932.5508796296295,MERGED,8,4,2,5,1,450,False,0,5,4,1167,12,7.351388888888889,Bug
Go,395,661,1369.8329282407406,MERGED,0,28,2,0,3,166,False,0,0,0,333,28,146.53805555555556,Feature
JavaScript,5140,7054,1310.527511574074,MERGED,21,165,8,2,3,287,False,1,1,1,2911,186,97.27583333333334,Feature
Python,547,7161,2342.032974537037,MERGED,11,20,5,0,6,646,True,0,0,0,1247,31,12.268333333333333,Bug
TypeScript,202,107,1248.654085648148,MERGED,4,4,1,3,1,140,False,0,3,3,1890,8,20.405,Document
TypeScript,202,107,1247.8435185185185,MERGED,44,108,11,2,17,20,True,0,2,2,1741,152,72.25666666666666,Document
V,2097,34362,1656.638263888889,MERGED,1,1,1,0,1,21,False,0,0,0,1240,2,0.3036111111111111,Document
TypeScript,12,11,1089.3714351851852,MERGED,1,6,1,0,6,418,False,0,0,0,2827,7,67.78722222222223,Feature
JavaScript,5140,7054,1309.5667824074073,MERGED,5,7,2,2,1,194,False,1,1,1,3014,12,147.67555555555555,Feature
Vue,10811,21164,1127.0984375,MERGED,57,57,2,0,1,211,False,0,0,0,1618,114,17.336666666666666,Document
PHP,1334,2960,4307.990358796296,MERGED,2,36,1,1,5,894,False,0,1,1,2141,38,3.0052777777777777,Bug
Go,1835,11246,1832.5536342592593,MERGED,0,4,1,0,1,131,False,0,0,0,190,4,2.698888888888889,Feature
Go,1174,11429,1946.783159722222,MERGED,11,50,3,0,4,695,True,0,0,0,1828,61,125.68777777777778,Document
JavaScript,5140,7054,1309.5459606481481,MERGED,33,330,9,2,8,286,False,1,1,1,2869,363,120.70722222222223,Feature
TypeScript,15,34,595.5809027777779,MERGED,80,100,1,0,1,175,False,0,0,0,491,180,4.963888888888889,Feature
JavaScript,5140,7054,1304.556388888889,MERGED,21,304,8,2,4,357,False,1,1,1,2460,325,74.19805555555556,Feature
TypeScript,15,34,595.4561805555555,MERGED,4,15,1,0,1,174,False,0,0,0,348,19,7.9591666666666665,Bug
Vue,293,495,932.8097337962963,CLOSED,1,1,1,7,3,17,False,2,5,5,1209,2,27.778055555555557,Bug
Vue,293,495,935.5285532407407,MERGED,167,115,6,33,44,19,False,11,22,8,1799,282,132.08027777777778,Bug
TypeScript,58,78,921.1648148148148,MERGED,1,29,3,1,24,200,False,0,1,1,2974,30,0.16055555555555556,Bug
Vue,293,495,932.8674074074074,MERGED,21,23,1,8,2,21,False,1,7,6,1416,44,19.419722222222223,Bug
JavaScript,5140,7054,1310.6224189814814,MERGED,21,248,8,2,5,363,False,1,1,1,2928,269,24.975833333333334,Feature
TypeScript,202,107,1247.6943518518517,MERGED,1,65,3,2,1,21,True,0,2,2,1307,66,28.075833333333332,Document
JavaScript,5140,7054,1310.5370486111112,MERGED,21,758,9,3,10,121,False,2,1,1,3343,779,24.985833333333332,Feature
TypeScript,2070,16643,1347.7061921296297,MERGED,1,10,1,2,1,0,False,2,0,0,2334,11,62.12722222222222,Document
Python,547,7161,2341.641435185185,MERGED,0,33,1,0,3,259,False,0,0,0,466,33,0.044444444444444446,Document
C#,80,125,926.629861111111,MERGED,2,3,2,0,1,165,True,0,0,0,475,5,4.105,Document
Vue,293,495,931.8994097222222,MERGED,21,24,1,11,10,20,False,1,10,7,1304,45,49.58611111111111,Bug
TypeScript,202,107,1246.898900462963,MERGED,3,3,1,3,1,139,False,0,3,3,1453,6,62.54138888888889,Document
TypeScript,261,3764,776.7722685185186,MERGED,61,161,6,0,1,1088,True,0,0,0,2488,222,64.77694444444444,Document
TypeScript,202,107,1250.6271412037038,MERGED,2,16,2,3,4,141,False,0,3,3,2723,18,139.52,Document
Go,1174,11429,1947.8419560185184,MERGED,20,17,2,1,1,499,True,1,0,0,1775,37,0.8586111111111111,Document
Vue,293,495,936.8156250000001,MERGED,80,49,4,10,4,39,True,2,8,5,1685,129,50.941944444444445,Bug
TypeScript,15,34,594.7534722222223,MERGED,10,9,1,0,1,1124,False,0,0,0,297,19,16.753888888888888,Feature
TypeScript,202,107,1247.6883680555554,CLOSED,1,65,3,2,1,20,True,0,2,2,1293,66,0.015,Document
TypeScript,15,34,594.7296296296296,MERGED,1,1,1,0,1,1122,False,0,0,0,290,2,17.330555555555556,Document
Vue,293,495,932.5654398148148,MERGED,4,7,2,5,2,16,False,0,5,4,1160,11,5.525,Bug
Python,547,7161,2337.759664351852,MERGED,73,430,21,0,35,643,True,0,0,0,1128,503,221.9427777777778,Feature
Go,395,661,1369.9425694444444,MERGED,4,6,2,0,1,168,False,0,0,0,314,10,49.29055555555556,Bug
JavaScript,9664,43891,3761.119375,MERGED,2,12,1,0,3,94,True,0,0,0,352,14,0.7188888888888889,Bug
Go,1174,11429,1947.6380208333333,MERGED,77,68,5,1,1,498,True,1,0,0,1945,145,0.5530555555555555,Document
TypeScript,2147,14725,1578.082800925926,MERGED,10,10,3,0,3,51,False,0,0,0,1500,20,1.4566666666666668,Bug
Go,395,661,1366.0108449074075,CLOSED,4,65,2,1,1,163,False,0,1,1,356,69,286.66777777777776,Feature
Vue,293,495,933.8031828703703,CLOSED,22,125,6,9,18,0,False,0,9,6,1778,147,229.48111111111112,Bug
Python,547,7161,2337.8703124999997,MERGED,5,115,2,0,17,1,False,0,0,0,1098,120,187.80555555555554,Bug
JavaScript,5140,7054,1309.640347222222,MERGED,17,302,9,2,9,112,False,1,1,1,2679,319,24.911944444444444,Feature
TypeScript,202,107,1245.7596412037037,MERGED,3,3,1,3,1,76,True,0,3,3,1667,6,89.89833333333333,Document
V,2097,34362,1654.6357060185185,MERGED,1,54,2,1,2,266,True,0,1,1,1162,55,19.059166666666666,Bug
JavaScript,9664,43891,3763.0514814814815,MERGED,9,66,2,0,1,344,True,0,0,0,449,75,0.3463888888888889,Bug
TypeScript,202,107,1245.614502314815,MERGED,1,1,1,3,1,138,False,0,3,3,1324,2,93.39111111111112,Document
TypeScript,15,34,596.5330324074074,MERGED,30,78,3,0,3,176,False,0,0,0,547,108,16.17861111111111,Feature
Vue,293,495,931.890474537037,MERGED,1,5,1,5,1,197,True,0,5,4,1202,6,0.0775,Bug
Go,1174,11429,1947.0473032407408,MERGED,12,2,1,0,1,135,False,0,0,0,1969,14,0.13,Document
Vue,293,495,931.7775347222222,CLOSED,14,2,2,5,2,35,True,1,4,4,1476,16,4.475,Bug
Vue,293,495,935.9439930555556,MERGED,1,19,4,13,9,38,True,3,10,7,1630,20,48.76583333333333,Bug
TypeScript,261,3764,776.6836574074074,MERGED,0,54,27,0,2,1087,True,0,0,0,2329,54,0.41638888888888886,Document
TypeScript,1297,21107,522.7855324074075,MERGED,7,5,5,1,3,1320,True,0,1,1,2266,12,0.0275,Document
Vue,293,495,931.0228703703705,MERGED,3,3,2,5,2,34,True,0,5,4,1469,6,44.062777777777775,Bug
JavaScript,9664,43891,3762.3063425925925,MERGED,74,1155,28,0,9,52,False,0,0,0,507,1229,26.56861111111111,Feature
TypeScript,3706,54077,1462.0931828703704,MERGED,42,42,20,0,1,188,True,0,0,0,529,84,1.3855555555555557,Feature
TypeScript,202,107,1244.6802083333334,MERGED,1,1,1,3,2,136,False,0,3,3,1266,2,115.99055555555556,Document
TypeScript,15,34,595.584849537037,MERGED,10,53,4,0,8,91,False,0,0,0,478,63,49.62888888888889,Document
TypeScript,202,107,1245.0220486111111,MERGED,1,1,1,4,3,5,False,1,3,3,333,2,107.62222222222222,Bug
Java,450,746,4173.08994212963,MERGED,18,403,2,2,2,20,False,0,2,2,270,421,119.12083333333334,Feature
JavaScript,9664,43891,3761.9699305555555,MERGED,10,146,4,0,2,51,False,0,0,0,444,156,0.8286111111111111,Feature
TypeScript,202,107,1250.6159027777778,MERGED,9,23,2,3,2,314,True,0,3,3,2112,32,27.365277777777777,Bug
C#,80,125,924.6269097222222,MERGED,6,0,1,0,1,20,False,0,0,0,482,6,20.834444444444443,Document
Python,547,7161,2341.7161921296297,MERGED,18,105,4,0,6,43,False,0,0,0,2207,123,19.578333333333333,Document
TypeScript,15,34,595.4776388888889,MERGED,16,110,4,0,1,400,False,0,0,0,499,126,23.48361111111111,Bug
TypeScript,12,11,1095.4177546296296,MERGED,19,185,2,0,29,214,False,0,0,0,4258,204,17.896944444444443,Bug
Java,450,746,4176.4844791666665,MERGED,9,13,2,1,1,992,False,0,1,1,412,22,16.933055555555555,Feature
C#,80,125,920.866712962963,MERGED,869,1896,83,0,33,198,False,0,0,0,407,2765,69.93472222222222,Document
JavaScript,5140,7054,1307.6622453703703,MERGED,21,279,9,1,3,358,False,0,1,1,2705,300,45.755833333333335,Feature
Vue,293,495,930.8474189814815,CLOSED,2,2,2,13,1,332,True,4,9,6,1061,4,1.8452777777777778,Bug
TypeScript,202,107,1249.511701388889,MERGED,1,239,5,2,4,273,True,0,2,2,2531,240,54.19166666666667,Document
TypeScript,15,34,594.6706018518519,MERGED,229,503,17,2,10,399,False,0,2,1,463,732,42.855,Feature
Python,547,7161,2343.0135300925926,MERGED,28,24,8,0,8,180,False,0,0,0,2226,52,21.68611111111111,Bug
TypeScript,12,11,1094.6968402777777,MERGED,20,89,6,0,24,63,False,0,0,0,3953,109,35.870555555555555,Feature
TypeScript,15,34,594.3716087962963,MERGED,40,138,3,2,7,173,False,1,1,1,585,178,42.83222222222222,Feature
Vue,293,495,934.6989236111111,MERGED,10,20,4,8,3,0,False,0,8,7,1812,30,50.07972222222222,Bug
TypeScript,15,34,594.7206597222222,MERGED,54,25,4,0,4,1121,False,0,0,0,487,79,17.54388888888889,Feature
TypeScript,12,11,1094.3605439814814,MERGED,6,1047,7,0,7,98,False,0,0,0,3394,1053,52.08888888888889,Bug
V,2097,34362,1652.3343171296294,MERGED,5,39,2,3,2,20,True,1,2,2,1312,44,29.556944444444444,Bug
TypeScript,2070,16643,1343.1185648148148,MERGED,14,35,1,1,3,26,False,0,1,1,2453,49,170.47666666666666,Document
TypeScript,85,724,422.1753356481481,MERGED,30,316,11,0,34,37,False,0,0,0,5035,346,11.671111111111111,Document
Go,395,661,1368.906921296296,MERGED,35,92,4,0,3,164,False,0,0,0,411,127,97.89361111111111,Bug
Python,547,7161,2341.6147569444443,MERGED,66,206,7,2,22,335,True,1,1,1,1716,272,82.38472222222222,Document
JavaScript,9664,43891,3764.0710648148147,MERGED,0,348,2,0,2,661,False,0,0,0,585,348,0.28444444444444444,Feature
Go,1174,11429,1941.758587962963,MERGED,0,222,20,4,1,691,True,4,0,0,1837,222,177.9597222222222,Document
JavaScript,9664,43891,3763.856076388889,CLOSED,0,0,0,1,0,4,False,1,0,0,573,0,3.1308333333333334,Feature
TypeScript,12,11,1094.3272337962962,MERGED,37,68,7,0,3,212,False,0,0,0,4737,105,1.9994444444444444,Bug
TypeScript,15,34,593.780925925926,MERGED,85,28,30,0,2,1117,False,0,0,0,483,113,18.238055555555555,Bug
TypeScript,7,6,748.0296527777778,MERGED,14,24,8,1,2,330,False,0,1,1,542,38,0.3322222222222222,Bug
Vue,293,495,933.4643518518519,MERGED,11,48,2,11,7,36,True,2,9,7,1688,59,56.73916666666667,Bug
V,2097,34362,1656.4642476851852,MERGED,0,18,2,1,3,0,False,0,1,1,1529,18,4.575277777777778,Document
JavaScript,9664,43891,3763.2023842592594,MERGED,6,7,1,0,1,98,True,0,0,0,586,13,0.3016666666666667,Bug
PHP,1334,2960,4308.185694444444,MERGED,8,0,2,1,2,185,False,0,1,1,2444,8,0.13444444444444445,Document
TypeScript,12,11,1093.5033564814814,MERGED,30,532,8,0,4,96,False,0,0,0,3752,562,17.29083333333333,Feature
Go,30,295,453.3637268518519,MERGED,33,381,4,2,8,124,True,1,1,1,2961,414,14.9575,Document
TypeScript,15,34,596.7657175925925,MERGED,190,588,21,0,7,543,True,0,0,0,667,778,11.45,Document
Go,752,2400,831.4615393518519,MERGED,25,79,5,0,1,328,False,0,0,0,2431,104,1.4866666666666666,Bug
TypeScript,261,3764,781.8272800925926,MERGED,41,103,8,0,5,1097,True,0,0,0,3270,144,0.9788888888888889,Document
Go,2083,11771,1625.0926851851852,MERGED,6,17,1,0,1,5,False,0,0,0,2074,23,6.948333333333333,Document
TypeScript,2147,14725,1573.1113425925926,MERGED,12,13,6,0,3,50,False,0,0,0,1951,25,69.07222222222222,Feature
Vue,293,495,933.2107407407407,MERGED,18,24,4,6,2,3,False,0,6,4,2278,42,13.023888888888889,Bug
Go,2083,11771,1625.072025462963,CLOSED,6,17,1,0,1,4,False,0,0,0,2299,23,0.45666666666666667,Document
JavaScript,9664,43891,3762.215821759259,MERGED,33,31,1,0,2,96,True,0,0,0,598,64,16.47222222222222,Feature
JavaScript,5140,7054,1304.7862037037037,MERGED,19,263,8,1,8,111,False,0,1,1,2606,282,66.12083333333334,Feature
TypeScript,85,724,419.15172453703707,CLOSED,24,302,8,1,31,33,False,1,0,0,5129,326,72.545,Document
TypeScript,7,6,744.9232291666667,MERGED,31,109,4,1,9,66,True,0,1,1,1993,140,4.678055555555556,Feature
JavaScript,9664,43891,3761.9911458333336,MERGED,1,47,4,0,2,95,True,0,0,0,515,48,0.21027777777777779,Feature
V,2097,34362,1652.6123611111109,MERGED,3,10,4,3,4,236,True,1,2,2,2014,13,167.29583333333332,Document
TypeScript,41370,87415,3041.980439814815,MERGED,4,0,1,2,1,1684,True,0,2,2,1863,4,0.7347222222222223,Document
TypeScript,261,3764,780.7670833333333,MERGED,312,311,104,0,1,1093,True,0,0,0,4629,623,18.073333333333334,Document
TypeScript,261,3764,780.7263657407407,MERGED,83,93,6,0,9,74,False,0,0,0,4252,176,19.766944444444444,Document
TypeScript,12,11,1092.3784837962962,MERGED,8,267,7,0,32,95,False,0,0,0,3495,275,1.8852777777777778,Feature
Go,2083,11771,1619.2789930555555,MERGED,2,4,1,5,1,0,False,2,3,2,1430,6,3.6597222222222223,Document
Python,547,7161,2341.8551851851853,MERGED,11,60,2,0,4,260,False,0,0,0,634,71,1.5172222222222222,Bug
TypeScript,12,11,1092.126099537037,CLOSED,24679,13313,142,0,29,12,True,0,0,0,3430,37992,7.722222222222222,Bug
TypeScript,261,3764,780.7262615740741,MERGED,1206,418,24,0,3,1092,True,0,0,0,3974,1624,1.3202777777777779,Document
TypeScript,15,34,595.0704976851852,MERGED,167,334,34,0,10,1126,False,0,0,0,640,501,38.82555555555555,Document
C#,80,125,920.7105902777777,MERGED,1,1,1,0,1,197,False,0,0,0,483,2,0.5872222222222222,Document
JavaScript,9664,43891,3760.9676041666667,MERGED,20,199,5,0,1,50,False,0,0,0,528,219,24.0475,Feature
TypeScript,307,2556,641.6800578703704,MERGED,185,184,65,1,5,600,True,0,1,1,1794,369,5.993055555555555,Bug
Go,1174,11429,1947.9752893518519,MERGED,33,56,7,2,2,150,True,2,0,0,2561,89,19.65888888888889,Document
TypeScript,15,34,594.953263888889,MERGED,6,9,2,0,4,1125,False,0,0,0,584,15,9.985277777777778,Feature
Vue,293,495,931.0054166666667,MERGED,0,26,1,17,7,33,True,4,13,6,1737,26,47.93055555555556,Bug
Kotlin,164,4298,510.9180439814815,MERGED,6,57,3,2,4,27,False,1,1,1,774,63,21.635555555555555,Feature
Go,1174,11429,1947.8611805555556,MERGED,8,3,1,0,2,206,True,0,0,0,2386,11,1.5308333333333333,Document
Go,1174,11429,1947.8535995370369,MERGED,0,9,1,1,1,500,True,1,0,0,2145,9,0.5625,Document
Vue,293,495,931.2696180555555,MERGED,8,19,4,8,1,2,False,1,7,4,2315,27,12.833333333333334,Bug
Go,1174,11429,1947.5822453703704,MERGED,1,1,1,1,1,190,True,1,0,0,2297,2,12.625,Document
Go,1174,11429,1947.7193402777777,MERGED,0,3,1,0,1,142,True,0,0,0,2399,3,1.4180555555555556,Document
TypeScript,15,34,594.5692592592592,MERGED,131,121,14,0,3,1120,False,0,0,0,555,252,1.7783333333333333,Document
JavaScript,5140,7054,1309.7594097222222,MERGED,21,358,10,2,8,362,False,1,1,1,3951,379,142.96305555555554,Feature
JavaScript,9664,43891,3764.00744212963,MERGED,73,73,2,0,2,5,False,0,0,0,767,146,116.12138888888889,Feature
TypeScript,15,34,590.319849537037,MERGED,45,351,8,0,4,398,False,0,0,0,457,396,0.9891666666666666,Feature
Go,1174,11429,1946.728263888889,MERGED,15,90,7,3,4,205,True,2,1,1,2343,105,23.087222222222223,Document
Go,421,1654,1614.9644444444446,MERGED,66,37,9,0,2,523,True,0,0,0,4195,103,5.549444444444444,Document
TypeScript,15,34,593.6869097222223,MERGED,25,30,1,0,2,1116,False,0,0,0,524,55,0.08888888888888889,Document
Go,1174,11429,1946.0874884259258,MERGED,1,1,1,6,1,48,True,3,3,2,2681,2,23.615555555555556,Document
TypeScript,15,34,593.5982986111111,MERGED,44,42,2,0,1,1115,False,0,0,0,581,86,2.2286111111111113,Bug
Go,1174,11429,1946.2282060185187,MERGED,1,15,2,2,4,105,False,1,1,1,2298,16,17.121944444444445,Document
TypeScript,15,34,593.0499305555555,MERGED,35261,42834,3,0,5,1113,False,0,0,0,504,78095,15.32638888888889,Feature
Go,1174,11429,1945.637488425926,MERGED,10,40,3,1,2,518,True,1,0,0,2707,50,47.9825,Document
Erlang,2054,12122,3901.1647222222223,MERGED,2,2,2,1,1,153,False,1,0,0,895,4,2.4391666666666665,Document
Go,1174,11429,1945.751898148148,MERGED,34,30,7,1,2,520,True,1,0,0,2358,64,20.56972222222222,Document
Go,1174,11429,1946.0028472222223,CLOSED,0,8,1,1,1,693,True,1,0,0,2159,8,1.9719444444444445,Document
JavaScript,5140,7054,1309.5843518518518,MERGED,20,633,11,2,6,120,False,1,1,1,4238,653,46.41222222222222,Feature
TypeScript,41369,87415,3043.7541782407407,MERGED,3,11,7,3,8,681,True,0,3,3,2909,14,119.81527777777778,Document
Go,1174,11429,1945.6829976851852,CLOSED,0,1,1,0,1,692,True,0,0,0,2092,1,9.8625,Document
Go,1174,11429,1945.7033449074072,MERGED,13,107,3,1,6,234,False,1,0,0,2684,120,3.484722222222222,Document
Go,1174,11429,1945.5902662037035,CLOSED,1,1,1,0,1,47,True,0,0,0,2162,2,0.2727777777777778,Document
Go,1174,11429,1944.9362962962962,MERGED,16,32,1,13,2,283,True,10,3,2,2328,48,41.560833333333335,Document
JavaScript,9664,43891,3763.833738425926,MERGED,26,38,2,0,1,345,True,0,0,0,802,64,0.9483333333333334,Feature
JavaScript,9664,43891,3757.9153125,MERGED,5,208,5,0,5,93,True,0,0,0,601,213,3.7827777777777776,Feature
JavaScript,5140,7054,1308.7373842592592,MERGED,32,292,8,1,3,360,False,0,1,1,4238,324,67.7688888888889,Feature
TypeScript,1297,21107,521.6722222222222,MERGED,28,17,2,1,1,1316,True,0,1,1,2506,45,0.19944444444444445,Document
JavaScript,5140,7054,1308.8475115740741,MERGED,33,483,10,2,5,361,False,1,1,1,3917,516,44.647777777777776,Feature
Python,547,7161,2343.0877662037037,MERGED,22,64,3,0,7,648,True,0,0,0,2355,86,9.3025,Bug
Go,1174,11429,1944.9224537037037,MERGED,27,116,10,2,1,497,True,1,1,1,2894,143,2.292777777777778,Document
JavaScript,5140,7054,1308.6208333333334,MERGED,33,588,13,1,8,98,False,0,1,1,3678,621,43.689166666666665,Feature
Go,1174,11429,1944.7869791666665,MERGED,8,38,2,1,1,495,True,1,0,0,2375,46,4.094166666666666,Document
TypeScript,2070,16643,1342.961435185185,MERGED,9,10,1,0,2,0,False,0,0,0,2287,19,177.29972222222221,Bug
JavaScript,9664,43891,3763.0102314814812,MERGED,4,45,3,0,3,97,True,0,0,0,741,49,0.5961111111111111,Bug
Go,395,661,1365.9014467592594,MERGED,1,7,1,0,2,2,False,0,0,0,554,8,71.25194444444445,Feature
Go,1174,11429,1944.6220601851853,MERGED,2,5,1,2,2,493,True,1,1,1,2264,7,0.7519444444444444,Document
Go,395,661,1370.9673032407409,MERGED,91,206,14,0,5,170,False,0,0,0,738,297,120.06083333333333,Feature
Python,547,7161,2342.7293171296296,MERGED,58,11,2,0,11,178,False,0,0,0,1124,69,28.823611111111113,Bug
JavaScript,9664,43891,3762.896643518519,MERGED,6,316,8,0,1,343,True,0,0,0,735,322,0.5291666666666667,Feature
TypeScript,41369,87415,3043.8897453703703,CLOSED,5,5,4,4,2,5,False,1,3,3,2998,10,12.41638888888889,Document
Java,450,746,4177.107650462963,MERGED,1,0,1,2,1,590,False,0,2,2,940,1,68.65555555555555,Bug
Go,1174,11429,1941.8908333333331,MERGED,9,51,3,3,1,492,True,1,2,1,2586,60,143.8022222222222,Document
TypeScript,41369,87415,3043.4448495370366,MERGED,5,10,1,2,1,1686,True,0,2,2,2479,15,13.325555555555555,Document
TypeScript,41369,87415,3043.481921296296,MERGED,4,52,3,2,2,1687,True,0,2,2,2418,56,2.2769444444444447,Document
TypeScript,1297,21107,520.0578819444444,MERGED,4,33,3,1,1,53,False,0,1,1,2490,37,11.274722222222222,Document
JavaScript,5140,7054,1307.5248726851853,MERGED,21,363,10,1,5,119,False,0,1,1,3464,384,47.9775,Feature
TypeScript,41369,87415,3043.474039351852,MERGED,6,30,1,2,1,680,True,0,2,2,2939,36,0.8541666666666666,Document
C#,80,125,924.6033796296297,MERGED,91,6,2,0,3,197,True,0,0,0,684,97,45.365,Document
C#,80,125,924.8022800925927,MERGED,49,78,4,0,5,200,False,0,0,0,961,127,26.194166666666668,Document
Go,1174,11429,1942.2512152777779,MERGED,803,239,4,3,3,189,True,2,1,1,2325,1042,88.91944444444445,Document
TypeScript,41369,87415,3043.055324074074,CLOSED,1,19,2,2,3,213,False,0,2,2,2241,20,0.02861111111111111,Document
TypeScript,15,34,589.8072916666666,MERGED,87,675,5,0,2,540,True,0,0,0,721,762,13.71111111111111,Document
TypeScript,41369,87415,3042.895011574074,MERGED,8,1,1,2,2,679,True,0,2,2,2185,9,12.686388888888889,Document
TypeScript,41369,87415,3042.7760300925925,MERGED,4,4,1,4,3,29,True,0,4,4,2183,8,17.254166666666666,Document
TypeScript,41369,87415,3042.7228819444445,MERGED,5,1,1,5,1,212,False,1,4,4,2401,6,17.81138888888889,Document
TypeScript,3393,2334,1072.0526041666667,MERGED,0,7,1,1,1,400,False,0,1,1,1044,7,0.0661111111111111,Feature
Go,1174,11429,1942.1444328703703,CLOSED,23,141,9,2,3,133,False,1,1,1,2749,164,73.49027777777778,Document
Go,1174,11429,1942.4490740740741,MERGED,1,11,1,5,1,46,True,2,3,2,2757,12,53.120555555555555,Document
Go,1174,11429,1942.3994097222221,MERGED,1,1,1,3,1,45,True,2,1,1,2417,2,54.32888888888889,Document
TypeScript,41369,87415,3042.8229629629627,MERGED,22,22,7,3,1,1685,True,0,3,3,2406,44,0.8327777777777777,Document
Go,1174,11429,1941.8748611111112,MERGED,56,316,6,1,3,516,True,1,0,0,2696,372,65.76805555555555,Document
TypeScript,41369,87415,3042.4904861111113,MERGED,5,0,1,2,1,88,True,0,2,2,2342,5,1.0397222222222222,Document
V,2097,34362,1653.092511574074,CLOSED,65,129,16,7,3,74,True,2,5,2,3311,194,158.79444444444445,Feature
TypeScript,1297,21107,518.9981134259259,MERGED,34,34,3,1,1,1309,True,0,1,1,2639,68,0.15666666666666668,Document
C#,80,125,923.9279745370371,MERGED,124,5,6,0,1,199,False,0,0,0,854,129,15.445555555555556,Document
TypeScript,41369,87415,3041.890625,MERGED,2,27,3,2,3,678,True,0,2,2,2951,29,22.392222222222223,Document
C#,655,7879,1935.1559259259259,MERGED,38,54,2,1,2,17,True,0,1,1,1805,92,21.524722222222223,Document
C#,655,7879,1935.1672453703704,MERGED,6,54,4,5,4,1535,True,2,3,2,1746,60,19.85388888888889,Document
JavaScript,5140,7054,1306.2130787037038,MERGED,8,436,11,1,22,72,False,0,1,1,3589,444,33.14333333333333,Feature
V,2097,34362,1653.5668287037035,MERGED,8,120,5,0,5,93,False,0,0,0,2674,128,97.14583333333333,Document
V,2097,34362,1654.5492129629629,MERGED,6,8,5,0,2,0,False,0,0,0,2105,14,27.407222222222224,Document
TypeScript,41369,87415,3041.727407407407,MERGED,5,14,1,2,1,677,True,0,2,2,2319,19,0.7338888888888889,Document
C#,655,7879,1935.0429976851854,MERGED,1,5,1,0,1,1534,True,0,0,0,1715,6,0.5136111111111111,Document
TypeScript,41369,87415,3041.5617476851853,MERGED,1,27,1,2,2,1974,True,0,2,2,2224,28,5.920833333333333,Document
TypeScript,41369,87415,3041.5056944444445,MERGED,6,5,3,2,1,54,True,0,2,2,2890,11,1.4283333333333332,Document
Go,1174,11429,1941.7881944444443,CLOSED,6,33,2,4,1,406,True,2,2,1,2620,39,2.696111111111111,Document
TypeScript,41369,87415,3041.476539351852,MERGED,2,2,1,2,1,1973,True,0,2,2,2388,4,0.47,Document
Python,2409,12193,340.53125,MERGED,0,3,1,1,2,26,False,0,1,1,728,3,51.17611111111111,Document
TypeScript,41369,87415,3040.93005787037,MERGED,5,31,1,2,2,675,True,0,2,2,2756,36,1.5261111111111112,Document
C#,655,7879,1933.9903472222222,MERGED,25,25,2,2,1,637,True,1,1,1,1504,50,7.187222222222222,Document
TypeScript,41369,87415,3040.6098842592596,MERGED,18,28,2,6,1,673,True,3,3,3,2512,46,0.37916666666666665,Document
TypeScript,41369,87415,3040.040115740741,MERGED,0,24,2,3,4,3,False,1,2,2,2186,24,36.425555555555555,Document
C#,655,7879,1933.8826851851852,MERGED,2,0,1,0,1,636,True,0,0,0,1758,2,0.8675,Document
TypeScript,1297,21107,517.0383217592592,MERGED,0,13,4,1,1,52,False,0,1,1,2815,13,10.80638888888889,Document
TypeScript,41369,87415,3040.4256134259263,MERGED,2,2,2,2,1,48,False,0,2,2,2435,4,0.22555555555555556,Document
C#,655,7879,1932.0706828703703,MERGED,423,449,15,1,10,634,True,0,1,1,1804,872,84.4486111111111,Document
JavaScript,5140,7054,1304.0457407407407,MERGED,24,29,3,1,5,303,False,0,1,1,4032,53,20.56888888888889,Document
C#,655,7879,1932.8986689814817,MERGED,7,4,2,1,1,249,True,0,1,1,1516,11,5.250555555555556,Document
Python,547,7161,2337.7472916666666,MERGED,6,28,6,1,7,42,False,0,1,1,2466,34,18.733888888888888,Document
TypeScript,12,11,1092.417974537037,CLOSED,161,374,98,0,2,13,True,0,0,0,7014,535,233.91916666666665,Feature
Go,752,2400,827.4696180555555,MERGED,9,20,4,0,1,185,False,0,0,0,3260,29,0.25277777777777777,Bug
C#,80,125,920.5228587962962,MERGED,23,38,8,0,2,203,False,0,0,0,874,61,3.4030555555555555,Document
TypeScript,178,1359,428.0030439814814,MERGED,79,62,2,1,1,42,True,0,1,1,6725,141,0.09361111111111112,Bug
Erlang,2054,12122,3902.500451388889,MERGED,255,677,7,1,12,98,False,1,0,0,1412,932,82.265,Document
TypeScript,41369,87415,3037.417627314815,MERGED,4,17,7,12,7,53,True,4,8,5,2828,21,72.40777777777778,Document
TypeScript,12,11,1094.4823611111112,MERGED,405,218,10,0,11,61,False,0,0,0,6712,623,40.408055555555556,Feature
Erlang,2054,12122,3901.5322685185183,MERGED,28,164,3,0,1,34,False,0,0,0,1410,192,43.04944444444445,Document
Erlang,2054,12122,3901.2700694444447,MERGED,65,166,5,0,1,36,False,0,0,0,1301,231,122.67305555555555,Document
TypeScript,261,3764,782.6606018518519,MERGED,262,345,21,0,3,137,True,0,0,0,5061,607,94.73083333333334,Document
TypeScript,41369,87415,3037.763854166667,MERGED,1,1,1,2,1,2,False,0,2,2,2094,2,0.5397222222222222,Document
TypeScript,58,78,921.3772800925926,CLOSED,3,58,3,3,1,140,False,1,2,2,5781,61,253.56027777777777,Feature
C#,655,7879,1934.763263888889,MERGED,7,69,2,3,5,743,True,0,3,2,2656,76,172.39638888888888,Document
TypeScript,2070,16643,1348.1834606481482,MERGED,4,28,2,0,3,0,False,0,0,0,3020,32,48.8925,Document
Erlang,2054,12122,3902.2011574074077,MERGED,1214,6314,231,0,140,60,False,0,0,0,1286,7528,1.7519444444444445,Document
Erlang,2054,12122,3901.899016203704,MERGED,3,19,2,0,1,419,True,0,0,0,1334,22,18.67388888888889,Document
Erlang,2054,12122,3901.64287037037,CLOSED,2,5,3,0,2,450,True,0,0,0,1343,7,29.151666666666667,Document
Starlark,440,286,596.5334375,MERGED,1,1,1,1,2,32,False,0,1,1,1375,2,5.308611111111111,Bug
Python,137,75,791.0013425925927,CLOSED,0,59,4,0,2,52,False,0,0,0,1782,59,3.3133333333333335,Feature
C++,363,552,643.2085532407408,MERGED,14,28,10,0,4,326,False,0,0,0,1744,42,76.84,Document
TypeScript,261,3764,782.8344328703703,MERGED,56,52,37,0,1,1101,True,0,0,0,5029,108,0.05555555555555555,Document
TypeScript,261,3764,782.7526157407407,MERGED,82,71,43,0,1,1100,True,0,0,0,5210,153,0.2175,Document
TypeScript,261,3764,782.7140162037036,CLOSED,1657,410,266,1,1,138,True,0,1,1,5293,2067,0.5877777777777777,Document
TypeScript,261,3764,782.642974537037,MERGED,201,66,17,0,1,1099,True,0,0,0,6670,267,3.1327777777777777,Document
Erlang,2054,12122,3901.214930555556,MERGED,2,2,1,0,1,460,False,0,0,0,1144,4,24.009166666666665,Document
Erlang,2054,12122,3901.1330555555555,MERGED,3,166,3,0,1,459,False,0,0,0,1311,169,29.385,Document
F#,33,60,2361.907743055556,MERGED,416,57,7,2,4,24,False,1,1,1,4764,473,0.33111111111111113,Document
Go,11874,71346,2801.561423611111,CLOSED,2,2,2,2,1,0,False,1,1,1,1107,4,3.000277777777778,Feature
TypeScript,261,3764,782.5393287037036,MERGED,16,111,14,0,1,1098,True,0,0,0,5121,127,0.2675,Document
Go,1174,11429,1945.6657407407408,MERGED,54,140,8,3,1,519,True,2,1,1,3506,194,53.254444444444445,Document
C++,363,552,643.6154398148147,MERGED,16,35,2,0,2,66,False,0,0,0,1660,51,20.474166666666665,Document
Erlang,2054,12122,3901.031168981481,MERGED,43,46,19,0,1,35,False,0,0,0,1374,89,21.34138888888889,Document
C++,363,552,643.619375,MERGED,0,75,4,0,1,67,False,0,0,0,1859,75,18.860277777777778,Document
TypeScript,3393,2334,1074.652048611111,MERGED,1,1,1,1,1,403,False,0,1,1,1396,2,3.448888888888889,Feature
C#,655,7879,1934.2567708333333,MERGED,0,2,1,3,1,742,True,0,3,3,2263,2,114.56611111111111,Document
Erlang,2054,12122,3900.137627314815,MERGED,3,6,2,0,3,59,False,0,0,0,1028,9,50.34305555555556,Document
Go,1174,11429,1945.205949074074,MERGED,106,216,15,9,20,134,False,3,6,2,3815,322,49.7225,Document
Go,1174,11429,1945.012337962963,MERGED,60,112,3,1,2,517,True,1,0,0,3031,172,62.30277777777778,Document
Go,1174,11429,1945.8545717592594,MERGED,23,2,1,1,1,235,False,1,0,0,2946,25,3.3055555555555554,Document
C#,80,125,926.9760185185186,CLOSED,0,0,0,0,0,202,False,0,0,0,990,0,13.097222222222221,Document
TypeScript,2070,16643,1346.112638888889,MERGED,9,9,1,0,1,0,False,0,0,0,3479,18,98.23944444444444,Bug
C++,363,552,643.0007407407408,MERGED,5,16,2,0,1,325,False,0,0,0,1919,21,21.073055555555555,Document
TypeScript,261,3764,781.7497685185185,MERGED,25,83,9,0,1,1096,True,0,0,0,4941,108,0.38416666666666666,Document
TypeScript,4,33,868.9913657407407,MERGED,2,2,2,1,1,285,False,0,1,1,1331,4,0.051111111111111114,Bug
TypeScript,261,3764,781.6933564814814,MERGED,1041,15,75,0,1,1095,True,0,0,0,6459,1056,0.7169444444444445,Document
TypeScript,261,3764,781.6608912037037,MERGED,21,83,7,0,5,243,True,0,0,0,5478,104,1.3491666666666666,Document
C#,80,125,926.7488078703703,MERGED,60,366,82,0,6,202,False,0,0,0,1337,426,4.7025,Document
TypeScript,3393,2334,1074.0548263888888,MERGED,1,1,1,1,1,190,False,0,1,1,1201,2,0.11777777777777777,Feature
Erlang,2054,12122,3896.3361226851853,MERGED,361,493,13,0,6,151,False,0,0,0,1301,854,268.1402777777778,Document
C#,80,125,926.6747800925926,CLOSED,458,657,103,0,22,112,False,0,0,0,1238,1115,2.8983333333333334,Document
C#,655,7879,1935.1376736111113,MERGED,17,31,2,0,4,16,True,0,0,0,1959,48,7.258611111111111,Document
Java,450,746,4178.246516203703,MERGED,24,103,3,2,5,393,True,1,1,1,1698,127,47.05222222222222,Document
C#,655,7879,1934.9891087962963,MERGED,775,807,17,1,4,639,True,0,1,1,2135,1582,18.270833333333332,Document
Erlang,2054,12122,3900.1315046296295,MERGED,510,102,7,0,1,458,False,0,0,0,1205,612,6.000277777777778,Document
TypeScript,4,33,868.544537037037,MERGED,1,1,1,1,1,7,True,0,1,1,1099,2,0.86,Bug
TypeScript,4,33,868.4404861111111,MERGED,10,47,3,1,2,284,False,0,1,1,1409,57,0.060833333333333336,Feature
TypeScript,4,33,868.3793171296296,MERGED,6,14,2,1,4,693,True,0,1,1,1212,20,0.5283333333333333,Bug
C#,80,125,925.8043287037036,CLOSED,475,767,109,0,27,111,False,0,0,0,1225,1242,40.8175,Document
TypeScript,3393,2334,1073.3747337962964,CLOSED,9,13,2,4,1,0,False,0,4,2,1672,22,16.336111111111112,Feature
C#,655,7879,1934.9982523148149,MERGED,34,38,5,0,2,640,True,0,0,0,2089,72,0.7247222222222223,Document
Erlang,2054,12122,3899.9439467592597,MERGED,5,61,4,0,1,418,True,0,0,0,1329,66,2.0941666666666667,Document
TypeScript,4,33,868.1829282407407,MERGED,14,18,2,1,1,692,True,0,1,1,1189,32,2.0188888888888887,Bug
Erlang,2054,12122,3899.7425694444446,MERGED,5,18,10,0,2,417,True,0,0,0,1235,23,6.9325,Document
C#,80,125,925.8325810185185,MERGED,12,528,3,0,1,201,False,0,0,0,1421,540,22.922777777777778,Document
C++,363,552,642.1053935185186,MERGED,77,108,16,0,1,324,False,0,0,0,1833,185,8.477222222222222,Document
C#,655,7879,1933.9386574074076,MERGED,4,1,1,3,1,740,True,0,3,3,2204,5,48.82083333333333,Document
C#,655,7879,1934.366226851852,MERGED,34,49,1,5,1,1533,True,2,3,2,2055,83,16.78,Document
C++,363,552,641.2132175925926,MERGED,2,16,1,0,1,322,False,0,0,0,1522,18,55.420833333333334,Document
C#,655,7879,1934.1787731481481,MERGED,4,10,2,1,1,1532,True,0,1,1,1971,14,20.33888888888889,Document
C#,80,125,923.4396990740742,MERGED,23918,30933,101,0,48,196,True,0,0,0,1233,54851,170.5075,Document
Erlang,2054,12122,3899.195868055556,MERGED,2,2,2,0,1,416,True,0,0,0,1234,4,20.058611111111112,Document
V,2097,34362,1656.7894328703703,MERGED,40,122,1,0,5,76,True,0,0,0,3457,162,10.189722222222223,Feature
TypeScript,21,40,2389.985462962963,MERGED,2,215,2,1,1,72,False,0,1,1,1263,217,0.2577777777777778,Bug
JavaScript,5140,7054,1309.5132407407407,MERGED,557,8941,99,4,46,193,False,0,4,2,6517,9498,175.84,Document
C++,363,552,641.0939814814815,MERGED,21,56,1,0,2,321,False,0,0,0,1722,77,31.23,Document
TypeScript,21,40,2389.016666666667,MERGED,5,5,1,1,1,69,False,0,1,1,1041,10,61.464444444444446,Feature
TypeScript,12,11,1089.4391203703703,MERGED,1,37,2,0,17,420,False,0,0,0,7807,38,71.90138888888889,Bug
TypeScript,261,3764,779.5821180555555,MERGED,80,329,18,0,2,299,True,0,0,0,5322,409,23.50611111111111,Document
TypeScript,261,3764,779.757349537037,MERGED,8,179,17,0,2,131,True,0,0,0,5703,187,3.8766666666666665,Document
TypeScript,12,11,1089.6803125,MERGED,1,49,4,0,5,422,False,0,0,0,5302,50,43.20361111111111,Feature
TypeScript,261,3764,779.6669560185186,MERGED,29,280,15,0,3,240,True,0,0,0,6387,309,2.8044444444444445,Document
C++,363,552,640.990787037037,MERGED,11,12,2,0,2,65,False,0,0,0,1684,23,8.07,Document
Go,1174,11429,1941.6855092592593,MERGED,448,984,10,0,10,141,True,0,0,0,2934,1432,144.49666666666667,Document
TypeScript,41369,87415,3043.8945949074073,MERGED,189,127,24,2,6,684,True,0,2,2,4175,316,0.8580555555555556,Document
TypeScript,41369,87415,3043.867766203704,CLOSED,5,5,4,7,2,4,False,3,4,3,3744,10,0.3972222222222222,Document
TypeScript,3393,2334,1072.0397800925925,MERGED,0,8,1,1,1,399,False,0,1,1,1113,8,0.25083333333333335,Feature
TypeScript,21,40,2389.040335648148,MERGED,1,702,2,1,2,70,False,0,1,1,1333,703,22.5375,Feature
TypeScript,41369,87415,3043.738240740741,MERGED,913,1592,11,4,9,1688,True,0,4,3,4684,2505,7.136111111111111,Document
C++,363,552,640.0516782407407,MERGED,1,6,1,0,1,320,False,0,0,0,1775,7,52.925555555555555,Document
TypeScript,4,33,866.19,MERGED,17,95,9,1,5,691,True,0,1,1,1316,112,26.63361111111111,Document
Java,450,746,4177.163611111111,MERGED,59,164,17,0,7,755,False,0,0,0,5123,223,32.33416666666667,Bug
C++,363,552,637.2703703703704,MERGED,1,1,1,0,1,317,False,0,0,0,1410,2,0.5861111111111111,Document
TypeScript,1073,11367,1198.4639814814816,MERGED,1,1,1,3,4,0,False,1,2,2,1247,2,25.02111111111111,Document
Starlark,440,286,590.6996296296296,MERGED,1,1,1,2,1,54,False,1,1,1,1054,2,121.86722222222222,Feature
Starlark,440,286,590.6717939814815,MERGED,0,696,3,1,2,12,False,0,1,1,1481,696,122.53138888888888,Feature
Python,137,75,786.8988657407408,MERGED,23,4,3,0,3,122,False,0,0,0,1288,27,3.3530555555555557,Bug
TypeScript,12,11,1089.6771064814814,CLOSED,1,6,1,0,5,421,False,0,0,0,4992,7,0.07888888888888888,Feature
C#,655,7879,1929.389976851852,CLOSED,31,34,3,0,1,0,False,0,0,0,2258,65,233.1125,Document
TypeScript,12,11,1089.4206944444445,CLOSED,2,28,3,0,6,419,False,0,0,0,5183,30,6.6433333333333335,Feature
TypeScript,41369,87415,3042.638576388889,MERGED,51,15,2,4,3,78,False,1,3,3,3147,66,42.67638888888889,Document
TypeScript,15,34,594.5582060185185,MERGED,54,451,30,0,29,541,True,0,0,0,1381,505,37.235277777777775,Bug
Starlark,440,286,590.1112268518518,MERGED,0,96,2,1,1,96,False,0,1,1,1345,96,135.9386111111111,Feature
TypeScript,15,34,594.2973032407407,MERGED,350,960,35,0,12,214,False,0,0,0,1226,1310,47.843333333333334,Feature
TypeScript,3393,2334,1071.2093055555556,MERGED,6,8,4,1,3,781,False,0,1,1,1340,14,1.3480555555555556,Bug
Python,137,75,792.1664699074073,MERGED,10,78,6,0,13,125,False,0,0,0,2243,88,114.885,Bug
C++,363,552,639.8794097222222,MERGED,8,18,1,0,1,319,False,0,0,0,1863,26,3.4611111111111112,Document
Java,450,746,4173.177881944444,MERGED,3,754,11,1,21,173,False,0,1,1,4031,757,235.9275,Bug
Java,450,746,4176.161018518519,MERGED,6,23,3,1,4,84,False,0,1,1,1371,29,1.6319444444444444,Bug
TypeScript,1297,21107,519.5716550925926,MERGED,99,70,20,1,1,1311,True,0,1,1,4914,169,0.10694444444444444,Document
Python,137,75,791.9820833333333,MERGED,12,41,26,0,8,124,False,0,0,0,2255,53,10.203611111111112,Bug
Erlang,2054,12122,3896.0121875,MERGED,81,121,9,0,4,260,True,0,0,0,1480,202,88.26027777777777,Document
Go,30,295,447.8155208333333,MERGED,9,348,2,0,1,121,True,0,0,0,4733,357,0.14027777777777778,Feature
TypeScript,3393,2334,1070.2146296296296,MERGED,5,9,1,2,1,0,False,0,2,1,1484,14,14.678055555555556,Feature
C#,655,7879,1929.9465856481481,MERGED,66,132,7,2,7,733,True,0,2,2,2430,198,144.19944444444445,Document
TypeScript,1297,21107,518.9644560185185,MERGED,7,41,3,1,1,1307,True,0,1,1,4801,48,0.043611111111111114,Document
TypeScript,41369,87415,3042.098634259259,CLOSED,8,162,8,3,1,0,False,1,2,2,3603,170,7.557777777777778,Document
JavaScript,5140,7054,1309.878599537037,MERGED,33,694,19,1,2,0,False,0,1,1,4787,727,40.03861111111111,Feature
TypeScript,3393,2334,1069.1935300925927,MERGED,2,2,2,2,1,0,False,0,2,1,1318,4,39.25805555555556,Bug
TypeScript,3393,2334,1069.1781365740742,MERGED,2,2,2,2,1,0,False,0,2,1,1548,4,38.53777777777778,Feature
TypeScript,261,3764,776.6585300925926,MERGED,25,1455,30,0,5,130,True,0,0,0,6030,1480,74.43166666666667,Document
TypeScript,41369,87415,3041.660613425926,MERGED,77,109,3,2,1,1975,True,0,2,2,2369,186,3.5236111111111112,Document
Go,789,5551,1146.2993287037036,MERGED,1,1,1,2,1,1,False,1,1,1,1909,2,98.79333333333334,Document
TypeScript,307,2556,638.6877777777778,MERGED,128,428,43,1,7,599,True,1,0,0,3630,556,238.26222222222222,Bug
C#,655,7879,1931.3318287037036,MERGED,479,10,11,0,2,736,True,0,0,0,2394,489,16.783055555555556,Document
TypeScript,3706,54077,1459.0947453703702,MERGED,2,2,1,0,1,186,True,0,0,0,1185,4,41.94861111111111,Bug
TypeScript,3393,2334,1068.7080439814815,MERGED,0,9,1,2,1,0,False,0,2,1,1131,9,0.049166666666666664,Feature
Go,789,5551,1146.9908101851852,MERGED,0,3,1,0,1,0,False,0,0,0,1972,3,22.459722222222222,Document
Go,1835,11246,1833.5819212962963,MERGED,1,1,1,0,1,181,False,0,0,0,1371,2,0.1313888888888889,Document
C#,80,125,919.9701041666667,MERGED,58,1179,39,0,8,196,False,0,0,0,1041,1237,160.83277777777778,Document
C#,655,7879,1930.3573379629631,MERGED,1,1,1,1,1,734,True,0,1,1,2261,2,40.44444444444444,Document
TypeScript,41369,87415,3040.8062962962963,MERGED,8,8,1,4,1,1972,True,1,3,3,3431,16,0.8397222222222223,Document
C#,655,7879,1929.2115393518518,MERGED,4,6,1,1,1,731,True,0,1,1,2378,10,91.77333333333333,Document
TypeScript,3393,2334,1068.7054050925926,CLOSED,0,9,1,2,1,543,False,0,2,1,1131,9,0.03138888888888889,Feature
TypeScript,41369,87415,3040.83306712963,CLOSED,200,430,22,2,6,1681,True,0,2,2,3988,630,1.146388888888889,Document
TypeScript,41369,87415,3040.8156018518516,MERGED,131,194,8,3,4,1680,True,1,2,2,4535,325,1.066111111111111,Document
TypeScript,41369,87415,3040.642916666666,MERGED,269,472,8,1,3,159,True,0,1,1,3807,741,1.988611111111111,Document
Go,789,5551,1146.050972222222,MERGED,0,5,1,0,1,14,False,0,0,0,1951,5,19.043333333333333,Document
Python,2409,12193,346.65712962962965,MERGED,1,1,1,3,2,0,False,2,1,1,1999,2,1.1497222222222223,Document
V,2097,34362,1653.1802662037037,MERGED,6,40,3,1,1,0,False,0,1,1,3111,46,3.0219444444444443,Document
Vue,10811,21164,1123.090601851852,CLOSED,9435,11910,4,4,1,0,False,1,3,2,4095,21345,63.3125,Bug
Starlark,440,286,596.5294444444445,CLOSED,2,3,2,1,9,31,False,0,1,1,1448,5,0.0077777777777777776,Bug
Go,1835,11246,1831.9576041666667,MERGED,5,1,1,0,1,135,False,0,0,0,1547,6,0.16583333333333333,Document
TypeScript,4,33,862.6643634259259,MERGED,0,7,2,1,4,276,False,0,1,1,1553,7,0.095,Feature
Python,2409,12193,345.87070601851855,MERGED,5,5,1,1,5,21,False,0,1,1,2240,10,9.508888888888889,Document
Erlang,2054,12122,3900.215266203704,CLOSED,255,684,7,1,10,1043,True,1,0,0,1773,939,69.08694444444444,Document
TypeScript,12,11,1092.438136574074,MERGED,25530,14763,182,0,59,14,True,0,0,0,7658,40293,211.04527777777778,Bug
Erlang,2054,12122,3900.8616550925926,MERGED,25,152,9,0,6,448,True,0,0,0,1663,177,21.300555555555555,Document
Erlang,2054,12122,3900.9436689814816,MERGED,3,2,2,0,1,449,True,0,0,0,1680,5,13.89638888888889,Document
Python,2409,12193,345.83129629629633,MERGED,8,13,1,0,2,470,True,0,0,0,1730,21,1.2416666666666667,Document
Python,2409,12193,345.7290740740741,MERGED,11,31,3,0,5,468,True,0,0,0,1935,42,0.7130555555555556,Document
TypeScript,3393,2334,1074.3089467592592,MERGED,1,181,9,1,4,402,False,0,1,1,2247,182,1.1333333333333333,Feature
Erlang,2054,12122,3900.620729166667,MERGED,33,86,8,0,2,447,True,0,0,0,1825,119,8.125555555555556,Document
Go,752,2400,827.4782986111112,MERGED,8,19,4,0,1,186,False,0,0,0,4042,27,0.059722222222222225,Bug
TypeScript,3393,2334,1073.938738425926,MERGED,2,15,3,1,2,783,False,0,1,1,2192,17,6.436111111111111,Bug
TypeScript,41369,87415,3037.607974537037,MERGED,37,181,3,12,12,672,True,3,9,5,2909,218,77.64833333333333,Document
TypeScript,41369,87415,3038.0120254629633,MERGED,15,15,3,5,1,47,False,1,4,3,3298,30,44.62388888888889,Document
TypeScript,4,33,869.066087962963,MERGED,43,98,8,1,8,424,False,0,1,1,1541,141,0.2336111111111111,Document
Erlang,2054,12122,3900.1744675925925,MERGED,2,40,3,0,1,33,False,0,0,0,1669,42,7.160555555555556,Document
TypeScript,3393,2334,1073.3710648148149,MERGED,7,2,1,2,1,0,False,0,2,1,2106,9,13.875555555555556,Bug
Starlark,440,286,594.3133796296296,MERGED,41,61,1,1,1,98,False,0,1,1,1629,102,35.26305555555555,Bug
C#,80,125,924.4996296296296,MERGED,689,2368,33,0,17,204,False,0,0,0,1723,3057,143.5836111111111,Document
Python,14534,41196,1192.6000694444444,MERGED,2,2,1,0,1,1444,True,0,0,0,1979,4,0.7722222222222223,Document
TypeScript,85,724,420.3168287037037,MERGED,93,110,16,0,4,223,False,0,0,0,10366,203,38.979166666666664,Document
TypeScript,41369,87415,3037.4995949074073,MERGED,7,24,4,2,4,529,True,0,2,2,3333,31,3.296111111111111,Document
TypeScript,4,33,867.9645717592592,MERGED,112,191,15,1,4,283,False,0,1,1,2045,303,0.058611111111111114,Feature
TypeScript,178,1359,425.99753472222227,MERGED,133,103,2,1,1,41,True,0,1,1,10558,236,5.397777777777778,Bug
TypeScript,4,33,867.4804166666667,MERGED,17,27,9,1,1,281,False,0,1,1,2027,44,0.03944444444444444,Bug
C++,363,552,641.2407175925927,MERGED,1,10,1,0,1,323,False,0,0,0,1981,11,5.560555555555555,Document
TypeScript,3393,2334,1072.0666087962964,MERGED,0,87,3,1,2,401,False,0,1,1,1789,87,0.2361111111111111,Feature
Go,1835,11246,1828.7925231481483,MERGED,3,3,1,0,1,133,False,0,0,0,1425,6,0.03138888888888889,Document
TypeScript,4,33,867.1757407407407,MERGED,49,335,15,1,16,423,False,0,1,1,2023,384,0.3358333333333333,Bug
C#,655,7879,1935.2659490740741,MERGED,74,90,9,1,3,641,True,0,1,1,2833,164,20.784444444444443,Document
Python,2409,12193,342.9840046296296,MERGED,6,40,1,0,16,458,True,0,0,0,1745,46,1.7119444444444445,Document
Go,789,5551,1141.065185185185,MERGED,1,1,1,0,1,15,False,0,0,0,2095,2,74.25055555555555,Document
TypeScript,4,33,866.174988425926,MERGED,143,828,15,1,24,69,False,0,1,1,2201,971,52.844722222222224,Feature
TypeScript,21,40,2389.0413078703705,MERGED,2,580,7,1,1,71,False,0,1,1,2062,582,20.119444444444444,Feature
TypeScript,21,40,2389.0104166666665,MERGED,4,4,2,1,1,68,False,0,1,1,1851,8,20.190555555555555,Feature
TypeScript,12,11,1092.124363425926,CLOSED,31099,534,126,0,8,11,True,0,0,0,7373,31633,6.68,Bug
TypeScript,3393,2334,1070.8079861111112,MERGED,11,8,5,2,2,545,False,0,2,1,2309,19,25.871666666666666,Feature
TypeScript,3393,2334,1070.8003819444446,MERGED,24,5,4,2,2,544,False,0,2,1,2060,29,26.022777777777776,Bug
TypeScript,1073,11367,1197.5822453703704,MERGED,597,544,4,1,3,243,False,0,1,1,2315,1141,0.49833333333333335,Bug
TypeScript,3393,2334,1068.0390972222222,MERGED,21,38,3,1,4,397,False,0,1,1,2183,59,149.8275,Bug
Python,2409,12193,340.3518287037037,CLOSED,9,10,1,3,2,25,False,2,1,1,2114,19,0.06388888888888888,Feature
C++,363,552,638.8157523148149,MERGED,1,2,1,0,1,318,False,0,0,0,2082,3,33.032222222222224,Document
TypeScript,3393,2334,1068.5519444444444,MERGED,14,36,3,2,1,0,False,0,2,1,2246,50,7.756944444444445,Feature
Go,1835,11246,1833.7816550925927,MERGED,23,30,1,0,1,66,True,0,0,0,1912,53,2.535833333333333,Document
Go,1835,11246,1833.562326388889,MERGED,2,2,2,1,1,14,False,0,1,1,1677,4,1.4441666666666666,Document
TypeScript,261,3764,779.4582754629629,MERGED,97,120,28,0,4,1089,True,0,0,0,8051,217,0.6141666666666666,Document
Go,1835,11246,1832.8517708333331,MERGED,13,3,2,0,1,35,False,0,0,0,2020,16,0.095,Document
TypeScript,85,724,415.89193287037034,MERGED,109,159,28,0,6,143,False,0,0,0,8834,268,6.1225,Document
TypeScript,3393,2334,1068.1172453703705,MERGED,0,15,2,1,1,398,False,0,1,1,1936,15,0.2644444444444444,Feature
TypeScript,3393,2334,1067.927476851852,MERGED,5,10,3,2,3,541,False,0,2,1,2576,15,4.016111111111111,Bug
Go,1835,11246,1831.865,MERGED,1,25,3,0,1,62,True,0,0,0,1767,26,19.121388888888887,Document
Go,1835,11246,1831.7914814814815,MERGED,0,8,2,0,1,134,False,0,0,0,2124,8,0.4,Document
C#,655,7879,1928.8862847222224,MERGED,6,133,7,0,6,730,True,0,0,0,2460,139,76.75111111111111,Document
Go,30,295,452.03579861111115,MERGED,24,80,8,0,13,123,True,0,0,0,7098,104,19.532222222222224,Bug
Go,752,2400,832.6348495370371,MERGED,23,709,13,0,5,90,False,0,0,0,6804,732,191.76666666666668,Document
TypeScript,4,33,869.425451388889,MERGED,11,34,4,1,5,6,False,0,1,1,3172,45,126.72638888888889,Bug
TypeScript,1073,11367,1200.5839351851853,MERGED,0,4,1,1,1,245,False,0,1,1,2481,4,174.04527777777778,Bug
Java,450,746,4178.992037037037,MERGED,188,61,13,0,15,7,False,0,0,0,7018,249,105.17916666666666,Document
C++,363,552,643.1811574074073,MERGED,77,72,5,6,5,11,False,0,6,2,2433,149,141.45527777777778,Document
Erlang,2054,12122,3902.130462962963,MERGED,9,54,7,0,2,461,False,0,0,0,2564,63,6.188055555555556,Document
C++,2234,23697,2463.4353819444445,MERGED,4,571,13,1,7,14,False,0,1,1,2856,575,2.9280555555555554,Feature
Python,2409,12193,346.82402777777776,MERGED,2,3,3,0,14,474,True,0,0,0,2166,5,0.8225,Document
Python,2409,12193,346.45168981481487,CLOSED,0,2,1,3,1,22,False,1,2,1,2209,2,6.9816666666666665,Document
TypeScript,1297,21107,522.7555439814815,MERGED,3,361,8,1,1,1319,True,0,1,1,6980,364,0.24027777777777778,Document
Go,1835,11246,1828.7285879629628,MERGED,0,6,1,0,1,61,True,0,0,0,1851,6,1.5708333333333333,Document
Python,2409,12193,345.78255787037034,MERGED,18,29,4,0,4,469,True,0,0,0,2547,47,0.8747222222222222,Document
Python,2409,12193,344.68018518518517,MERGED,1,1,1,6,6,27,False,2,4,1,2067,2,48.574444444444445,Document
TypeScript,1073,11367,1198.854363425926,MERGED,2,2,2,2,1,0,False,1,1,1,2764,4,162.4011111111111,Bug
TypeScript,1073,11367,1200.9741319444445,MERGED,3,3,2,0,1,39,True,0,0,0,2429,6,0.01861111111111111,Bug
Python,4517,54995,1029.590787037037,MERGED,4,1,1,1,1,129,True,0,1,1,2967,5,148.9961111111111,Document
TypeScript,3393,2334,1073.3682060185185,CLOSED,2,16,2,3,1,0,False,1,2,1,3071,18,0.4166666666666667,Bug
Starlark,440,286,594.129050925926,MERGED,0,163,2,2,2,0,False,1,1,1,2415,163,39.66916666666667,Feature
JavaScript,34,25,302.0897685185185,MERGED,17,48,2,0,1,4,False,0,0,0,3311,65,118.24,Bug
TypeScript,1297,21107,521.0147106481481,MERGED,433,436,90,1,8,1315,True,0,1,1,8095,869,1.425,Document
Python,2409,12193,344.07619212962965,MERGED,9,5,3,2,2,462,True,1,1,1,3210,14,0.41055555555555556,Document
Python,2409,12193,343.9910300925926,MERGED,14,15,7,2,15,461,True,1,1,1,3154,29,0.9180555555555555,Document
Go,752,2400,832.4769675925926,MERGED,13,335,4,0,1,89,False,0,0,0,5057,348,0.09416666666666666,Bug
TypeScript,41369,87415,3043.8403125,MERGED,15,31,2,4,2,682,True,1,3,3,6017,46,13.753333333333334,Document
Python,137,75,788.1970717592593,MERGED,16,11,4,0,5,49,False,0,0,0,3234,27,14.314444444444444,Bug
Python,2409,12193,343.8088657407407,MERGED,187,108,22,0,10,460,True,0,0,0,2431,295,2.962222222222222,Document
Python,137,75,787.9760069444445,MERGED,10,34,4,0,2,239,False,0,0,0,2380,44,1.0575,Document
Python,2409,12193,343.4827314814815,MERGED,1,11,2,4,4,0,False,1,3,1,2105,12,7.740555555555556,Document
Python,137,75,787.4806712962964,MERGED,12,21,4,0,4,238,False,0,0,0,2868,33,0.5622222222222222,Bug
Starlark,440,286,592.0584027777778,MERGED,1,2,1,1,1,7,False,0,1,1,2324,3,89.29055555555556,Feature
TypeScript,3393,2334,1071.367824074074,MERGED,28,35,2,2,1,0,False,0,2,1,3293,63,39.2525,Bug
Python,2409,12193,343.25149305555556,MERGED,36,29,6,0,7,459,True,0,0,0,2380,65,0.6763888888888889,Document
TypeScript,41369,87415,3042.6709143518515,MERGED,85,191,12,2,11,211,False,0,2,2,7040,276,0.5575,Document
Starlark,440,286,591.19375,MERGED,0,331,2,1,3,97,False,0,1,1,2868,331,110.02888888888889,Document
TypeScript,1297,21107,519.0606481481482,MERGED,100,52,9,1,2,1310,True,0,1,1,8332,152,0.12027777777777778,Document
TypeScript,12,11,1094.6379166666668,MERGED,293,232,31,0,20,62,False,0,0,0,10734,525,36.970555555555556,Bug
Python,137,75,786.5115162037036,MERGED,1,13,7,0,1,237,False,0,0,0,2694,14,0.1436111111111111,Document
Go,1174,11429,1944.8649421296295,MERGED,11,29,3,1,1,496,True,1,0,0,2374,40,2.2063888888888887,Document
TypeScript,21,40,2388.700127314815,MERGED,12,157,3,1,4,67,False,0,1,1,2896,169,1.02,Feature
TypeScript,1297,21107,518.6653935185185,MERGED,183,191,40,3,3,1306,True,0,3,2,5674,374,5.9622222222222225,Document
C++,363,552,639.5561226851852,MERGED,9,65,8,2,4,276,False,2,0,0,2466,74,42.48694444444445,Document
TypeScript,41369,87415,3041.4825925925925,MERGED,28,58,3,2,2,676,True,0,2,2,5030,86,0.5797222222222222,Document
V,2097,34362,1653.678912037037,MERGED,4,6,2,7,4,75,True,4,3,1,5511,10,36.681666666666665,Document
Python,4517,54995,1028.409050925926,MERGED,4,4,1,0,1,128,True,0,0,0,3050,8,1.9719444444444445,Document
Go,1835,11246,1834.688738425926,MERGED,6,12,3,1,1,607,False,1,0,0,2487,18,2.067222222222222,Document
Go,1835,11246,1834.6301967592592,MERGED,6,11,4,0,1,37,False,0,0,0,3028,17,0.3236111111111111,Document
Python,2409,12193,340.4912962962963,MERGED,48,29,3,5,7,97,True,2,3,1,2391,77,54.806666666666665,Document
TypeScript,3393,2334,1068.7254976851852,MERGED,13,28,1,2,1,0,False,0,2,1,2652,41,3.4844444444444442,Feature
Go,1835,11246,1833.8063310185187,MERGED,32,26,2,0,1,36,False,0,0,0,2780,58,0.3863888888888889,Document
TypeScript,2147,14725,1576.0777430555556,MERGED,196,1020,11,0,1,335,False,0,0,0,11483,1216,87.39277777777778,Bug
TypeScript,1297,21107,516.812824074074,MERGED,42,42,23,1,1,51,False,0,1,1,7702,84,4.0311111111111115,Document
TypeScript,1297,21107,516.6422453703703,MERGED,190,89,12,1,3,1301,True,0,1,1,7152,279,0.056666666666666664,Document
Go,1835,11246,1831.836886574074,MERGED,23,27,3,0,1,33,False,0,0,0,2433,50,0.585,Document
Go,1835,11246,1829.6051851851853,MERGED,2,44,2,0,1,605,False,0,0,0,2317,46,2.1822222222222223,Document
TypeScript,1297,21107,522.8181481481481,MERGED,6,58,4,1,2,55,False,0,1,1,7747,64,118.77166666666666,Document
TypeScript,7,6,748.0771875,CLOSED,21868,15725,179,0,4,331,False,0,0,0,9022,37593,20.83111111111111,Bug
TypeScript,4,33,868.6334027777779,MERGED,49,58,3,1,3,5,False,0,1,1,3401,107,183.82444444444445,Feature
Erlang,2054,12122,3902.323113425926,MERGED,15,50,5,1,1,35,False,1,0,0,3026,65,19.361944444444443,Document
TypeScript,41369,87416,3041.759537037037,MERGED,146,302,15,7,14,1683,True,2,5,4,9294,448,143.75444444444443,Document
Python,2409,12193,346.7519907407407,MERGED,14,24,9,0,12,473,True,0,0,0,3831,38,0.52,Document
TypeScript,41369,87416,3040.770902777778,MERGED,76,482,17,8,9,28,True,3,5,3,8362,558,161.78722222222223,Document
Python,2409,12193,346.0574305555556,MERGED,95,129,16,0,15,472,True,0,0,0,3486,224,7.333055555555555,Document
Python,4517,54995,1029.1779398148149,MERGED,2,16,1,2,5,5,False,1,1,1,3420,18,231.17583333333334,Document
Python,2409,12193,345.9914467592593,MERGED,29,23,3,0,1,471,True,0,0,0,3672,52,0.2897222222222222,Document
TypeScript,41369,87416,3042.6588773148146,CLOSED,89,196,13,2,10,55,True,0,2,2,8620,285,0.0675,Document
TypeScript,3393,2334,1074.4664583333333,MERGED,14,15,7,2,1,0,False,0,2,1,4487,29,7.7747222222222225,Bug
Python,4517,54995,1029.367175925926,MERGED,12,30,1,3,10,0,False,0,3,2,3585,42,176.36916666666667,Document
Python,4517,54995,1029.2793055555555,MERGED,6,7,1,0,3,3,False,0,0,0,4125,13,178.06861111111112,Document
Python,2409,12193,345.2679513888889,MERGED,23,102,5,1,6,467,True,1,0,0,3557,125,1.3897222222222223,Document
TypeScript,1073,11367,1200.8753703703703,MERGED,91,88,3,1,3,247,False,0,1,1,3364,179,0.9786111111111111,Bug
C++,2234,23697,2457.5735648148147,MERGED,249,811,3,1,17,12,False,0,1,1,8633,1060,27.11888888888889,Feature
TypeScript,1073,11367,1200.791226851852,MERGED,31,20,3,1,1,246,False,0,1,1,3877,51,0.29055555555555557,Document
JavaScript,34,25,303.0861226851852,MERGED,1863,1873,46,0,10,101,False,0,0,0,4368,3736,44.02027777777778,Feature
Python,137,75,788.7996643518518,MERGED,143,125,14,0,8,50,False,0,0,0,3551,268,8.679166666666667,Document
TypeScript,41369,87416,3040.874895833333,MERGED,149,305,10,3,7,674,True,1,2,2,10161,454,13.015555555555556,Document
TypeScript,3393,2334,1073.119872685185,MERGED,32,79,9,1,1,189,False,0,1,1,4657,111,0.8966666666666666,Document
Python,2409,12193,344.1266087962963,MERGED,7,9,2,0,5,463,True,0,0,0,3313,16,1.9852777777777777,Document
Go,789,5551,1141.0054166666666,MERGED,10,2,2,2,1,28,False,2,0,0,3145,12,120.81333333333333,Document
TypeScript,4,33,866.8179398148148,MERGED,33,21,9,1,3,439,True,0,1,1,3825,54,0.0675,Feature
Java,450,746,4177.080625,MERGED,17,45,4,1,3,85,False,0,1,1,3689,62,0.7372222222222222,Bug
TypeScript,3393,2334,1071.848298611111,MERGED,4,14,4,1,1,782,False,0,1,1,3362,18,0.12583333333333332,Feature
Starlark,440,286,590.6680902777778,MERGED,66,145,1,1,1,11,False,0,1,1,4643,211,122.59027777777777,Bug
Python,137,75,786.2124305555554,MERGED,47,46,4,0,5,121,False,0,0,0,4419,93,1.0238888888888888,Document
Python,137,75,785.9063541666666,MERGED,26,66,6,0,7,120,False,0,0,0,4136,92,0.41583333333333333,Document
Python,4517,54995,1026.694386574074,MERGED,1,32,2,8,3,0,False,5,3,1,3288,33,44.38305555555556,Document
Go,1835,11246,1833.883472222222,MERGED,15,46,6,0,3,83,False,0,0,0,4370,61,0.18861111111111112,Document
Go,1835,11246,1833.7832523148147,MERGED,28,64,4,0,4,67,True,0,0,0,3632,92,2.4566666666666666,Document
Go,1835,11246,1833.749988425926,MERGED,1,71,5,0,2,65,True,0,0,0,3584,72,3.3538888888888887,Document
TypeScript,4,33,863.8026157407407,MERGED,136,1005,47,1,9,437,True,0,1,1,4761,1141,16.10611111111111,Document
TypeScript,4,33,863.6380902777778,MERGED,5,216,8,1,5,278,False,0,1,1,4067,221,22.504166666666666,Feature
TypeScript,3706,54077,1457.7463888888888,MERGED,13,22,10,0,1,185,True,0,0,0,4305,35,8.866111111111111,Feature
TypeScript,61,71,1773.2459953703703,MERGED,19888,26059,11,0,1,178,True,0,0,0,4453,45947,1.2572222222222222,Bug
TypeScript,4,33,862.72125,MERGED,23,254,15,1,8,277,False,0,1,1,3426,277,0.3858333333333333,Bug
TypeScript,261,3764,782.6710648148147,MERGED,1773,936,81,0,4,153,False,0,0,0,14470,2709,5.381388888888889,Document
TypeScript,261,3764,781.7287152777777,MERGED,852,617,54,0,3,152,False,0,0,0,17197,1469,4.7875,Document
Python,72,25,1740.7714467592593,MERGED,358,368,45,0,4,54,False,0,0,0,15204,726,19.0725,Bug
C#,655,7879,1933.3890740740742,MERGED,54,106,5,0,18,739,True,0,0,0,8508,160,134.81583333333333,Document
TypeScript,261,3764,780.8397685185186,MERGED,426,689,37,0,1,1094,True,0,0,0,15873,1115,0.3686111111111111,Document
TypeScript,261,3764,780.5266203703704,MERGED,689,426,37,0,4,151,False,0,0,0,14684,1115,3.6775,Document
Python,1912,12144,173.12137731481482,MERGED,12,152,10,1,2,15,False,1,0,0,7760,164,22.443055555555556,Feature
TypeScript,41369,87416,3037.642175925926,MERGED,1349,1908,60,4,30,530,True,1,3,3,10312,3257,57.93333333333333,Document
Python,137,75,791.0003703703704,MERGED,45,53,12,0,12,123,False,0,0,0,5618,98,2.1919444444444443,Document
TypeScript,1073,11367,1200.5038657407406,MERGED,1,137,14,1,8,93,True,0,1,1,4977,138,100.07166666666667,Bug
Python,2409,12193,345.0012384259259,MERGED,61,45,8,0,1,465,True,0,0,0,5728,106,0.33361111111111114,Document
Java,450,746,4176.9423495370365,MERGED,71,1036,28,2,33,45,False,0,2,1,7197,1107,77.59722222222223,Document
TypeScript,4,33,866.2338078703705,MERGED,14,338,14,3,29,289,True,2,1,1,7723,352,93.83055555555555,Feature
TypeScript,3706,54077,1461.871886574074,CLOSED,113,118,21,0,1,187,True,0,0,0,7336,231,5.167777777777777,Feature
TypeScript,4,33,866.1351851851852,MERGED,933,1415,62,1,27,83,False,0,1,1,7244,2348,61.4925,Bug
TypeScript,4,33,866.7288425925926,MERGED,194,292,34,1,14,280,False,0,1,1,7711,486,0.23805555555555555,Bug
Python,4517,54995,1027.7537731481482,MERGED,98,460,3,0,13,160,False,0,0,0,5486,558,128.70638888888888,Document
Go,1835,11246,1834.935451388889,MERGED,456,463,43,0,7,134,False,0,0,0,7523,919,98.28777777777778,Feature
Python,137,75,786.495011574074,MERGED,74,69,39,0,5,236,False,0,0,0,6801,143,0.17472222222222222,Document
TypeScript,149,2900,481.56952546296293,MERGED,221,553,14,3,7,134,False,0,3,1,5736,774,72.98694444444445,Document
TypeScript,4,33,864.6698726851852,MERGED,1608,2102,83,1,25,438,True,0,1,1,7431,3710,51.29083333333333,Document
TypeScript,3393,2334,1067.7454166666666,MERGED,70,107,8,2,1,0,False,0,2,1,7255,177,27.33277777777778,Feature
Go,1835,11246,1832.797037037037,MERGED,5,229,7,0,1,34,False,0,0,0,5315,234,0.23805555555555555,Document
Go,1835,11246,1831.9036226851852,MERGED,44,93,11,0,1,27,False,0,0,0,7530,137,16.268333333333334,Document
Go,1835,11246,1831.5823958333333,MERGED,6502,46,62,1,1,606,False,0,1,1,7171,6548,0.3061111111111111,Document
Go,1835,11246,1829.1436458333335,MERGED,6492,37,61,1,1,604,False,0,1,1,5840,6529,58.358333333333334,Document
Go,1835,11246,1828.8678935185187,MERGED,190,341,13,0,12,26,False,0,0,0,6611,531,66.7238888888889,Document
Go,1835,11246,1828.6267939814816,MERGED,1,1188,87,1,1,60,True,0,1,1,8073,1189,0.5313888888888889,Document
Go,1835,11246,1828.5946643518519,MERGED,4,25,2,0,3,132,False,0,0,0,5628,29,0.1486111111111111,Document
TypeScript,4,33,868.8667476851851,MERGED,750,1070,118,1,64,442,True,0,1,1,8572,1820,72.53111111111112,Bug
TypeScript,4,33,869.281099537037,CLOSED,109,238,21,1,6,694,True,0,1,1,8181,347,25.41611111111111,Bug
TypeScript,1073,11367,1200.9653819444445,MERGED,19838,19170,83,1,106,38,True,0,1,1,8789,39008,0.1502777777777778,Bug
Python,1912,12144,169.69216435185186,MERGED,1639,2020,32,0,15,14,False,0,0,0,8879,3659,8.793611111111112,Bug
Python,2409,12193,344.28274305555556,MERGED,330,246,14,0,13,464,True,0,0,0,8525,576,2.9427777777777777,Document
TypeScript,4,33,867.7019444444445,MERGED,465,289,15,1,4,282,False,0,1,1,7649,754,0.03277777777777778,Bug
TypeScript,4,33,867.6139583333334,MERGED,162,219,23,1,8,440,True,0,1,1,8629,381,2.6080555555555556,Bug
TypeScript,3393,2334,1068.3301851851852,MERGED,77,89,10,2,1,0,False,0,2,1,9970,166,13.256388888888889,Bug
Erlang,2054,12122,3902.171898148148,MERGED,40,48,5,0,2,451,True,0,0,0,8009,88,70.52083333333333,Document
TypeScript,4803,40789,3866.402002314815,MERGED,68,303,21,1,4,164,True,0,1,1,10997,371,0.10222222222222223,Bug
Java,450,746,4177.254814814815,MERGED,309,390,19,2,21,86,False,0,2,1,11704,699,63.31944444444444,Document
TypeScript,149,2900,485.66438657407406,CLOSED,440,375,48,1,27,211,True,0,1,1,15315,815,6.736666666666666,Document
TypeScript,61,71,1779.2451504629628,MERGED,42294,107877,207,0,9,29,True,0,0,0,22485,150171,19.773611111111112,Bug
Go,1835,11246,1833.5633217592592,MERGED,894,1000,39,1,4,132,False,0,1,1,28313,1894,25.540555555555557,Bug
TypeScript,2147,14725,1586.0515046296296,MERGED,0,1,1,0,1,827,False,0,0,0,636,1,2.212222222222222,Bug
TypeScript,2147,14725,1586.0678703703704,MERGED,0,1,1,0,1,0,False,0,0,0,662,1,2.8625,Bug
TypeScript,2147,14725,1586.0734722222223,MERGED,0,5,1,0,1,195,False,0,0,0,591,5,1.4058333333333333,Feature
TypeScript,2147,14725,1586.055648148148,MERGED,13,14,1,0,1,81,False,0,0,0,674,27,2.0716666666666668,Feature
TypeScript,2147,14725,1586.032511574074,MERGED,1,1,1,0,1,52,False,0,0,0,664,2,2.6391666666666667,Bug
TypeScript,2147,14725,1585.6652777777779,MERGED,1,1,1,0,1,0,False,0,0,0,629,2,11.461944444444445,Bug
TypeScript,2147,14725,1585.3776967592594,MERGED,0,17,1,0,1,3,False,0,0,0,674,17,18.43138888888889,Feature
TypeScript,2147,14725,1584.7156481481481,MERGED,1,0,1,0,1,823,False,0,0,0,653,1,34.801944444444445,Bug
TypeScript,2147,14725,1584.2276157407407,MERGED,0,1,1,0,1,822,False,0,0,0,621,1,46.5025,Bug
TypeScript,2147,14725,1586.2367129629629,MERGED,7,26,2,1,1,43,False,0,1,1,985,33,13.3475,Feature
TypeScript,178,1359,434.6017476851852,MERGED,1,5,1,1,1,24,True,0,1,1,980,6,12.446666666666667,Bug
TypeScript,85,724,428.9486921296296,MERGED,61,61,1,0,2,135,False,0,0,0,1174,122,1.7994444444444444,Document
TypeScript,85,724,428.3299421296296,MERGED,1,1,1,0,1,229,False,0,0,0,1112,2,15.65,Document
TypeScript,2147,14725,1582.983125,MERGED,1,1,1,0,1,338,False,0,0,0,685,2,1.1966666666666668,Bug
TypeScript,2147,14725,1585.2269907407408,MERGED,3,35,2,0,1,826,False,0,0,0,951,38,22.004722222222224,Feature
TypeScript,12,11,1100.2716898148149,MERGED,3,140,1,1,4,106,False,1,0,0,898,143,45.530833333333334,Feature
TypeScript,85,724,428.09527777777777,MERGED,1,1,1,0,1,227,False,0,0,0,1166,2,21.27138888888889,Document
TypeScript,2147,14725,1585.1251157407407,MERGED,1,1,1,1,1,0,False,0,1,1,792,2,24.37388888888889,Bug
TypeScript,12,11,1100.1634375,CLOSED,1,4,1,0,1,24,True,0,0,0,994,5,47.98722222222222,Bug
TypeScript,12,11,1100.1605671296295,CLOSED,0,2,1,0,1,22,True,0,0,0,1022,2,48.06583333333333,Feature
TypeScript,12,11,1100.1588078703703,CLOSED,1,0,1,0,1,21,True,0,0,0,1015,1,48.11194444444445,Bug
TypeScript,85,724,428.1345138888889,MERGED,0,58,2,0,2,80,False,0,0,0,1166,58,0.15222222222222223,Document
TypeScript,85,724,428.07087962962964,MERGED,0,1,1,0,1,226,False,0,0,0,1104,1,0.12472222222222222,Document
TypeScript,12,11,1099.1552199074074,CLOSED,0,1,1,0,1,15,True,0,0,0,901,1,72.22305555555556,Feature
TypeScript,12,11,1096.1769791666668,MERGED,0,201,1,0,3,102,False,0,0,0,806,201,95.98416666666667,Feature
TypeScript,85,724,427.37343749999997,MERGED,13,94,4,0,3,39,False,0,0,0,1122,107,12.529722222222222,Document
TypeScript,85,724,426.98956018518516,MERGED,91,369,26,0,7,133,False,0,0,0,915,460,1.1608333333333334,Document
TypeScript,2147,14725,1584.0289583333333,MERGED,175,3,3,0,1,79,False,0,0,0,1069,178,2.34,Feature
JavaScript,5140,7054,1317.8833796296296,MERGED,1,1,1,1,1,147,False,0,1,1,679,2,0.13305555555555557,Document
TypeScript,85,724,426.10480324074075,MERGED,1,1,1,0,1,132,False,0,0,0,1161,2,46.2225,Document
Go,422,1654,1621.2500694444443,MERGED,3669,0,15,0,3,530,True,0,0,0,726,3669,0.47944444444444445,Bug
JavaScript,5140,7054,1317.0522916666666,CLOSED,0,22,1,1,1,0,False,0,1,1,596,22,0.38972222222222225,Feature
TypeScript,85,724,426.0827546296296,MERGED,1,1,1,0,1,131,False,0,0,0,1155,2,0.2275,Document
Vue,293,495,943.1378125,MERGED,2,4,1,6,2,94,False,1,5,4,494,6,16.100833333333334,Bug
TypeScript,12,11,1096.1735300925927,MERGED,2,443,4,0,16,101,False,0,0,0,867,445,96.65138888888889,Bug
TypeScript,85,724,429.18662037037035,MERGED,1,9,3,0,2,42,False,0,0,0,1590,10,0.8211111111111111,Document
TypeScript,2147,14725,1586.1789699074072,MERGED,6,4,3,0,1,694,False,0,0,0,1595,10,0.7897222222222222,Document
PHP,1334,2960,4320.111180555556,MERGED,1,17,2,4,1,897,False,1,3,2,1061,18,0.26055555555555554,Document
TypeScript,2147,14725,1585.3854398148148,MERGED,2,4,1,0,1,4,False,0,0,0,1229,6,18.20916666666667,Feature
TypeScript,261,3764,788.7096412037037,MERGED,1,7,2,0,1,75,False,0,0,0,1326,8,0.9944444444444445,Document
TypeScript,261,3764,788.6820138888888,MERGED,0,9,2,0,1,143,True,0,0,0,1307,9,0.20194444444444445,Document
TypeScript,261,3764,788.668923611111,MERGED,0,86,2,0,2,236,False,0,0,0,1357,86,0.3383333333333333,Document
TypeScript,12,11,1100.237962962963,MERGED,32,378,6,0,4,105,False,0,0,0,1334,410,46.4425,Bug
PHP,1334,2960,4319.2128125,MERGED,2,2,2,2,2,646,False,1,1,1,833,4,18.309444444444445,Feature
TypeScript,12,11,1100.1753935185186,CLOSED,13,13,1,0,1,25,True,0,0,0,1587,26,47.69777777777778,Bug
TypeScript,261,3764,788.4991435185185,MERGED,900,340,4,0,4,235,False,0,0,0,1631,1240,3.3091666666666666,Document
TypeScript,12,11,1100.1619907407407,CLOSED,1,4,1,0,1,23,True,0,0,0,1404,5,48.02388888888889,Bug
Python,547,7161,2351.744560185185,MERGED,2,2,1,0,1,344,True,0,0,0,648,4,0.025277777777777777,Bug
PHP,1334,2960,4318.988344907407,MERGED,3,15,1,2,2,644,False,0,2,2,1081,18,0.37833333333333335,Feature
TypeScript,2147,14725,1584.7761226851853,MERGED,5,14,1,0,1,80,False,0,0,0,1330,19,32.721666666666664,Feature
TypeScript,85,724,428.12717592592594,MERGED,6,5,1,0,5,41,False,0,0,0,1459,11,0.6325,Document
TypeScript,85,724,428.11347222222224,MERGED,25,12,1,0,1,79,False,0,0,0,1883,37,0.27805555555555556,Document
TypeScript,2147,14725,1584.9453703703703,MERGED,14,26,2,0,1,825,False,0,0,0,1839,40,18.221666666666668,Bug
PHP,1334,2960,4318.911296296296,MERGED,1,1,1,1,1,189,False,0,1,1,858,2,1.3363888888888888,Document
TypeScript,85,724,428.0255324074074,MERGED,0,27,2,0,2,78,False,0,0,0,1418,27,0.22916666666666666,Document
TypeScript,261,3764,787.8730208333333,MERGED,31,28,2,0,1,1113,True,0,0,0,1271,59,0.7325,Document
TypeScript,85,724,427.92635416666667,MERGED,14,3,1,0,1,40,False,0,0,0,1490,17,0.23666666666666666,Document
TypeScript,12,11,1099.2444907407407,CLOSED,2,8,1,0,2,20,True,0,0,0,1327,10,70.06333333333333,Feature
TypeScript,12,11,1099.1583680555557,CLOSED,1,0,1,0,1,17,True,0,0,0,1159,1,72.14027777777778,Bug
TypeScript,12,11,1099.1572800925926,CLOSED,4,4,1,0,1,16,True,0,0,0,1283,8,72.17055555555555,Bug
Java,450,746,4186.066932870371,MERGED,1,1,1,1,1,179,False,0,1,1,652,2,0.99,Bug
F#,271,818,2843.0177430555555,MERGED,1,3,1,0,1,6,False,0,0,0,1710,4,0.08555555555555555,Bug
TypeScript,261,3764,786.8648958333333,MERGED,195,817,49,0,5,234,False,0,0,0,1400,1012,20.485555555555557,Document
TypeScript,261,3764,786.8071875,MERGED,1,7,2,0,1,140,True,0,0,0,1317,8,14.632222222222222,Document
TypeScript,12,11,1099.4490740740741,MERGED,4,5,1,0,1,218,False,0,0,0,1356,9,0.03111111111111111,Bug
JavaScript,5140,7054,1315.5008680555554,MERGED,8838,8930,2,2,3,195,False,1,1,1,1053,17768,0.6825,Document
Vue,293,495,941.8117361111111,MERGED,1,1,1,4,1,333,True,0,4,3,613,2,0.34444444444444444,Bug
Go,422,1654,1623.2355555555557,CLOSED,2,3,1,0,1,18,False,0,0,0,1228,5,17.79277777777778,Document
TypeScript,261,3764,789.5347916666666,MERGED,6,47,5,0,2,156,False,0,0,0,2049,53,0.32666666666666666,Document
TypeScript,1297,21107,530.0784722222222,MERGED,50,72,18,1,2,1354,True,0,1,1,755,122,0.14027777777777778,Document
TypeScript,85,724,429.00333333333333,MERGED,10,39,2,0,2,81,False,0,0,0,2256,49,1.8616666666666666,Document
Python,547,7161,2348.6379282407406,MERGED,2,16,3,0,2,54,False,0,0,0,720,18,0.8241666666666667,Document
TypeScript,2147,14725,1586.0618865740742,MERGED,13,50,2,0,1,42,False,0,0,0,2414,63,2.1341666666666668,Bug
Go,422,1654,1622.4777314814817,CLOSED,0,7,1,0,1,0,False,0,0,0,1438,7,1.5316666666666667,Bug
Vue,293,495,943.9583680555555,MERGED,3,16,2,5,1,468,False,0,5,4,1039,19,0.34694444444444444,Bug
TypeScript,2147,14725,1585.4400810185186,MERGED,0,15,1,0,1,5,False,0,0,0,1881,15,16.8825,Feature
PHP,1334,2960,4320.203784722223,MERGED,20,22,4,1,6,192,False,0,1,1,1182,42,1.4008333333333334,Document
JavaScript,5140,7054,1313.5054166666666,CLOSED,0,227,1,3,1,0,False,0,3,2,701,227,0.33555555555555555,Feature
TypeScript,261,3764,783.755474537037,MERGED,11,47,5,0,5,32,True,0,0,0,1335,58,65.63805555555555,Document
PHP,1334,2960,4320.047673611111,MERGED,10,10,2,1,2,896,False,0,1,1,1941,20,2.3933333333333335,Feature
Vue,293,495,943.547488425926,MERGED,0,1,1,4,1,96,False,0,4,3,828,1,2.4358333333333335,Bug
Python,547,7161,2350.7082986111113,MERGED,0,1,1,0,4,266,False,0,0,0,900,1,0.8277777777777777,Bug
TypeScript,261,3764,787.7187731481481,MERGED,22,11,3,0,1,1110,True,0,0,0,2155,33,0.7272222222222222,Document
JavaScript,5140,7054,1315.9378935185184,MERGED,4,55,3,1,8,73,False,0,1,1,1486,59,41.97416666666667,Document
TypeScript,261,3764,786.7053125000001,MERGED,6,31,6,0,2,245,True,0,0,0,2043,37,22.162222222222223,Document
TypeScript,85,724,426.2785763888889,MERGED,10,24,4,0,5,224,False,0,0,0,2080,34,22.16861111111111,Document
TypeScript,12,11,1098.1908564814814,MERGED,351,287,25,0,21,64,False,0,0,0,2282,638,55.68888888888889,Bug
Go,11874,71346,2809.491666666667,MERGED,3,1,1,0,1,312,True,0,0,0,218,4,0.05583333333333333,Feature
Java,450,746,4184.218518518518,MERGED,1,3,1,1,1,175,False,0,1,1,825,4,21.869722222222222,Bug
Python,547,7161,2348.627939814815,MERGED,15,14,1,0,5,189,False,0,0,0,958,29,28.17222222222222,Bug
Python,547,7161,2348.8145717592593,MERGED,3,3,2,0,2,191,False,0,0,0,897,6,1.5283333333333333,Bug
Vue,10811,21164,1134.1026967592593,MERGED,0,1,1,0,1,216,False,0,0,0,1145,1,1.0372222222222223,Bug
Python,547,7161,2348.5660995370367,MERGED,0,7,1,0,2,341,True,0,0,0,786,7,0.22027777777777777,Bug
Vue,293,495,940.5401273148149,MERGED,4,2,3,8,4,464,False,1,7,5,937,6,7.1722222222222225,Bug
Vue,293,495,938.8169328703704,MERGED,55,105,2,8,13,20,False,1,7,5,1107,160,119.78166666666667,Bug
Rust,433,2229,350.02777777777777,MERGED,0,3,1,0,1,1259,False,0,0,0,239,3,0.22361111111111112,Document
Go,2083,11771,1631.813634259259,MERGED,1,1,1,0,1,967,True,0,0,0,1099,2,0.02277777777777778,Document
Vue,10811,21164,1133.0630439814815,MERGED,1,1,1,0,1,215,False,0,0,0,1351,2,29.899166666666666,Document
Vue,293,495,938.8334027777778,MERGED,2,8,1,5,2,3,False,0,5,4,975,10,47.394444444444446,Bug
PHP,1334,2960,4319.25369212963,MERGED,7,4,1,1,1,190,False,0,1,1,1778,11,22.615833333333335,Document
V,2097,34362,1661.3394675925927,MERGED,0,7,1,1,4,1,False,1,0,0,784,7,18.76527777777778,Document
TypeScript,12,11,1096.1675,MERGED,0,266,2,0,3,100,False,0,0,0,1744,266,8.095277777777778,Bug
Go,30,295,459.0543171296296,MERGED,39,0,1,0,2,48,True,0,0,0,1196,39,33.70444444444445,Document
Go,395,661,1377.976712962963,MERGED,2,3,1,0,3,358,False,0,0,0,177,5,0.26416666666666666,Feature
Vue,293,495,938.8472800925925,MERGED,6,6,5,4,13,398,True,0,4,3,753,12,0.2783333333333333,Document
Python,547,7161,2345.7140277777776,MERGED,7,29,1,1,5,340,True,1,0,0,789,36,54.90972222222222,Bug
JavaScript,5140,7054,1311.4966782407407,MERGED,20,71,6,4,10,113,False,3,1,1,1859,91,102.63222222222223,Feature
TypeScript,15,34,603.5268634259259,MERGED,3,21,1,0,1,1146,False,0,0,0,240,24,1.1188888888888888,Feature
Kotlin,164,4298,516.8425578703703,MERGED,5,20,2,0,1,62,False,0,0,0,334,25,22.581944444444446,Feature
Go,30,295,458.83994212962966,MERGED,0,5,1,0,1,127,True,0,0,0,1427,5,1.218611111111111,Feature
TypeScript,1297,21107,530.061400462963,MERGED,13,356,14,1,3,1353,True,0,1,1,1192,369,0.07472222222222222,Document
TypeScript,261,3764,788.714050925926,MERGED,21,16,4,0,1,1117,True,0,0,0,2346,37,0.27111111111111114,Document
Vue,293,495,937.9988078703703,MERGED,279,0,10,5,1,459,False,0,5,4,870,279,4.120555555555556,Feature
TypeScript,85,724,428.01851851851853,MERGED,79,45,4,0,4,225,False,0,0,0,2859,124,1.3005555555555555,Document
Vue,293,495,944.022488425926,MERGED,1,1,1,4,1,334,True,0,4,3,1356,2,1.8308333333333333,Bug
TypeScript,261,3764,788.5367824074074,MERGED,11,11,6,0,1,1115,True,0,0,0,2733,22,0.06638888888888889,Document
Vue,10811,21164,1129.8208796296296,MERGED,2,18,3,1,5,23,False,0,1,1,1361,20,83.29888888888888,Bug
Kotlin,164,4298,516.536412037037,MERGED,7,11,1,1,1,28,False,1,0,0,329,18,2.3919444444444444,Bug
TypeScript,12,11,1099.1877083333334,CLOSED,3,42,4,0,4,18,True,0,0,0,2900,45,71.4325,Bug
Vue,293,495,943.7283333333334,MERGED,0,1,1,5,1,7,False,0,5,4,1462,1,5.566388888888889,Bug
Go,30,295,458.3359375,MERGED,1,1,1,0,1,126,True,0,0,0,1382,2,0.1413888888888889,Feature
Vue,10811,21164,1130.812523148148,MERGED,6,3,1,0,1,214,False,0,0,0,1308,9,3.901666666666667,Bug
Vue,293,495,943.5461921296296,MERGED,116,118,3,8,7,6,False,1,7,6,1100,234,9.920833333333333,Bug
Vue,293,495,943.5022916666667,MERGED,0,5,1,6,1,6,False,0,6,5,1393,5,10.983888888888888,Bug
TypeScript,261,3764,787.8480208333334,MERGED,3,51,3,0,1,300,True,0,0,0,3118,54,1.3227777777777778,Document
Vue,293,495,942.8052430555555,MERGED,9,58,1,6,1,467,False,0,6,5,1215,67,3.873611111111111,Bug
Go,395,661,1376.1687268518517,MERGED,6,2,1,0,1,96,False,0,0,0,159,8,0.2975,Feature
Vue,293,495,942.7748726851852,MERGED,1,0,1,5,1,5,False,0,5,4,1346,1,2.301111111111111,Document
TypeScript,1297,21107,528.9112731481481,MERGED,1,1,1,1,1,57,False,0,1,1,1408,2,0.23027777777777778,Document
Go,395,661,1376.0577199074075,MERGED,6,0,1,0,2,95,False,0,0,0,172,6,0.8947222222222222,Bug
TypeScript,261,3764,787.675162037037,MERGED,9,71,5,0,1,141,True,0,0,0,2765,80,0.2038888888888889,Document
TypeScript,261,3764,787.5568518518518,MERGED,1,48,5,0,2,1109,True,0,0,0,2656,49,2.3005555555555555,Document
TypeScript,42,46,883.92625,MERGED,0,4,1,1,3,205,False,0,1,1,334,4,0.1438888888888889,Feature
TypeScript,15,34,601.7258680555556,MERGED,16,21,3,0,2,406,False,0,0,0,238,37,3.0744444444444445,Feature
TypeScript,42,46,880.8762152777778,MERGED,3,3,1,1,1,201,False,0,1,1,216,6,0.06722222222222222,Feature
Vue,293,495,941.8554513888889,CLOSED,124,135,1,5,1,8,False,1,4,3,1478,259,42.19361111111111,Bug
JavaScript,5140,7054,1314.831261574074,MERGED,0,16,2,1,1,22,False,0,1,1,2170,16,0.505,Document
Vue,293,495,941.8007291666667,CLOSED,116,116,2,10,4,5,False,3,7,6,1166,232,41.60333333333333,Bug
TypeScript,15,34,601.2147337962963,MERGED,10,23,2,0,1,180,False,0,0,0,303,33,24.4975,Feature
Go,395,661,1376.2286805555557,MERGED,8,15,1,0,2,104,False,0,0,0,228,23,72.1775,Bug
Go,752,2400,840.5977083333333,MERGED,2,35,2,0,1,93,False,0,0,0,1337,37,0.7502777777777778,Bug
TypeScript,85,724,426.17520833333333,MERGED,24,46,4,0,5,111,False,0,0,0,2601,70,3.0330555555555554,Document
Python,547,7161,2350.3578125,MERGED,0,48,4,0,9,119,False,0,0,0,1282,48,22.23138888888889,Bug
Java,450,746,4185.208125,MERGED,12,18,4,1,2,178,False,0,1,1,1561,30,20.188333333333333,Bug
Python,19251,70268,2572.4980555555553,CLOSED,0,3,1,2,2,1672,False,2,0,0,339,3,21.525833333333335,Bug
Vue,293,495,941.6103935185184,MERGED,4,6,1,8,1,3,False,1,7,4,1296,10,5.316944444444444,Bug
Vue,293,495,940.9814004629629,MERGED,67,142,13,21,7,4,False,4,17,7,1546,209,71.46166666666667,Bug
Go,395,661,1376.905486111111,MERGED,2,1,1,0,1,97,False,0,0,0,240,3,2.131111111111111,Bug
Vue,293,495,940.9307291666668,MERGED,2,2,1,11,3,4,False,1,10,6,1515,4,68.95027777777777,Bug
TypeScript,261,3764,786.8442939814814,MERGED,67,7,9,0,1,1108,True,0,0,0,2392,74,3.5141666666666667,Document
Python,547,7161,2350.129988425926,MERGED,469,602,12,2,10,343,True,1,1,1,1098,1071,12.197777777777778,Bug
TypeScript,261,3764,786.7794791666666,MERGED,8,17,4,0,2,139,True,0,0,0,2805,25,0.5883333333333334,Document
Vue,293,495,941.6247800925926,MERGED,22,73,4,12,3,466,False,2,10,4,1251,95,12.340833333333334,Bug
Vue,293,495,941.236724537037,MERGED,9,11,1,9,1,11,False,1,8,5,1485,20,14.331388888888888,Bug
Vue,293,495,941.0953819444444,MERGED,8,53,1,10,4,2,False,3,7,5,1543,61,43.475,Bug
Vue,293,495,940.6982870370371,MERGED,25,26,4,18,3,92,False,4,14,6,1322,51,54.48222222222222,Bug
TypeScript,202,107,1256.7594444444444,MERGED,7,13,2,3,1,316,True,0,3,3,1765,20,0.6444444444444445,Bug
TypeScript,1297,21107,527.7910069444445,MERGED,2,1,1,1,1,1327,True,0,1,1,1396,3,2.174166666666667,Document
Go,1835,11246,1840.5714699074076,MERGED,3,4,1,0,1,137,False,0,0,0,258,7,0.3233333333333333,Bug
TypeScript,261,3764,786.4895254629629,MERGED,1,37,4,0,1,1105,True,0,0,0,2305,38,0.32611111111111113,Document
TypeScript,42,46,882.8621296296296,MERGED,2,2,1,1,2,204,False,0,1,1,272,4,0.4297222222222222,Feature
TypeScript,15,34,603.6173611111111,MERGED,2,2,1,0,3,96,False,0,0,0,324,4,0.29388888888888887,Bug
Kotlin,164,4298,516.6340740740741,MERGED,4,9,1,0,1,29,False,0,0,0,401,13,0.8569444444444444,Bug
Python,547,7161,2349.47505787037,MERGED,2,1,1,0,3,193,False,0,0,0,1019,3,2.6597222222222223,Bug
V,2097,34362,1662.851863425926,MERGED,0,12,1,2,2,79,True,0,2,2,1278,12,20.35972222222222,Feature
Vue,293,495,940.9658912037038,MERGED,12,32,3,4,1,465,False,0,4,4,1256,44,1.5925,Bug
Vue,293,495,939.7929861111111,MERGED,50,53,3,8,4,5,False,0,8,5,1510,103,76.18861111111111,Bug
V,2097,34362,1663.5748842592593,MERGED,1,1,1,0,1,1,False,0,0,0,1347,2,13.0425,Document
TypeScript,202,107,1255.6290509259259,MERGED,12,11,1,3,1,145,False,0,3,3,1455,23,19.404166666666665,Document
Python,19251,70268,2571.46193287037,MERGED,147,147,16,0,1,293,False,0,0,0,249,294,0.16833333333333333,Feature
Python,19251,70268,2571.3639814814815,MERGED,409,271,51,0,4,291,False,0,0,0,313,680,1.7525,Feature
Vue,293,495,940.5395601851851,MERGED,83,367,33,7,27,91,False,0,7,4,1433,450,6.175833333333333,Document
JavaScript,9664,43892,3771.137453703704,MERGED,10,1,1,0,1,347,True,0,0,0,432,11,0.1525,Feature
TypeScript,202,107,1254.6468750000001,MERGED,11,6,1,3,1,144,False,0,3,3,1567,17,43.00361111111111,Document
JavaScript,9664,43892,3770.833009259259,MERGED,10,19,1,0,1,59,False,0,0,0,481,29,11.765,Bug
TypeScript,15,34,602.5967245370371,MERGED,4,4,2,0,1,1144,False,0,0,0,307,8,0.5408333333333334,Bug
V,2097,34362,1662.8774189814815,CLOSED,1,1,1,0,1,0,False,0,0,0,1373,2,0.7805555555555556,Document
Vue,293,495,940.0593402777778,MERGED,16,12,4,10,5,463,False,2,8,5,1055,28,19.767777777777777,Bug
JavaScript,9664,43892,3770.4613773148144,MERGED,8,52,4,0,1,58,False,0,0,0,386,60,8.611666666666666,Feature
Vue,293,495,939.7551157407407,MERGED,18,40,1,10,6,4,False,0,10,7,1365,58,30.669166666666666,Bug
Vue,293,495,939.8496875000001,MERGED,13,5,1,6,1,32,False,0,6,4,1403,18,23.75111111111111,Bug
V,2097,34362,1660.7474652777776,MERGED,1,1,1,0,1,77,True,0,0,0,1385,2,13.781944444444445,Document
Vue,293,495,939.6967013888889,MERGED,5,1,1,6,1,3,False,0,6,5,1332,6,27.442222222222224,Bug
Vue,293,495,939.0766898148148,CLOSED,39,60,1,8,2,43,True,2,6,4,1587,99,65.17972222222222,Bug
JavaScript,9664,43892,3767.8016087962965,MERGED,3,3,1,1,1,664,False,0,1,1,312,6,0.42694444444444446,Feature
TypeScript,15,34,601.5417476851852,MERGED,11,41,2,0,2,181,False,0,0,0,320,52,16.029722222222222,Feature
Vue,293,495,939.2206018518518,MERGED,0,32,1,7,3,10,False,1,6,6,1376,32,41.0075,Bug
JavaScript,9664,43892,3770.1356944444447,MERGED,12,39,3,0,4,37,False,0,0,0,493,51,0.24972222222222223,Feature
TypeScript,42,46,880.7411805555556,MERGED,0,49,1,1,2,200,False,0,1,1,263,49,0.1463888888888889,Feature
Vue,293,495,939.0340277777777,MERGED,6,17,2,9,3,462,False,1,8,5,1112,23,42.51111111111111,Bug
Vue,293,495,938.1712384259259,MERGED,15,17,6,21,5,460,False,6,15,9,1282,32,16.620277777777776,Bug
JavaScript,9664,43892,3769.9168981481484,MERGED,0,12,1,0,1,56,False,0,0,0,386,12,0.09916666666666667,Feature
JavaScript,9664,43892,3769.8335300925924,CLOSED,6,8,2,0,1,44,False,0,0,0,426,14,1.3263888888888888,Feature
Go,2083,11771,1630.9818750000002,MERGED,16,23,1,0,1,966,True,0,0,0,1970,39,0.145,Document
C#,655,7879,1936.237974537037,CLOSED,14,14,1,1,1,1536,True,1,0,0,422,28,34.397222222222226,Feature
Vue,293,495,938.4817824074074,MERGED,2,9,2,6,2,2,False,0,6,5,1592,11,56.59305555555556,Bug
TypeScript,42,46,882.7446875,MERGED,1,3,1,1,1,203,False,0,1,1,365,4,0.07361111111111111,Feature
Python,547,7161,2345.726655092593,MERGED,43,40,10,0,7,187,False,0,0,0,1509,83,94.36222222222223,Bug
JavaScript,5140,7054,1316.0170717592594,MERGED,33,453,10,1,3,369,False,0,1,1,3373,486,39.882777777777775,Feature
Vue,10811,21164,1132.0591666666667,MERGED,5,5,2,0,1,28,True,0,0,0,2135,10,18.216666666666665,Bug
TypeScript,15,34,603.3644907407407,MERGED,102,80,23,0,5,547,True,0,0,0,459,182,3.276111111111111,Feature
V,2097,34362,1661.3125694444443,MERGED,1,2,1,0,2,0,False,0,0,0,1328,3,1.1205555555555555,Document
Python,547,7161,2345.8015162037036,MERGED,125,75,4,0,3,188,False,0,0,0,1381,200,65.77527777777777,Bug
TypeScript,202,107,1251.9357060185187,MERGED,14,12,1,3,1,331,True,0,3,3,1593,26,108.0886111111111,Document
TypeScript,202,107,1251.9164120370372,MERGED,1,6,1,3,2,142,False,0,3,3,1455,7,108.56055555555555,Document
TypeScript,15,34,597.7461342592593,MERGED,4,10,1,0,2,1135,False,0,0,0,257,14,0.5427777777777778,Bug
JavaScript,9664,43892,3769.0073726851856,MERGED,2,54,7,0,3,35,False,0,0,0,465,56,0.2836111111111111,Feature
TypeScript,15,34,597.4970717592593,MERGED,123,112,2,0,1,1133,False,0,0,0,226,235,2.1275,Feature
Go,395,661,1378.241076388889,MERGED,87,137,3,0,8,359,False,0,0,0,454,224,20.56222222222222,Feature
JavaScript,9664,43892,3767.9081365740744,MERGED,77,77,4,1,1,0,False,0,1,1,420,154,50.88444444444445,Bug
Vue,293,495,937.7537268518519,MERGED,44,24,3,7,2,40,True,0,7,5,1478,68,28.433888888888887,Bug
Vue,293,495,942.828738425926,MERGED,65,44,3,6,5,34,False,0,6,4,1608,109,0.46166666666666667,Bug
TypeScript,202,107,1254.8486689814815,MERGED,54,29,4,3,6,6,False,0,3,3,608,83,38.1475,Bug
Vue,293,495,937.949212962963,MERGED,65,71,1,8,4,41,True,0,8,6,1493,136,4.227777777777778,Bug
Vue,293,495,942.7507523148148,MERGED,15,14,6,7,7,93,False,0,7,5,1600,29,2.786111111111111,Bug
Vue,293,495,942.2326041666666,MERGED,2,8,1,10,2,13,False,1,9,6,1776,10,14.787222222222223,Bug
Vue,293,495,942.171886574074,MERGED,2,3,2,6,2,12,False,0,6,5,1948,5,16.698333333333334,Bug
TypeScript,58,78,933.2005208333334,MERGED,53,169,7,1,1,236,True,0,1,1,3678,222,26.414166666666667,Feature
Go,395,661,1377.9144791666668,MERGED,2,35,4,0,1,357,False,0,0,0,489,37,0.10694444444444444,Feature
Vue,10811,21164,1130.9894907407408,MERGED,9,15,4,1,4,164,False,0,1,1,2095,24,0.6877777777777778,Document
Vue,10811,21164,1130.9851851851852,CLOSED,9,6,3,1,3,163,False,0,1,1,2095,15,0.09888888888888889,Document
Vue,10811,21164,1130.9759490740742,CLOSED,9,6,3,1,3,162,False,0,1,1,2095,15,0.2136111111111111,Document
JavaScript,5140,7054,1314.5992476851852,MERGED,23,35,24,1,2,366,False,0,1,1,3887,58,24.799722222222222,Document
TypeScript,15,34,601.655,MERGED,37,57,8,0,5,1142,False,0,0,0,399,94,6.061388888888889,Document
Go,2083,11771,1629.0189236111112,MERGED,8,19,1,0,1,964,True,0,0,0,1560,27,0.041666666666666664,Document
TypeScript,1297,21107,527.9565856481481,CLOSED,0,1,1,1,1,1,False,0,1,1,1777,1,0.5844444444444444,Document
JavaScript,9664,43892,3767.8435300925926,MERGED,1,1,1,0,1,665,False,0,0,0,500,2,0.18444444444444444,Feature
Go,422,1654,1616.9395370370369,MERGED,8,15,10,0,1,526,True,0,0,0,2820,23,71.02777777777777,Document
Vue,293,495,940.9767476851852,MERGED,22,19,1,10,2,33,False,0,10,4,1638,41,27.79222222222222,Bug
TypeScript,42,46,877.8839814814814,MERGED,6,6,6,1,3,199,False,0,1,1,274,12,2.137777777777778,Feature
JavaScript,9664,43892,3771.1162731481486,MERGED,8,1,1,0,1,346,True,0,0,0,551,9,0.15916666666666668,Feature
TypeScript,85,724,428.20125,MERGED,24,53,3,0,2,228,False,0,0,0,3813,77,18.73361111111111,Document
TypeScript,261,3764,789.7653587962964,MERGED,30,232,11,0,5,237,False,0,0,0,3847,262,19.608333333333334,Document
TypeScript,3393,2334,1074.7289467592593,CLOSED,445,2680,87,1,56,405,False,0,1,1,440,3125,0.08138888888888889,Feature
JavaScript,9664,43892,3770.887858796296,MERGED,0,120,40,0,1,345,True,0,0,0,643,120,0.1763888888888889,Feature
TypeScript,15,34,600.2382407407407,MERGED,26,67,10,0,4,178,False,0,0,0,465,93,53.58361111111111,Feature
TypeScript,1297,21107,527.0705208333333,MERGED,2,2,1,2,2,56,False,1,1,1,1753,4,14.650555555555556,Document
TypeScript,261,3764,784.5176504629629,MERGED,8,131,7,0,3,276,False,0,0,0,3151,139,28.014166666666668,Document
JavaScript,9664,43892,3770.7569791666665,MERGED,8,43,2,0,2,99,True,0,0,0,599,51,3.9580555555555557,Feature
TypeScript,2147,14725,1584.8232060185185,MERGED,19,49,5,0,1,824,False,0,0,0,4899,68,31.56,Feature
TypeScript,307,2556,650.6338194444444,MERGED,2,34,2,1,4,35,False,0,1,1,1712,36,25.16722222222222,Document
Vue,293,495,939.9090972222222,MERGED,259,205,2,10,5,24,False,1,9,5,1966,464,46.16555555555556,Bug
TypeScript,15,34,600.7928125,MERGED,103,115,8,0,2,1140,False,0,0,0,502,218,0.5955555555555555,Bug
PHP,883,2338,1941.4377083333331,CLOSED,0,91,1,2,1,2,False,0,2,2,1944,91,104.28916666666667,Document
TypeScript,12,11,1100.232164351852,MERGED,73,487,7,0,20,104,False,0,0,0,3873,560,46.91583333333333,Feature
Go,2083,11771,1627.7634837962962,MERGED,2,2,1,2,1,0,False,0,2,2,1457,4,2.89,Document
F#,153,337,3026.9837268518518,MERGED,652,692,3,0,2,189,False,0,0,0,2344,1344,22.345555555555556,Document
TypeScript,15,34,597.7966666666667,MERGED,181,208,8,0,1,1136,False,0,0,0,346,389,0.7888888888888889,Feature
TypeScript,261,3764,788.7954398148148,MERGED,130,148,69,0,3,1119,True,0,0,0,4308,278,17.60972222222222,Document
JavaScript,9664,43892,3769.981712962963,MERGED,16,156,6,0,9,36,False,0,0,0,647,172,1.1925,Feature
Vue,293,495,938.7823958333333,MERGED,37,377,13,23,23,90,False,7,16,10,2010,414,97.9925,Bug
TypeScript,12,11,1099.1971064814813,CLOSED,13,47,18,0,2,19,True,0,0,0,4673,60,71.20361111111112,Feature
JavaScript,9664,43892,3769.815,MERGED,0,8,2,0,1,347,True,0,0,0,676,8,3.6594444444444445,Feature
Vue,293,495,938.9147916666667,CLOSED,22,19,1,6,2,31,False,1,5,5,2036,41,75.31888888888889,Bug
TypeScript,307,2556,649.7202199074073,MERGED,8,7,2,6,1,24,True,2,4,2,1558,15,18.879166666666666,Bug
TypeScript,261,3764,788.6238541666667,MERGED,32,104,16,0,2,1116,True,0,0,0,4476,136,0.30194444444444446,Document
Go,2083,11771,1631.9017476851852,MERGED,9,27,2,2,1,968,True,0,2,1,1945,36,0.15583333333333332,Document
TypeScript,15,34,602.8745949074074,CLOSED,51,64,1,0,5,94,False,0,0,0,555,115,0.475,Feature
TypeScript,15,34,602.8997337962963,MERGED,1,19,1,0,21,95,False,0,0,0,640,20,16.285555555555554,Feature
Java,450,746,4184.192638888889,MERGED,19,59,7,2,10,48,False,0,2,1,689,78,19.095277777777778,Feature
TypeScript,261,3764,787.9955092592592,MERGED,883,105,50,0,1,155,False,0,0,0,4634,988,15.524722222222222,Document
PHP,1093,3328,2966.213900462963,CLOSED,1,480,5,0,26,2,False,0,0,0,656,481,25.575277777777778,Bug
JavaScript,9664,43892,3768.8762152777776,MERGED,12,1385,4,0,1,342,True,0,0,0,562,1397,0.3244444444444444,Feature
JavaScript,9664,43892,3768.8544444444447,MERGED,92,81,7,0,4,341,True,0,0,0,487,173,0.3263888888888889,Feature
JavaScript,9664,43892,3768.2923726851855,MERGED,82,236,11,0,3,55,False,0,0,0,634,318,38.971666666666664,Feature
C#,80,125,930.5393055555555,MERGED,2,2,1,0,2,21,False,0,0,0,513,4,78.49972222222222,Document
TypeScript,41369,87417,3048.6105902777776,MERGED,0,6,1,2,1,686,True,0,2,2,2055,6,0.28805555555555556,Document
TypeScript,41369,87417,3048.599166666667,MERGED,2,6,1,2,2,536,True,0,2,2,2113,8,1.0644444444444445,Document
TypeScript,261,3764,787.7057175925926,MERGED,27772,2638,463,1,2,277,False,0,1,1,3761,30410,0.5755555555555556,Document
TypeScript,307,2556,648.6571643518519,MERGED,10,8,3,2,1,601,True,0,2,2,1643,18,20.028055555555557,Bug
Go,1174,11429,1948.734837962963,MERGED,0,1,1,1,1,151,True,1,0,0,1907,1,0.7466666666666667,Document
Python,19251,70268,2567.8230208333334,CLOSED,4,6,3,1,3,1671,False,1,0,0,617,10,163.9463888888889,Bug
TypeScript,41369,87417,3048.0358564814815,MERGED,1,1,1,1,1,0,False,0,1,1,1915,2,8.763055555555555,Document
TypeScript,15,34,601.9066898148147,MERGED,78,70,4,0,2,1143,False,0,0,0,550,148,11.992222222222223,Bug
Go,1174,11429,1954.8648726851852,CLOSED,195,165,12,1,1,505,True,1,0,0,2068,360,2.971111111111111,Document
Go,1174,11429,1954.668587962963,MERGED,1,1,1,3,1,504,True,3,0,0,2614,2,2.7880555555555557,Document
C#,80,125,930.6079398148148,MERGED,5,6,1,0,1,116,False,0,0,0,660,11,0.8180555555555555,Document
TypeScript,15,34,601.4047453703704,MERGED,92,1025,18,0,10,405,False,0,0,0,639,1117,5.865833333333334,Feature
TypeScript,261,3764,786.5219907407408,MERGED,6,67,8,0,1,1106,True,0,0,0,3747,73,1.9269444444444443,Document
TypeScript,15,34,597.4731712962963,MERGED,629,217,24,0,7,1132,False,0,0,0,434,846,6.805833333333333,Bug
TypeScript,12,11,1096.443611111111,MERGED,7,229,9,0,2,216,False,0,0,0,3985,236,66.14611111111111,Bug
PHP,1334,2960,4320.003796296296,MERGED,4,12,1,1,3,191,False,0,1,1,2877,16,0.44055555555555553,Document
TypeScript,12,11,1096.2868171296298,MERGED,7,635,11,0,3,215,False,0,0,0,4014,642,70.10527777777777,Bug
Go,395,661,1372.819652777778,MERGED,18,42,3,0,1,172,False,0,0,0,446,60,4.353888888888889,Feature
TypeScript,15,34,600.4677314814815,MERGED,10,432,9,0,6,546,True,0,0,0,593,442,19.410833333333333,Feature
Go,1174,11429,1953.6669097222223,CLOSED,1,1,1,1,1,523,True,1,0,0,2257,2,0.8572222222222222,Document
TypeScript,15,34,600.2905787037038,MERGED,48,47,9,0,4,179,False,0,0,0,535,95,20.930833333333332,Bug
TypeScript,1297,21107,530.1428587962963,MERGED,17,81,6,1,4,1355,True,0,1,1,2515,98,0.036944444444444446,Document
Go,1174,11429,1953.243923611111,MERGED,1,18,1,1,1,697,True,1,0,0,2253,19,11.663333333333334,Document
TypeScript,15,34,599.6442592592592,MERGED,223,911,21,0,16,545,True,0,0,0,591,1134,44.632777777777775,Bug
Go,1174,11429,1953.0214351851853,MERGED,2,2,1,1,1,237,False,1,0,0,2650,4,17.53638888888889,Document
TypeScript,1297,21107,529.8316550925925,CLOSED,10,55,3,1,4,58,False,0,1,1,2887,65,5.081666666666667,Document
JavaScript,5140,7054,1317.5919675925927,MERGED,19,172,7,1,3,116,False,0,1,1,3631,191,7.1775,Feature
TypeScript,85,724,424.0273148148148,MERGED,21,59,6,0,5,130,False,0,0,0,4013,80,0.8036111111111112,Document
Erlang,2054,12122,3908.262858796296,MERGED,20,12,1,0,1,101,False,0,0,0,848,32,15.383333333333333,Document
TypeScript,1297,21107,529.7721990740741,MERGED,17,13,2,1,2,1347,True,0,1,1,3192,30,0.010833333333333334,Document
TypeScript,1297,21107,529.7414004629629,MERGED,4,136,6,1,2,1346,True,0,1,1,3087,140,0.7713888888888889,Document
TypeScript,261,3764,789.5978935185185,MERGED,109,195,19,0,1,58,False,0,0,0,2935,304,0.2338888888888889,Document
Go,1174,11429,1952.6785069444443,MERGED,4,55,4,1,1,502,True,1,0,0,2633,59,24.21638888888889,Document
C#,80,125,927.8568055555555,MERGED,1185,3644,259,0,16,114,False,0,0,0,778,4829,70.42694444444444,Document
Vue,293,495,943.2738541666666,MERGED,30,11,2,10,3,14,False,2,8,5,2043,41,16.3475,Bug
Go,1174,11429,1952.2345138888888,MERGED,0,12,1,0,1,696,True,0,0,0,2142,12,35.90555555555556,Document
JavaScript,9664,43892,3770.334467592593,MERGED,22,49,3,0,2,38,False,0,0,0,825,71,14.611666666666666,Feature
Go,1174,11429,1951.9631944444445,MERGED,3,3,3,1,1,190,True,1,0,0,2407,6,0.8172222222222222,Document
TypeScript,1297,21107,528.4756712962964,MERGED,3,169,3,1,1,1331,True,0,1,1,3434,172,0.028055555555555556,Document
TypeScript,261,3764,783.7741898148148,MERGED,4824,136,19,0,1,1104,True,0,0,0,4576,4960,0.43222222222222223,Document
TypeScript,261,3764,783.7375694444445,MERGED,25,84,8,0,1,1103,True,0,0,0,4431,109,0.4075,Document
JavaScript,5140,7054,1314.5769560185186,MERGED,21,74,6,3,4,288,False,1,2,2,5124,95,55.54,Feature
TypeScript,41369,87417,3050.7423263888886,CLOSED,2586,16614,271,3,97,0,False,0,3,3,2495,19200,5.849722222222222,Document
TypeScript,41369,87417,3050.7450925925928,MERGED,7,3,3,2,2,25,False,0,2,2,2125,10,3.8916666666666666,Document
TypeScript,41369,87417,3050.6199768518522,MERGED,2,6,2,2,12,0,False,0,2,2,2644,8,8.528055555555556,Document
TypeScript,41369,87417,3050.6447106481482,MERGED,3,5,3,2,2,537,True,0,2,2,2716,8,6.2877777777777775,Document
TypeScript,202,107,1255.7258912037037,MERGED,32,739,9,3,6,332,True,0,3,3,3580,771,19.2875,Document
C#,80,125,931.6744675925926,MERGED,329,29,3,0,3,22,False,0,0,0,715,358,48.85916666666667,Document
TypeScript,3393,2334,1078.9507986111112,MERGED,18,79,5,1,6,202,False,0,1,1,969,97,50.55555555555556,Bug
TypeScript,15,34,597.5160185185185,MERGED,3,10,1,0,1,404,False,0,0,0,640,13,5.1194444444444445,Feature
TypeScript,2070,16643,1351.2538194444444,MERGED,2,4,1,0,2,62,True,0,0,0,2770,6,39.068333333333335,Bug
JavaScript,5140,7054,1314.7862499999999,MERGED,33,655,9,2,3,368,False,1,1,1,4364,688,20.451944444444443,Feature
TypeScript,15,34,597.3972222222222,MERGED,139,130,6,0,2,177,False,0,0,0,596,269,8.949166666666667,Feature
TypeScript,15,34,597.4344212962964,MERGED,5,21,3,0,1,403,False,0,0,0,513,26,1.8955555555555557,Bug
JavaScript,9664,43892,3769.059803240741,MERGED,1,1,1,0,1,343,True,0,0,0,754,2,0.1825,Bug
JavaScript,5140,7054,1314.6573148148148,MERGED,33,197,9,1,2,367,False,0,1,1,4019,230,23.291944444444443,Feature
JavaScript,5140,7054,1314.646261574074,MERGED,33,371,6,1,3,99,False,0,1,1,3935,404,19.16888888888889,Feature
Go,1174,11429,1949.0384606481482,MERGED,75,36,3,8,1,192,True,4,4,3,2508,111,97.04416666666667,Document
JavaScript,9664,43892,3768.8163078703706,MERGED,2,11,3,0,1,346,True,0,0,0,729,13,0.6102777777777778,Feature
TypeScript,41369,87417,3050.0148726851853,MERGED,3,8,1,2,2,1703,True,0,2,2,2234,11,9.650555555555556,Document
JavaScript,5140,7054,1313.8852199074074,MERGED,66,126,6,1,4,307,False,0,1,1,4824,192,24.74361111111111,Document
JavaScript,9664,43892,3768.1574189814814,MERGED,118,380,17,0,5,54,False,0,0,0,768,498,0.4697222222222222,Feature
TypeScript,4,33,873.2440046296297,MERGED,1,1,1,1,1,70,False,0,1,1,1047,2,0.7919444444444445,Bug
TypeScript,41369,87417,3049.3987500000003,MERGED,40,44,1,2,1,59,True,0,2,2,2445,84,0.695,Document
TypeScript,41369,87417,3049.3460879629633,MERGED,3,4,2,3,3,0,False,0,3,3,2533,7,4.069166666666667,Document
Go,395,661,1377.1632175925924,MERGED,4,141,4,0,2,5,False,0,0,0,903,145,46.054722222222225,Feature
TypeScript,41369,87417,3048.771064814815,CLOSED,1,1,1,5,1,8,False,0,5,4,2232,2,39.56361111111111,Document
TypeScript,41369,87417,3048.9361921296295,CLOSED,1,8,2,5,3,9,False,1,4,4,2255,9,23.656388888888888,Document
TypeScript,3393,2334,1078.2476504629628,MERGED,2,15,1,2,3,550,False,0,2,1,1068,17,0.3938888888888889,Bug
TypeScript,3393,2334,1078.1943055555555,MERGED,0,5,1,2,1,548,False,0,2,1,994,5,0.05638888888888889,Feature
C#,655,7879,1942.2747337962962,MERGED,2,5,1,5,1,1543,True,2,3,3,1932,7,8.668888888888889,Document
TypeScript,3393,2334,1078.102824074074,MERGED,0,3,1,1,1,199,False,0,1,1,1103,3,0.009166666666666667,Feature
C#,655,7879,1942.1143287037037,MERGED,2,2,1,3,2,1541,True,1,2,2,1682,4,4.026666666666666,Document
TypeScript,15,34,600.7869560185185,MERGED,161,1386,40,0,32,215,False,0,0,0,818,1547,57.315,Feature
Go,1174,11429,1948.7291666666667,MERGED,20,22,1,2,2,506,False,2,0,0,2394,42,5.582777777777777,Document
TypeScript,41369,87417,3048.6550810185186,MERGED,1,22,2,2,2,687,True,0,2,2,2799,23,1.3919444444444444,Document
TypeScript,41369,87417,3048.65130787037,MERGED,1,2,2,2,2,0,False,0,2,2,2732,3,0.4525,Document
TypeScript,41369,87417,3048.6305324074074,CLOSED,30,107,10,4,6,214,False,1,3,3,2242,137,1.0533333333333332,Document
TypeScript,41369,87417,3046.8198726851856,MERGED,53,55,1,2,1,1690,True,0,2,2,2336,108,0.6552777777777777,Document
TypeScript,4,33,870.4081134259259,MERGED,7,15,1,1,5,7,False,0,1,1,1022,22,101.93416666666667,Document
TypeScript,41369,87417,3047.8004513888886,MERGED,0,5,1,19,1,1,False,7,12,3,1992,5,23.115,Document
TypeScript,15,34,600.7083564814815,MERGED,86,173,12,0,2,1139,False,0,0,0,1384,259,0.9016666666666666,Document
TypeScript,41369,87417,3047.8356481481483,MERGED,0,1,1,2,1,1977,True,0,2,2,2165,1,0.1363888888888889,Document
TypeScript,41369,87417,3047.7067245370367,CLOSED,154,51,21,4,3,56,True,0,4,3,2779,205,1.221111111111111,Document
Go,2083,11771,1630.300462962963,MERGED,7,19,8,0,1,965,True,0,0,0,2792,26,0.12944444444444445,Document
TypeScript,41369,87417,3047.619849537037,MERGED,1,3,1,2,1,30,True,0,2,2,2250,4,0.4786111111111111,Document
TypeScript,41369,87417,3047.3792129629633,MERGED,1,1,1,2,1,535,True,0,2,2,2169,2,0.9230555555555555,Document
Vue,293,495,937.6319328703704,MERGED,5,11,3,5,2,1,False,0,5,4,2322,16,7.908611111111111,Bug
TypeScript,41369,87417,3046.543680555556,MERGED,8,8,2,2,1,24,False,0,2,2,2916,16,22.785833333333333,Document
TypeScript,41369,87417,3046.007465277778,MERGED,0,1,1,2,1,1976,True,0,2,2,2201,1,34.03611111111111,Document
TypeScript,41369,87417,3044.4093749999997,MERGED,5,50,5,10,15,6,False,5,5,3,3101,55,109.44694444444444,Document
TypeScript,41369,87417,3045.9576504629626,MERGED,2,4,2,2,3,532,True,0,2,2,2592,6,0.8647222222222222,Document
C#,655,7879,1938.3503125,MERGED,29,39,2,0,2,20,True,0,0,0,1777,68,0.28194444444444444,Document
C#,655,7879,1938.344537037037,MERGED,14,31,2,0,2,19,True,0,0,0,1783,45,0.23166666666666666,Document
TypeScript,58,78,932.085601851852,MERGED,121,481,10,1,10,125,False,0,1,1,8049,602,52.20111111111111,Bug
TypeScript,15,34,597.3624768518519,MERGED,20,53,4,0,2,544,True,0,0,0,781,73,0.3383333333333333,Bug
JavaScript,5140,7054,1311.684074074074,MERGED,21,476,13,1,3,0,False,0,1,1,3160,497,67.86055555555555,Feature
TypeScript,2147,14725,1585.210266203704,MERGED,20,245,13,0,3,693,False,0,0,0,6711,265,17.177777777777777,Document
Erlang,2054,12122,3909.168912037037,MERGED,12,9,2,0,1,41,False,0,0,0,1349,21,5.914444444444444,Document
TypeScript,261,3764,789.8500462962962,MERGED,134,137,8,0,2,238,False,0,0,0,6238,271,14.834166666666667,Document
Erlang,2054,12122,3908.352013888889,MERGED,33,251,10,0,1,464,False,0,0,0,1289,284,24.730555555555554,Document
C#,655,7879,1935.5703472222222,MERGED,15,92,5,6,2,233,True,0,6,3,1714,107,86.04055555555556,Document
TypeScript,261,3764,789.5145717592592,MERGED,1,47,14,0,1,666,True,0,0,0,5600,48,0.22611111111111112,Document
Python,137,75,797.2391550925926,MERGED,12,21,4,0,3,127,False,0,0,0,1768,33,0.6663888888888889,Bug
Erlang,2054,12122,3908.166701388889,MERGED,2,13,2,1,1,39,False,1,0,0,1343,15,6.007777777777778,Document
Go,1174,11429,1953.3869444444445,MERGED,0,4,1,0,1,107,False,0,0,0,2822,4,11.6475,Document
TypeScript,3393,2334,1081.6970833333332,MERGED,2,2,1,2,1,0,False,0,2,1,1262,4,4.3025,Bug
TypeScript,85,724,427.0418287037037,MERGED,975,277,20,0,17,36,False,0,0,0,7816,1252,1.8408333333333333,Document
Go,1174,11429,1953.1059143518517,MERGED,20,35,2,9,1,503,True,4,5,2,3251,55,1.0919444444444444,Document
JavaScript,5140,7054,1310.9385416666667,MERGED,21,635,14,1,4,0,False,0,1,1,3490,656,14.676666666666666,Feature
Go,1174,11429,1953.0057060185184,MERGED,19,17,15,4,1,191,True,2,2,2,3055,36,0.6469444444444444,Document
C#,655,7879,1935.8418287037036,MERGED,22,25,2,0,2,18,True,0,0,0,1758,47,1.58,Document
TypeScript,1297,21107,529.8486342592593,MERGED,204,345,16,1,8,1348,True,0,1,1,4454,549,0.7025,Document
TypeScript,4,33,875.8911111111111,CLOSED,6,84,2,1,3,85,False,0,1,1,1240,90,0.0375,Document
TypeScript,3393,2334,1081.1372337962964,MERGED,2,0,1,1,1,412,False,0,1,1,1642,2,1.3522222222222222,Feature
Erlang,2054,12122,3907.3120601851856,MERGED,46,158,13,0,3,100,False,0,0,0,1199,204,19.647222222222222,Document
TypeScript,3393,2334,1081.0869560185185,MERGED,0,29,2,1,1,411,False,0,1,1,1600,29,0.2866666666666667,Feature
TypeScript,4,33,875.5733796296296,MERGED,1,32,4,1,14,290,False,0,1,1,1144,33,0.021666666666666667,Document
C++,363,552,649.4857060185185,MERGED,28,19,1,3,1,335,False,2,1,1,1944,47,12.351111111111111,Document
Go,1174,11429,1951.0679050925926,CLOSED,108,132,17,5,1,501,True,2,3,2,3301,240,94.11305555555556,Document
C#,80,125,933.5478356481482,MERGED,252,723,86,0,1,23,False,0,0,0,1260,975,0.18611111111111112,Document
Erlang,2054,12122,3906.6853703703705,MERGED,7,58,3,0,1,455,True,0,0,0,1506,65,23.75722222222222,Document
Erlang,2054,12122,3905.969618055555,MERGED,2,4,3,0,1,261,True,0,0,0,1178,6,45.221944444444446,Document
Erlang,2054,12122,3906.5236805555555,MERGED,0,26,3,0,1,38,False,0,0,0,1316,26,19.450277777777778,Document
C++,363,552,649.1073842592592,MERGED,1,11,2,0,1,332,False,0,0,0,1568,12,8.644444444444444,Document
Erlang,2054,12122,3906.02837962963,MERGED,6,24,3,0,2,420,True,0,0,0,1209,30,48.36944444444445,Document
TypeScript,3393,2334,1080.0861805555555,MERGED,0,9,1,1,1,409,False,0,1,1,1011,9,0.2088888888888889,Feature
TypeScript,1297,21107,528.7340972222222,MERGED,27,100,8,1,1,1333,True,0,1,1,3664,127,0.13416666666666666,Document
Erlang,2054,12122,3906.011608796296,MERGED,8,27,5,0,3,454,True,0,0,0,1386,35,27.608888888888888,Document
C#,655,7879,1940.4751736111111,MERGED,15,54,2,0,5,103,False,0,0,0,2019,69,54.283611111111114,Document
C#,655,7879,1941.024398148148,MERGED,2,2,1,1,2,747,True,0,1,1,2263,4,13.565,Document
Python,2409,12193,350.87655092592587,MERGED,3,3,1,2,1,2,False,0,2,1,1587,6,6.2877777777777775,Document
TypeScript,3393,2334,1079.7332523148148,MERGED,2,2,1,2,1,552,False,0,2,1,1233,4,6.733333333333333,Feature
C++,363,552,648.1326967592593,MERGED,1,3,1,0,1,69,False,0,0,0,1370,4,44.553333333333335,Document
Java,450,746,4183.215243055555,MERGED,25,139,7,1,8,174,False,0,1,1,3895,164,16.959444444444443,Bug
TypeScript,4,33,874.2673379629629,MERGED,0,7,1,1,2,699,True,0,1,1,1086,7,0.5411111111111111,Bug
TypeScript,4,33,874.2148148148149,MERGED,2,2,1,1,1,428,False,0,1,1,1540,4,0.6394444444444445,Feature
C++,363,552,648.2853240740741,MERGED,33,108,3,0,2,119,False,0,0,0,1626,141,4.2811111111111115,Document
C++,363,552,648.2816087962963,MERGED,112,82,12,1,1,118,False,0,1,1,1552,194,2.9058333333333333,Document
C#,655,7879,1940.4272453703704,MERGED,34,47,5,0,6,21,True,0,0,0,2020,81,16.221944444444443,Document
TypeScript,4,33,873.7977546296296,MERGED,1,3,1,3,3,8,False,1,2,2,1140,4,14.1775,Document
TypeScript,3393,2334,1079.2089699074074,MERGED,13,7,1,1,1,204,False,0,1,1,1373,20,0.3322222222222222,Feature
TypeScript,261,3764,786.6583796296296,MERGED,44,43,22,0,1,1107,True,0,0,0,6886,87,0.06333333333333334,Document
TypeScript,41369,87417,3050.7344675925924,MERGED,6,57,4,4,4,163,True,1,3,3,3229,63,17.912777777777777,Document
C++,363,552,648.0278703703704,MERGED,28,3,1,0,2,331,False,0,0,0,2051,31,4.8469444444444445,Document
TypeScript,3393,2334,1079.0664930555556,MERGED,1,14,1,1,1,203,False,0,1,1,1589,15,0.3188888888888889,Feature
Java,450,746,4184.05949074074,MERGED,1,1,1,1,1,91,False,0,1,1,1352,2,0.2763888888888889,Bug
V,2097,34362,1662.7880902777779,MERGED,20,22,13,0,4,78,True,0,0,0,3660,42,31.9675,Document
TypeScript,41369,87417,3050.720497685185,CLOSED,6,47,7,1,6,162,True,0,1,1,3947,53,0.3372222222222222,Document
C#,655,7879,1939.1471527777778,MERGED,8,83,4,0,3,31,False,0,0,0,2297,91,70.03194444444445,Document
JavaScript,34,25,308.256712962963,MERGED,6,10,2,1,1,16,False,1,0,0,1584,16,44.49722222222222,Feature
Python,2409,12193,349.7281018518518,MERGED,3,5,1,0,2,99,True,0,0,0,1629,8,3.104722222222222,Document
C++,363,552,647.4312384259259,MERGED,201,207,2,0,2,330,False,0,0,0,1527,408,7.078611111111111,Document
TypeScript,4,33,873.2256365740741,MERGED,5,86,6,1,1,697,True,0,1,1,1586,91,4.704166666666667,Feature
JavaScript,5140,7054,1317.6040393518517,MERGED,38,974,18,2,6,370,False,1,1,1,7478,1012,4.258333333333334,Feature
TypeScript,61,71,1782.921689814815,MERGED,3,3,1,0,2,30,True,0,0,0,1450,6,5.310833333333333,Bug
TypeScript,4,33,872.3215972222223,MERGED,187,503,20,1,9,446,True,0,1,1,1608,690,52.48916666666667,Document
TypeScript,41369,87417,3050.0052199074075,MERGED,12,54,1,2,4,1978,True,0,2,2,3541,66,10.06638888888889,Document
TypeScript,307,2556,649.5019560185185,MERGED,2,31,6,1,4,0,False,0,1,1,4387,33,58.76583333333333,Document
Erlang,2054,12122,3903.438553240741,MERGED,39,88,3,0,1,37,False,0,0,0,1538,127,73.27166666666666,Document
Go,1835,11246,1841.8409490740742,MERGED,20,0,1,0,2,138,False,0,0,0,1443,20,3.5408333333333335,Bug
C++,363,552,646.4335532407407,MERGED,5,26,3,0,1,329,False,0,0,0,1558,31,35.69611111111111,Document
TypeScript,4,33,870.246574074074,MERGED,189,516,19,2,29,291,True,1,1,1,1026,705,143.75861111111112,Feature
TypeScript,85,724,423.05350694444445,MERGED,103,255,30,0,26,129,False,0,0,0,8184,358,1.7647222222222223,Document
JavaScript,9664,43892,3766.0504745370367,MERGED,4,4,2,3,5,0,False,2,1,1,1122,8,69.55583333333334,Feature
TypeScript,41369,87417,3048.8520949074077,MERGED,6,324,12,6,5,688,True,2,4,3,3914,330,25.405833333333334,Document
Python,14534,41196,1195.8998032407408,MERGED,0,0,0,0,2,1445,True,0,0,0,1457,0,19.720555555555556,Document
Go,1835,11246,1840.8926967592595,MERGED,27,42,11,0,2,27,False,0,0,0,1500,69,4.067777777777778,Document
Python,2409,12193,347.9284953703704,MERGED,1,57,2,0,2,476,True,0,0,0,1379,58,10.33388888888889,Document
Erlang,2054,12122,3903.2876967592597,MERGED,3,60,2,0,1,36,False,0,0,0,1622,63,3.425,Document
JavaScript,5140,7054,1315.803449074074,MERGED,2011,1170,43,1,8,196,False,0,1,1,5713,3181,24.477777777777778,Document
TypeScript,4,33,871.2685995370371,MERGED,118,136,8,1,1,445,True,0,1,1,1297,254,0.034444444444444444,Document
C++,363,552,644.1988657407408,MERGED,9,28,6,0,1,328,False,0,0,0,1762,37,87.475,Document
Erlang,2054,12122,3902.8767824074075,MERGED,17,16,9,0,2,452,True,0,0,0,1366,33,5.83,Document
Go,1835,11246,1839.9402430555556,MERGED,0,1,1,0,1,138,False,0,0,0,1502,1,15.54888888888889,Document
TypeScript,261,3764,783.6547569444446,MERGED,901,1273,61,0,10,1102,True,0,0,0,7102,2174,1.791388888888889,Document
C++,363,552,643.9948495370371,MERGED,50,48,5,1,2,117,False,1,0,0,1437,98,71.84305555555555,Document
TypeScript,41369,87417,3047.80099537037,MERGED,1,3,1,2,3,57,True,0,2,2,3863,4,3.3325,Document
Java,450,746,4180.259907407407,MERGED,1,5,2,1,1,46,False,0,1,1,1466,6,65.86305555555556,Feature
TypeScript,41369,87417,3047.7492592592594,MERGED,4,5,3,2,1,1692,True,0,2,2,3028,9,2.028611111111111,Document
TypeScript,41369,87417,3047.723634259259,MERGED,7,45,2,2,1,31,True,0,2,2,3458,52,3.285833333333333,Document
TypeScript,41369,87417,3047.5062962962966,MERGED,13,21,5,1,6,161,True,0,1,1,4533,34,2.9355555555555557,Document
Go,1835,11246,1839.557361111111,MERGED,3,22,2,0,1,135,False,0,0,0,1635,25,8.2975,Document
Python,2409,12193,353.79340277777777,MERGED,46,73,4,1,22,491,True,1,0,0,2095,119,1.6247222222222222,Document
TypeScript,41369,87417,3046.729560185185,MERGED,18,49,5,6,12,534,True,1,5,5,3322,67,27.045,Document
Vue,10812,21164,1130.0700810185185,MERGED,2,2,1,1,1,2,False,0,1,1,1583,4,17.57111111111111,Bug
C++,363,552,644.0677430555555,MERGED,0,3,1,0,1,327,False,0,0,0,1406,3,0.7394444444444445,Document
Python,2409,12193,353.39163194444444,MERGED,0,59,1,2,2,1,False,0,2,1,2051,59,9.627222222222223,Document
TypeScript,3393,2334,1074.9984027777778,MERGED,18,7,2,1,1,195,False,0,1,1,1639,25,0.008333333333333333,Document
Erlang,2054,12122,3908.3215046296295,MERGED,57,49,8,0,1,40,False,0,0,0,1590,106,3.3033333333333332,Document
C#,80,125,927.688761574074,MERGED,0,1,1,0,2,203,False,0,0,0,944,1,2.765833333333333,Document
C#,80,125,927.495625,MERGED,21,539,14,0,8,113,False,0,0,0,1489,560,3.881111111111111,Document
Python,2409,12193,352.92854166666666,MERGED,147,177,21,0,20,490,True,0,0,0,1748,324,8.6975,Document
Go,1835,11246,1841.9943171296297,MERGED,20,0,1,0,1,612,False,0,0,0,1996,20,0.21805555555555556,Document
Python,137,75,797.0690162037037,MERGED,0,66,7,0,8,126,False,0,0,0,2194,66,1.9725,Document
JavaScript,5140,7054,1312.6003587962962,MERGED,33,615,10,2,6,365,False,1,1,1,5042,648,74.99583333333334,Feature
TypeScript,3393,2334,1081.415462962963,MERGED,3,8,2,1,1,792,False,0,1,1,2028,11,0.15527777777777776,Bug
Go,1835,11246,1837.648125,MERGED,7,4,1,0,1,609,False,0,0,0,1514,11,22.494444444444444,Document
TypeScript,3393,2334,1081.0830902777777,MERGED,0,30,2,1,2,410,False,0,1,1,1977,30,0.37722222222222224,Feature
Python,2409,12193,351.6999074074074,CLOSED,6,62,1,3,2,0,False,2,1,1,1959,68,40.26972222222222,Document
TypeScript,3393,2334,1080.918425925926,CLOSED,16,6,2,1,1,206,False,0,1,1,1840,22,0.08055555555555556,Feature
TypeScript,3393,2334,1080.909375,MERGED,8,19,2,1,1,205,False,0,1,1,2135,27,0.10388888888888889,Feature
Starlark,440,286,602.1366666666667,CLOSED,32,32,2,1,3,101,False,0,1,1,2319,64,47.48138888888889,Bug
C++,363,552,649.158576388889,MERGED,17,64,5,1,3,333,False,0,1,1,1955,81,40.13583333333333,Document
TypeScript,41369,87417,3044.6054050925927,MERGED,15,3,1,2,1,0,False,0,2,2,3794,18,33.69888888888889,Document
Go,2083,11771,1627.908923611111,MERGED,34,64,5,0,3,963,True,0,0,0,4011,98,1.0633333333333332,Document
TypeScript,3393,2334,1080.1709722222222,MERGED,1,13,2,2,1,0,False,0,2,1,1676,14,18.33138888888889,Feature
Python,2409,12193,351.3930787037037,MERGED,2,2,1,1,1,24,False,0,1,1,1953,4,7.648888888888889,Document
TypeScript,41369,87417,3044.4857060185186,MERGED,22,24,2,2,1,160,True,0,2,2,4242,46,0.42944444444444446,Document
TypeScript,4,33,874.6433680555556,MERGED,72,187,9,1,14,449,True,0,1,1,1914,259,0.5044444444444445,Bug
C++,363,552,648.2869328703704,MERGED,169,183,7,0,2,120,False,0,0,0,2118,352,40.77166666666667,Document
TypeScript,3393,2334,1079.8621412037037,MERGED,3121,9,2,1,1,788,False,0,1,1,1901,3130,2.225,Feature
Python,2409,12193,350.8223611111111,MERGED,4,7,1,0,2,486,True,0,0,0,1909,11,7.595,Document
Python,2409,12193,350.3974652777778,MERGED,2,9,2,2,6,100,True,0,2,1,2086,11,8.873611111111112,Document
TypeScript,3393,2334,1079.0690625,MERGED,1,16,2,1,2,406,False,0,1,1,2014,17,0.8780555555555556,Feature
Python,2409,12193,350.03599537037036,MERGED,1,41,3,0,17,482,True,0,0,0,1928,42,1.5608333333333333,Document
Python,2409,12193,349.7986458333333,MERGED,118,14,4,0,7,481,True,0,0,0,2209,132,5.490277777777778,Document
Starlark,440,286,599.476574074074,CLOSED,0,50,2,5,2,1,False,4,1,1,1900,50,0.5775,Feature
Starlark,440,286,599.4713425925926,CLOSED,0,50,2,2,2,0,False,1,1,1,1796,50,0.6988888888888889,Feature
TypeScript,58,78,928.1641435185185,MERGED,19,526,14,3,8,142,False,0,3,3,8716,545,121.88833333333334,Feature
TypeScript,3393,2334,1078.3537962962962,MERGED,26,14,2,2,1,201,False,0,2,2,2189,40,0.3586111111111111,Feature
TypeScript,3393,2334,1078.347013888889,MERGED,4,9,1,1,1,200,False,0,1,1,1760,13,0.10416666666666667,Feature
TypeScript,3393,2334,1078.200787037037,MERGED,6,18,4,2,2,549,False,0,2,1,2253,24,0.4211111111111111,Bug
C#,655,7879,1941.0518287037037,MERGED,8,11,2,1,3,1540,True,0,1,1,2420,19,31.49361111111111,Document
TypeScript,261,3764,788.4971527777778,MERGED,40,40,31,0,1,1114,True,0,0,0,7447,80,0.21166666666666667,Document
C#,655,7879,1941.009074074074,MERGED,2,18,1,2,1,0,False,1,1,1,2536,20,31.776666666666667,Document
Go,1835,11246,1841.8050115740741,MERGED,17,18,2,0,1,69,True,0,0,0,2205,35,0.26666666666666666,Document
TypeScript,4,33,871.6233912037037,MERGED,45,84,10,2,23,427,False,1,1,1,1735,129,63.19,Document
TypeScript,85,724,425.3572916666667,MERGED,12,106,24,1,4,38,False,1,0,0,9227,118,13.649166666666666,Document
Erlang,2054,12122,3902.9680902777777,MERGED,53,163,4,0,3,453,True,0,0,0,1614,216,69.37388888888889,Document
TypeScript,261,3764,787.784826388889,MERGED,55,46,15,0,1,1112,True,0,0,0,8512,101,0.34444444444444444,Document
TypeScript,261,3764,787.7527430555556,MERGED,1865,13,43,0,3,1111,True,0,0,0,7653,1878,0.4161111111111111,Document
Python,2409,12193,347.87690972222225,MERGED,2,5,1,2,4,1,False,1,1,1,2124,7,11.58,Document
TypeScript,4,33,870.6527546296296,MERGED,43,78,11,1,3,443,True,0,1,1,1985,121,0.1761111111111111,Document
Go,1835,11246,1839.893275462963,MERGED,4,4,1,0,1,137,False,0,0,0,1899,8,0.3908333333333333,Document
Go,1835,11246,1839.8506597222222,MERGED,18,36,2,0,1,136,False,0,0,0,1769,54,0.4752777777777778,Document
Go,1835,11246,1838.821099537037,MERGED,2,2,2,0,1,59,False,0,0,0,2020,4,22.84111111111111,Document
Go,1835,11246,1838.8457175925926,MERGED,0,11,2,0,2,68,True,0,0,0,2110,11,1.2919444444444443,Document
Go,1835,11246,1837.1269907407407,MERGED,2,2,2,0,1,58,False,0,0,0,1861,4,0.03222222222222222,Document
Go,1174,11429,1952.2297569444445,MERGED,4,26,1,0,2,106,False,0,0,0,5033,30,39.403333333333336,Document
Python,2409,12193,354.18586805555555,MERGED,17,32,5,0,5,493,True,0,0,0,2681,49,0.5552777777777778,Document
Python,137,75,797.9398032407407,MERGED,0,267,11,0,19,54,False,0,0,0,2393,267,21.044722222222223,Bug
TypeScript,1297,21107,529.9548263888888,MERGED,194,29,2,2,1,1350,True,0,2,2,6140,223,0.2336111111111111,Document
Go,1835,11246,1835.8071990740739,MERGED,3,22,3,0,6,608,False,0,0,0,1743,25,19.69472222222222,Document
TypeScript,3393,2334,1081.746400462963,MERGED,29,95,7,2,3,553,False,0,2,1,3360,124,5.3533333333333335,Document
Python,14534,41196,1200.406076388889,MERGED,6,5,4,0,1,1446,True,0,0,0,2462,11,0.25722222222222224,Document
TypeScript,3393,2334,1081.3751388888888,MERGED,1,200,9,1,3,413,False,0,1,1,2800,201,1.1769444444444443,Feature
TypeScript,1297,21107,528.7547916666666,MERGED,34,116,10,1,2,1334,True,0,1,1,5586,150,0.05333333333333334,Document
TypeScript,1297,21107,528.4670023148147,MERGED,45,42,3,1,1,1330,True,0,1,1,5039,87,0.1663888888888889,Document
TypeScript,41369,87417,3051.0192245370367,MERGED,133,306,76,3,10,538,True,0,3,3,6168,439,0.5905555555555555,Document
Python,2409,12193,351.3585648148148,MERGED,15,19,6,0,6,488,True,0,0,0,2594,34,12.377222222222223,Document
TypeScript,1297,21107,527.799675925926,MERGED,40,137,10,1,2,1328,True,0,1,1,7810,177,0.09277777777777778,Document
TypeScript,41369,87417,3050.7497685185185,MERGED,209,327,10,2,5,1704,True,0,2,2,6174,536,4.7411111111111115,Document
Java,450,746,4185.075150462963,MERGED,14,16,3,1,2,49,False,0,1,1,2484,30,3.4547222222222222,Feature
TypeScript,1073,11367,1206.7969328703705,MERGED,3,3,2,0,3,44,True,0,0,0,2346,6,0.3686111111111111,Bug
TypeScript,1073,11367,1206.7276504629629,MERGED,66,45,9,1,4,331,True,0,1,1,2255,111,0.7394444444444445,Bug
TypeScript,61,71,1783.2193287037037,MERGED,51,179,16,1,6,31,True,1,0,0,3143,230,89.62277777777778,Bug
Java,450,746,4184.275868055555,MERGED,25,31,4,3,4,92,False,1,2,2,2852,56,19.9475,Feature
Go,789,5551,1149.240011574074,MERGED,0,8,2,0,1,16,False,0,0,0,2783,8,21.357777777777777,Document
TypeScript,41369,87417,3049.6446296296294,MERGED,71,404,9,2,3,1701,True,0,2,2,5615,475,6.208333333333333,Document
Starlark,440,286,599.7906018518519,CLOSED,0,0,0,1,0,1,False,0,1,1,2561,0,30.846666666666668,Document
TypeScript,1073,11367,1205.7844907407407,MERGED,14,14,8,1,2,248,False,0,1,1,2537,28,0.25055555555555553,Bug
Go,1835,11246,1838.614537037037,MERGED,26,8,6,0,1,85,False,0,0,0,2570,34,0.6361111111111111,Document
Java,450,746,4183.409502314815,MERGED,9,59,4,1,6,47,False,0,1,1,3087,68,15.426944444444445,Feature
TypeScript,4,33,871.5415740740741,MERGED,6,9,5,1,4,426,False,0,1,1,2640,15,60.320277777777775,Bug
TypeScript,41369,87417,3048.811388888889,MERGED,75,128,6,3,3,1699,True,0,3,3,5436,203,0.6336111111111111,Document
TypeScript,4,33,872.5927314814816,MERGED,204,202,6,1,7,448,True,0,1,1,2828,406,21.68611111111111,Feature
Python,2409,12193,349.2220949074074,MERGED,175,132,12,0,24,480,True,0,0,0,2530,307,4.335277777777778,Document
TypeScript,41369,87417,3048.751851851852,MERGED,475,622,15,2,4,1698,True,0,2,2,5622,1097,1.1269444444444445,Document
TypeScript,41369,87417,3048.504826388889,MERGED,25,52,5,3,6,685,True,0,3,3,5622,77,7.780833333333334,Document
Python,2409,12193,349.0113773148148,MERGED,41,62,10,1,9,478,True,1,0,0,2808,103,0.6986111111111111,Document
TypeScript,1073,11367,1204.8023032407407,MERGED,3,3,2,1,1,42,True,0,1,1,2412,6,0.36027777777777775,Bug
Go,1835,11246,1841.928541666667,MERGED,16,55,8,0,1,90,False,0,0,0,3086,71,1.6933333333333334,Document
Python,2409,12193,348.82718750000004,MERGED,39,30,4,1,10,477,True,1,0,0,2950,69,2.94,Document
TypeScript,1073,11367,1204.5882407407407,MERGED,3,3,2,0,3,41,True,0,0,0,2107,6,1.4525,Bug
TypeScript,1073,11367,1204.4901620370372,MERGED,2,4,1,1,1,40,True,0,1,1,2219,6,1.1377777777777778,Bug
TypeScript,41369,87417,3047.845127314815,MERGED,15,55,5,2,2,1693,True,0,2,2,5786,70,1.8044444444444445,Document
Python,2409,12193,347.88424768518513,MERGED,17,153,14,2,42,475,True,2,0,0,2113,170,11.87111111111111,Document
Python,14534,41196,1195.573761574074,CLOSED,1,18,1,0,2,2,False,0,0,0,2422,19,10.293055555555556,Document
TypeScript,41369,87417,3046.9872106481484,MERGED,126,177,7,3,1,1691,True,0,3,3,5617,303,0.49916666666666665,Document
TypeScript,4,33,871.2611458333334,MERGED,746,898,59,1,7,444,True,0,1,1,2367,1644,1.9491666666666667,Document
TypeScript,3393,2334,1076.2004050925925,MERGED,2,3,2,2,1,0,False,0,2,1,2499,5,1.1291666666666667,Feature
Go,1835,11246,1840.0823958333333,MERGED,14,23,6,0,2,611,False,0,0,0,2849,37,16.14611111111111,Bug
Go,1835,11246,1839.8682175925926,MERGED,15,13,3,0,1,88,False,0,0,0,2615,28,0.1661111111111111,Document
Vue,10812,21164,1129.9079166666668,MERGED,458,1178,82,1,44,161,False,0,1,1,7886,1636,0.29555555555555557,Document
TypeScript,3393,2334,1075.0194328703703,MERGED,5,23,3,2,4,546,False,0,2,1,2962,28,2.8525,Feature
Go,1835,11246,1838.7065509259257,MERGED,8,8,3,0,1,610,False,0,0,0,2580,16,0.3491666666666667,Document
TypeScript,41369,87417,3044.736909722222,MERGED,124,569,9,2,5,1689,True,0,2,2,5895,693,1.8388888888888888,Document
C++,2234,23697,2469.780914351852,MERGED,294,604,55,0,12,15,False,0,0,0,8857,898,0.3461111111111111,Bug
Python,2409,12193,353.8663657407408,MERGED,16,20,7,0,19,492,True,0,0,0,3822,36,6.839444444444444,Document
TypeScript,41369,87417,3049.8993287037033,MERGED,104,200,12,2,6,1702,True,0,2,2,8705,304,0.9516666666666667,Document
Python,2409,12193,351.81958333333336,MERGED,38,68,5,4,8,489,True,3,1,1,3447,106,1.9672222222222222,Document
Python,2409,12193,350.820625,CLOSED,12,16,5,5,4,0,False,2,3,1,4433,28,69.53972222222222,Document
TypeScript,4,33,874.7733217592591,MERGED,38,144,3,1,2,450,True,0,1,1,3536,182,19.82777777777778,Bug
TypeScript,4,33,874.7149074074074,MERGED,218,321,8,1,12,288,False,0,1,1,4486,539,19.799444444444443,Feature
TypeScript,41369,87417,3047.894513888889,MERGED,272,470,33,8,13,0,False,2,6,4,9074,742,13.3975,Document
Python,2409,12193,351.01721064814814,MERGED,93,67,6,0,18,487,True,0,0,0,4479,160,4.133333333333334,Document
TypeScript,3393,2334,1079.3185416666668,MERGED,11,11,6,2,1,0,False,0,2,1,4109,22,15.303888888888888,Feature
Python,2409,12193,350.3841898148148,MERGED,93,405,15,1,17,484,True,1,0,0,3418,498,22.8175,Document
Python,2409,12193,350.4088541666667,MERGED,39,35,6,0,3,485,True,0,0,0,4930,74,6.253333333333333,Document
Java,450,746,4184.162141203704,MERGED,649,437,18,2,9,396,True,0,2,1,3642,1086,27.50611111111111,Feature
Python,2409,12193,350.2018865740741,MERGED,70,89,8,0,4,483,True,0,0,0,3335,159,1.0108333333333333,Document
Python,2409,12193,350.0342939814814,MERGED,6,19,4,3,14,0,False,1,2,2,3749,25,4.0136111111111115,Document
Java,450,746,4183.954872685185,MERGED,28,54,7,1,5,90,False,0,1,1,4827,82,2.995833333333333,Bug
TypeScript,1073,11367,1205.7083796296297,MERGED,6,33,4,1,2,157,True,0,1,1,4413,39,3.0444444444444443,Feature
TypeScript,4,33,873.2160069444444,MERGED,177,249,24,1,3,696,True,0,1,1,4605,426,1.7863888888888888,Bug
Java,450,746,4183.169849537037,MERGED,10,54,5,1,9,89,False,0,1,1,4887,64,18.93138888888889,Bug
Java,450,746,4183.202916666666,MERGED,4,33,4,2,1,395,True,0,2,1,3835,37,0.7888888888888889,Bug
Python,2409,12193,349.0380902777778,MERGED,22,56,4,0,7,479,True,0,0,0,3172,78,1.1525,Document
Python,2409,12193,348.46578703703705,MERGED,7,10,2,1,2,98,True,0,1,1,3752,17,7.279444444444445,Document
JavaScript,34,25,307.1234606481482,MERGED,6,309,7,0,3,103,False,0,0,0,4926,315,2.218888888888889,Bug
Java,450,746,4180.114039351852,MERGED,118,212,10,1,16,87,False,0,1,1,5063,330,119.82055555555556,Document
TypeScript,3393,2334,1075.3672453703705,MERGED,45,53,13,5,3,0,False,2,3,2,4589,98,61.71861111111111,Bug
TypeScript,1073,11367,1202.639525462963,MERGED,3,37,3,1,1,780,True,0,1,1,3913,40,52.38027777777778,Bug
TypeScript,4,33,870.6760300925926,MERGED,12,57,7,1,4,287,False,0,1,1,4704,69,0.08333333333333333,Document
Java,450,746,4180.2084606481485,MERGED,23,41,5,2,12,88,False,0,2,1,4251,64,71.66666666666667,Bug
TypeScript,1073,11367,1201.8890740740742,MERGED,32,158,8,2,10,330,True,1,1,1,3247,190,62.73305555555555,Bug
TypeScript,3393,2334,1074.9160763888888,MERGED,45,117,3,1,1,191,False,0,1,1,3593,162,0.38972222222222225,Document
Go,2083,11771,1625.9514351851851,MERGED,8,133,31,0,4,962,True,0,0,0,9790,141,0.10527777777777778,Document
TypeScript,2147,14725,1583.8177083333333,MERGED,172,246,5,0,1,78,False,0,0,0,15701,418,56.06805555555555,Document
TypeScript,261,3764,783.7358101851852,MERGED,426,206,18,0,1,154,False,0,0,0,18517,632,1.3091666666666666,Document
TypeScript,41369,87417,3046.658518518518,MERGED,219,625,17,3,6,533,True,0,3,3,11662,844,0.5147222222222222,Document
Erlang,2054,12122,3907.3180092592593,MERGED,17,117,6,2,1,463,False,1,1,1,5084,134,19.004166666666666,Document
Python,2409,12193,351.8025,MERGED,128,144,2,4,9,2,False,1,3,1,5504,272,24.404166666666665,Document
Python,2409,12193,351.79131944444447,CLOSED,135,418,2,1,7,1,False,1,0,0,5498,553,0.0475,Document
TypeScript,1073,11367,1207.7518981481483,MERGED,1,3069,34,1,6,159,True,0,1,1,6738,3070,1.0191666666666668,Document
Python,2409,12193,351.4471064814815,CLOSED,89,105,1,6,6,0,False,3,3,1,6253,194,8.204722222222221,Document
TypeScript,3393,2334,1079.7719907407406,MERGED,599,18,8,2,1,0,False,0,2,1,7399,617,27.920833333333334,Feature
TypeScript,3393,2334,1080.0816087962962,MERGED,1,140,19,1,1,408,False,0,1,1,6076,141,0.31583333333333335,Feature
Python,1912,12144,175.8112962962963,MERGED,0,408,7,1,2,3,False,1,0,0,5153,408,31.32138888888889,Feature
TypeScript,1073,11367,1205.836863425926,MERGED,34,306,11,1,5,249,False,0,1,1,5775,340,48.93138888888889,Feature
JavaScript,34,25,309.3199652777778,MERGED,15043,20463,25,0,8,104,False,0,0,0,5987,35506,0.7644444444444445,Feature
TypeScript,4,33,872.4887731481481,MERGED,72,284,27,1,21,447,True,0,1,1,5817,356,44.41833333333334,Bug
Go,752,2400,837.6241319444445,MERGED,578,161,22,0,6,489,False,0,0,0,7363,739,26.988888888888887,Bug
TypeScript,3393,2334,1074.930462962963,MERGED,7,121,28,1,13,785,False,0,1,1,7990,128,152.76222222222222,Feature
TypeScript,3393,2334,1075.1981828703704,MERGED,140,239,7,1,2,197,False,0,1,1,7099,379,0.4127777777777778,Document
TypeScript,3706,54076,1464.9659027777777,MERGED,41,72,5,0,2,190,True,0,0,0,7337,113,72.31194444444445,Bug
Go,1835,11246,1839.8960416666666,MERGED,197,1006,57,1,4,136,False,0,1,1,6527,1203,51.429722222222225,Bug
TypeScript,4,33,870.3399768518519,MERGED,218,1747,62,1,2,695,True,0,1,1,6856,1965,5.087777777777778,Document
Go,1835,11246,1838.828298611111,MERGED,559,409,24,0,4,86,False,0,0,0,7134,968,21.729166666666668,Document
Go,1835,11246,1837.7989699074076,MERGED,8,6267,124,1,7,84,False,0,1,1,6502,6275,0.13694444444444445,Document
TypeScript,3393,2334,1079.1812962962963,MERGED,9,27,8,1,3,407,False,0,1,1,9296,36,20.579444444444444,Feature
TypeScript,1297,21107,527.0164699074074,CLOSED,229,172,3,2,1,0,False,1,1,1,11401,401,5.476666666666667,Document
Go,789,5551,1148.0954166666668,MERGED,497,58,16,3,4,202,True,2,1,1,10770,555,66.51388888888889,Document
Go,1835,11246,1840.7463541666666,MERGED,813,1040,25,1,2,89,False,0,1,1,8242,1853,3.251388888888889,Document
TypeScript,4,33,870.3358796296296,MERGED,166,1086,26,1,22,425,False,0,1,1,9689,1252,0.6780555555555555,Feature
TypeScript,4,33,869.8959490740741,MERGED,230,377,22,1,7,286,False,0,1,1,9430,607,0.23833333333333334,Document
TypeScript,1073,11367,1204.852488425926,MERGED,41,339,28,1,27,43,True,0,1,1,14196,380,0.14694444444444443,Bug
Go,1835,11246,1838.9109027777777,MERGED,71,112,9,0,1,87,False,0,0,0,12389,183,19.759722222222223,Document
Go,1835,11246,1835.6537384259261,MERGED,146,451,17,0,5,28,False,0,0,0,17941,597,75.00138888888888,Document
